recipeName,ingredients,numberOfIngredients,prepTime,cookTime,totalTime,servings,cuisine,course,diet
Masala Karela Recipe,"Karela, Salt, Onion, Gram Flour, Turmeric Powder, Red Chilli Powder, Cumin Seeds, Coriander Powder, Amchur, Sunflower Oil",10,15,30,45,6,Indian,Side Dish,Diabetic Friendly
Spicy Tomato Rice ,"Rice  Cooked, Tomato, Bc Belle Bhat Powder, Salt, Chickpea Lentils, Cumin Seeds, White Urad Dal, Teaspoon Mustard, Green Chilli, Dry Red Chilli, Cashew Peanuts, Oil   Asafoetida",12,5,10,15,3,South Indian Recipes,Main Course,Vegetarian
Ragi Semiya Upma Recipe - Ragi Millet Vermicelli Breakfast,"Rice Vermicelli Noodles, Onion, Carrots, Green Peas, Green Chilli, Asafoetida, Mustard Seeds, White Urad Dal, Ghee, Curry Leaves, Salt, Lemon Juice",12,20,30,50,4,South Indian Recipes,South Indian Breakfast,High Protein Vegetarian
Gongura Chicken Curry Recipe - Andhra Style Gongura Chicken,"Chicken, Onion, Tomato, Green Chilli, Ginger, Garlic, Turmeric Powder, Garam Masala Powder, Sesame, Salt, Methi Seeds, Coriander, Dry Red Chilli, Fennel Seeds, Sesame, Garlic, Sorrel Leaves, Salt",18,15,30,45,4,Andhra,Lunch,Non Vegeterian
Adrak Chutney ,"Chana Dal, White Urad Dal, Red Chilli, Coriander Seeds, , Onion, Tomato, Salt, Teaspoon Mustard, Asafoetida, Oil, Curry",12,10,20,30,4,Andhra,South Indian Breakfast,Vegetarian
Pudina Khara Pongal Recipe (Rice and Lentils Cooked With Mint Leaves & Mild Spices),"Rice, Yellow Moong Dal, Mint Leaves, Coriander, Green Chilli, Ginger, Cumin Seeds, Water, Sunflower Oil, Salt, Ghee, Cashew Nuts, Cumin Seeds, Whole Black Peppercorns, Curry Leaves, Asafoetida",16,10,20,30,4,South Indian Recipes,South Indian Breakfast,High Protein Vegetarian
Udupi Style Ash Gourd Coconut Curry Recipe,"Vellai Poosanikai, Turmeric Powder, Salt, Sunflower Oil, Dry Red Chilli, Fresh Coconut, Tamarind Water, Methi Seeds, Cumin Seeds, Coriander, Sesame Seeds, Jaggery, Tamarind Water, Sunflower Oil, Mustard Seeds, Curry Leaves, Dry Red Chilli",17,10,30,40,4,Udupi,Lunch,Vegetarian
Mexican Style Black Bean Burrito Recipe,"Tortillas, Black Beans, Spinach Leaves, Onion, Tomato, Garlic, Coriander, Rice Brown Rice, Lemon Juice, Spring Onion Greens, Cheddar Cheese, Hung Curd",12,10,30,40,4,Mexican,Lunch,Vegetarian
Spicy Crunchy Masala Idli Recipe,"Idli, Green Bell Pepper, Tomato, Onion, Green Chilli, Red Chilli Powder, Turmeric Powder, Tomato Ketchup, Coriander, Mint Leaves, Sunflower Oil, Salt",12,10,20,30,3,South Indian Recipes,Snack,Vegetarian
Cauliflower Leaves Chutney ,"Cabbage Leaves, Tomato, Tamarind, White Urad Dal, Red Chilli, Salt, Asafoetida, Garlic, Turmeric Powder, Big Spoon Oil, Rye, Cumin Seeds, Curry Leaves",13,5,20,25,3,South Indian Recipes,Side Dish,Vegetarian
Homemade Baked Beans Recipe (Wholesome & Healthy),"Dry Beans, Extra Virgin Olive Oil, Onion, Clove Garlic, Tomato, Honey More, Cumin Powder, Dried Oregano, Red Chilli Powder Cayenne Pepper, Salt And Pepper",10,60,60,120,4,Fusion,High Protein Vegetarian,Vegetarian
Veg Chili Cheese Burgers Recipe,"Burger Buns, Pickled Jalapenos, Cheese Slices, Potato, Onion, Red Chilli Powder, Salt, Whole Egg, Whole Wheat Bread Crumbs, Garlic, Onion, Tomato, Homemade Tomato Puree, Green Bell Pepper, Soy Granules, Red Chilli Powder, Red Chilli Flakes, Cumin Powder, Dried Oregano, Tabasco Original, Honey, Salt, Sunflower Oil",23,10,45,55,4,Continental,Main Course,Vegetarian
Andhra Style Ingavu Chaaru Recipe - Asafoetida Flavored Tamarind Rasam,"Tamarind Water, Arhar Dal, Asafoetida, Salt, Mustard Seeds, Cumin Seeds, Methi Seeds, Curry Leaves, Asafoetida, Sunflower Oil",10,0,30,30,4,Andhra,Lunch,Vegetarian
Aar Macher Jhol Recipe - Bengali Style Fish In Tomato Gravy,"Aar Maach, Tomato, Bay Leaves, Ginger  Paste, Green Chilli, Cumin Powder, Coriander Powder, Salt, Cumin Seeds, Turmeric Powder, Green Chilli, Mustard Oil, Water  Add  If You Like A Loose Gravy, Sugar, Coriander",15,5,15,20,2,Bengali Recipes,Dinner,High Protein Non Vegetarian
Saunf Aloo (Fennel Potato Curry) Recipe,"Potato, Fennel Seeds, Red Chilli Powder, Turmeric Powder, Fresh Cream, Coriander",6,10,15,25,6,Punjabi,Lunch,Vegetarian
South Indian Onion Chutney ,"Onion, Cumin Seeds, Black Urad Dal, Tamarind Paste, Dry Red Chilli, Jaggery, Oil, Salt, As Per  Rye, Curry Leaves, Oil",11,20,20,40,4,South Indian Recipes,Side Dish,Vegetarian
Hariyali Egg Curry Recipe In Coriander and Mint Gravy,"Whole Eggs, Cinnamon Stick, Bay Leaf, Cloves, Sunflower Oil, Coriander Powder, Garam Masala Powder, Fresh Cream, Coriander, Mint Leaves, Green Chilli, Onion, Ginger, Garlic",14,15,20,35,4,Indian,Lunch,Eggetarian
Grated Bottle Gourd Yogurt Salad ,"Curd, Gourd, Cucumber, Green, Green Coriander, Cumin Powder, Salt",7,15,15,30,4,Indian,Side Dish,Vegetarian
Homemade Tater Tots Recipe,"Potato, Garlic Powder, Onion Powder, Dried Oregano, Coriander, Red Chilli Flakes, All Purpose Flour, Rice Flour, Salt, Sunflower Oil",10,15,45,60,8,Continental,Appetizer,Vegetarian
Chettinad Vegetable Pulao Recipe,"Rice, Small Onion, Garlic, Ginger, Green Chilli, Bay Leaf, Red Chilli Powder, Turmeric Powder, Carrot, Green Beans, Potato, Ghee, , Cinnamon, Fennel, Whole Pepper, Coriander Seeds, Green Peas, Mint Leaves",19,15,45,60,4,Chettinad,Dinner,Vegetarian
Lehsun Amla Chutney Recipe,"Amla, Small Onion, Bud Garlic, Green Chilli, Mint, Coriander, Salt, Oil, Oil, Rye, Urad Dal, Chana Dal, Curry Leaves, Cashew Nuts",14,5,10,15,3,Tamil Nadu,Side Dish,Vegetarian
Maharashtrian Kakdi Thalipeeth Recipe - Spiced Cucumber Flat Bread,"Gram Flour, Whole Wheat Flour, Rice Flour, Cucumber, Turmeric Powder, Cumin Powder, Coriander Powder, Red Chilli Powder, Green Chilli, Coriander, Garlic, Salt, Ghee",13,30,30,60,4,Maharashtrian Recipes,Indian Breakfast,Diabetic Friendly
Homemade Healthy Subway Sandwich Recipe With Beet & Sprout,"Submarine Bread, Green Moong Sprouts, Beetroot, Garlic, Hung Curd, Coriander, Tomato, Stalks Spring Onion, Tabasco Original  Hot Sauce, Salt And Pepper",10,15,15,30,4,Fusion,Dinner,High Protein Vegetarian
South Indian Style Murungakkai Poriyal Recipe - Drumstick Stir Fry,"Drumstick, Fresh Coconut, Green Chilli, Curry Leaves, Mustard Seeds, Coconut Oil, Dry Red Chilli, Turmeric Powder, Salt, Water",10,30,15,45,4,South Indian Recipes,Side Dish,Vegetarian
Kesar Mango Lassi Recipe - Saffron Mango Lassi Recipe,"Mango Pulp, Curd, Sugar Honey, Saffron Strands, Badam, Milk, Ice Cubes",7,15,10,25,2,Indian,Snack,Vegetarian
Chettinad Sweet Paniyaram Recipe,"Idli Dosa Mixture, Rice Rava, Jaggery, Coconut, Of Cardamom Powder, Salt, Water, Oil",8,5,20,25,10,Chettinad,Snack,Vegetarian
Mini Dal Samosa Curry/Sabzi Recipe,"Cardamom, Whole Black Peppercorns, Cinnamon Stick, Cloves, Mace, Bay Leaf, Black Cardamom, Kasuri Methi, Kashmiri Red Chilli Powder, Turmeric Powder, Coriander Powder, Garam Masala Powder, Samosas, Cashew Nuts, Green Chilli, Onion, Tomato, Ginger, Sugar, Fresh Cream, Sunflower Oil",21,5,30,35,3,North Indian Recipes,Lunch,Vegetarian
Spinach Garlic Bruschetta Recipe With Red Bell Pepper Sauce,"Baguette, Butter, Garlic, Spinach Leaves, Red Bell Pepper, Tomato, Onion, Black Pepper Powder, Italian Seasoning, Fresh Cream, Cheddar Cheese, Salt, Roasted Tomato Pasta Sauce",13,10,20,30,4,Italian Recipes,Appetizer,Vegetarian
Mini Dal Pakwan Chaat Recipe - A Perfect Party Snack,"Whole Wheat Flour, All Purpose Flour, Ajwain, Cumin Seeds, Ghee, Salt, Sunflower Oil, Chana Dal, Turmeric Powder, Garam Masala Powder, Red Chilli Powder, Amchur, Sugar, Salt, Ghee, Asafoetida, Cumin Seeds, Green Chilli, Curry Leaves, Sweet Chutney, Green Chutney, Onion, Fresh Pomegranate Fruit Kernels, Sev",24,20,45,65,30,Sindhi,Appetizer,Vegetarian
Asian Style Sweet & Spicy Green Beans Recipe,"Green Beans, Garlic, Soy Sauce, Thai Sweet Chilli Sauce, Lemon, Rice Wine Vinegar, Roasted Peanuts, Salt, Sesame",9,10,15,25,4,Thai,Side Dish,High Protein Vegetarian
Chinese Darsaan Recipe With Ice Cream,"Sunflower Oil, All Purpose Flour, Baking Powder, Water Make The Dough, Sunflower Oil Deep Fry, Honey, Sugar, Sesame Seeds, Water, Vanilla Extract",10,15,25,40,4,Chinese,Dessert,Vegetarian
Sundakkai And Methi Leaves Sambar Recipe,"Sundkai, Fenugreek, Arhar Dal, Tomato, Tamarind, Turmeric Powder, Sambar Powder, Coriander Powder, Mustard, Cumin Seeds, Dry Red Chili, Asafoetida, Oil, Salt, Curry Leaves, Green Coriander, Water",17,30,35,65,4,South Indian Recipes,Lunch,Diabetic Friendly
"Cabbage, Spinach, Pomegranate Slaw with Lemon Dressing Recipe ","Cabbage, Spinach, Fresh Pomegranate Fruit Kernels, Lemon Juice, Extra Virgin Olive Oil, Salt And Pepper",6,15,0,15,4,Continental,Appetizer,Vegetarian
Matar Samosa Recipe -Green Pea Samosa,"All Purpose Flour, Ghee, Salt, Sunflower Oil, Ghee, Cumin Seeds, Green Chilli Sauce, Cinnamon Powder, Garam Masala Powder, Red Chilli Powder, Amchur, Green Peas, Salt, All Purpose Flour, Water",15,45,10,55,4,North Indian Recipes,Snack,Vegetarian
Eggless Chocolate Cupcakes With Raspberry & Cheese Frosting,"All Purpose Flour, Sugar, Dark Chocolate, Cocoa Powder, Salted Butter, Milk, Baking Powder, Baking Soda, Vanilla Extract, Britannia Cream Cheese, Caster Sugar, Vanilla Extract, Fresh Raspberries",13,20,20,40,4,Continental,Dessert,Vegetarian
Kerala Palada Pradhaman Recipe,"Ada, Milk, Sugar, Ghee, Cardamom Powder",5,15,75,90,4,Kerala Recipes,Dessert,Vegetarian
Tindora Sambharo Recipe - Instant Tendli Pickle,"Tindora, Red Chilli Powder, Split Methi Seeds, Split Mustard Seeds, Turmeric Powder, Asafoetida, Sunflower Oil, Lemon, Salt",9,20,15,35,1,Gujarati Recipesï»¿,Side Dish,Vegetarian
Chettinad Style Chicken Roast Recipe,"Chicken Legs, Hung Curd, Turmeric Powder, Salt, Sunflower Oil, Onion, Garlic, Ginger, Fresh Coconut, Cumin Seeds, Coriander, Methi Seeds, Kalonji, Whole Black Peppercorns, Dry Red Chilli, Fennel Seeds, Cinnamon Stick, Cloves, Cardamom, Mustard Seeds, Ghee, Tamarind Paste, Jaggery, Ghee, Mustard Seeds, Curry Leaves, Garlic",27,15,20,35,3,Chettinad,Appetizer,High Protein Non Vegetarian
Palakottai Kuzhambu Recipe-Kongunad Style Jackfruit Seeds Curry,"Jackfruit Seeds, Tamarind Water, Garlic, Mustard Seeds, Cumin Seeds, Curry Leaves, Turmeric Powder, Red Chilli Powder, Sambar Powder, Asafoetida, Coriander, Salt, Sunflower Oil, Fresh Coconut, Whole Black Peppercorns, Dry Red Chilli, Onion, Tomato, Coriander, Sunflower Oil",20,5,20,25,4,Tamil Nadu,Side Dish,Vegetarian
Baingan Bharta ,"Eggplant, Ginger, Onion, Tomato, Green Chilli, Turmeric Powder, Garam Masala Powder, Coriander Powder, Butter, Red Chili Powder, Salt, Oil, S Of Coriander",13,25,35,60,4,Punjabi,Side Dish,Vegetarian
Kesar Chai Recipe - A Delicious Saffron Flavored Indian Tea,"Water, Tea Leaves, Milk, Saffron Strands More",4,0,10,10,2,North Indian Recipes,North Indian Breakfast,Vegetarian
Tamil Nadu Raw Mango Pachadi Recipe,"Raw Mango, Tamarind Water, Jaggery, Sambar Powder, Turmeric Powder, Salt, Mustard, Asafoetida, Sprig Curry Leaves, Dry Red Chilli, Oil",11,5,30,35,4,Tamil Nadu,Side Dish,Vegetarian
Kodava Mudi Chekke Barthad Recipe - Raw Jackfruit & Black Chickpea Stir Fry,"Jackfruit Seeds, Kala Chana, Mustard Seeds, Cumin Seeds, Curry Leaves, Tomato, Tamarind Water, Turmeric Powder, Dry Red Chilli, Cumin Seeds, Coriander, Cloves, Cinnamon Stick, Fresh Coconut, Ginger, Garlic",16,10,45,55,4,Coorg,Lunch,Vegetarian
Whole Wheat Crepe Recipe With Herbed Vegetables,"Whole Wheat Flour, Salt, Italian Seasoning, Cheese Spread, Broccoli, Onion, Red Bell Pepper, Salt, Parsley Leaves",9,10,45,55,4,Coorg,Lunch,Vegetarian
Makki and Methi Roti Recipe,"Makki Ka Atta, Methi Leaves, Green Chilli, Ajwain, Kashmiri Red Chilli Powder, Salt",6,10,20,30,4,Punjabi,Lunch,Vegetarian
Cabbage and Carrot Sambharo Recipe - Gujarati Vegetable Stir Fry,"Carrots, Cabbage, Green Bell Pepper, Turmeric Powder, Sugar, Lemon Juice, Salt, Sunflower Oil, Mustard Seeds, Asafoetida, Curry Leaves, Green Chilli",12,10,20,30,4,Gujarati Recipesï»¿,Lunch,Vegetarian
Whole Wheat Pita Bread Recipe,"All Purpose Flour, Whole Wheat Flour, Active Dry Yeast, Salt, Sugar, Lukewarm Water, Extra Virgin Olive Oil",7,30,40,70,6,Continental,Main Course,Vegetarian
Andhra Style Tamati Pachadi Recipe (Tomato Chutney),"Tomato, Dry Red Chilli, Tamarind Paste, Red Chilli Powder, Turmeric Powder, Mustard Seeds, Methi Seeds, Garlic, Sunflower Oil, Salt",10,15,60,75,6,Andhra,Side Dish,Vegetarian
Herbed Brown Rice Recipe,"Brown Rice, Onion, Garlic, Oregano, Rosemary, Red Chilli Flakes, Salt, Oil, Water",9,10,20,30,4,Continental,Side Dish,Vegetarian
Aamras Recipe - Ripe Mango Ras,"Mango, Water, Sugar",3,10,5,15,4,North Indian Recipes,Side Dish,Vegan
Rajasthani Khooba Roti Recipe,"Whole Wheat Flour, Salt, Water, Ghee",4,20,25,45,4,Rajasthani,Lunch,Vegetarian
Peerkangai Thogayal Recipe (Ridge Gourd Peel Chutney),"Ridge Gourd Skin, White Urad Dal, Methi Seeds, Dry Red Chilli, Curry Leaves, Tamarind, Mustard Seeds, Dry Red Chilli, Curry Leaves, Sunflower Oil, Salt",11,15,10,25,4,South Indian Recipes,Side Dish,Vegetarian
Dalia Pakora Recipe,"Broken Wheat, Salt, Sunflower Oil, Gram Flour, Onion, Coriander, Green Chilli, Salt, Turmeric Powder, Cumin Seeds, Ajwain, Sunflower Oil, Water, Enos Fruit Salt, Sunflower Oil",15,10,15,25,4,Indian,Snack,Vegetarian
Paneer Tikka Kathi Roll Recipe,"Whole Wheat Flour, Salt, Ghee, Ghee, Paneer, Hung Curd, Gram Flour, Ginger, Garlic, Kasuri Methi, Turmeric Powder, Chaat Masala Powder, Garam Masala Powder, Mint Leaves, Salt, Coal, Mint Leaves, Green Bell Pepper, Onion, Lemon, Salt",21,30,30,60,4,Bengali Recipes,Snack,Vegetarian
Pan Fried Rice Balls Filled With Cheese Recipe,"Extra Virgin Olive Oil, Butter, Onion, Jasmine Rice, Salt, Sweet Corn, Parsley Leaves, Parmesan Cheese, Mozzarella Cheese, All Purpose Flour, Whole Eggs, Whole Wheat Bread Crumbs, Sunflower Oil",13,20,45,65,4,Continental,Appetizer,Vegetarian
Spicy Seafood Stew Casserole With Tomatoes And Lime Recipe,"Fish Fillet, Prawns, Clamps, Baby Potato, Carrots, Onion, Tomato, Fresh Red Chilli, Garlic, Cumin Powder, Paprika Powder, Salt, Lemon Juice, Black Pepper Powder, Coriander, Extra Virgin Olive Oil, Chicken Stock, Coconut Milk",18,10,55,65,6,South Indian Recipes,Lunch,Non Vegeterian
Spicy Chilli Garlic Noodles Recipe,"Hakka Noodles, Water, Salt, Sunflower Oil, Sunflower Oil, Onion, Green Bell Pepper, Garlic, Soy Sauce, Red Chilli Sauce, White Vinegar, Tomato Ketchup, Dry Red Chilli, Salt, Black Pepper Powder",15,10,30,40,4,Asian,Dinner,Vegetarian
Chanar Dalna Recipe -Bengali Style Paneer & Potato Gravy,"Paneer, Potato, Bay Leaf, Dry Red Chilli, Panch Phoran Masala, Tomato, Turmeric Powder, Red Chilli Powder, Cumin Seeds, Ginger, Salt, Sugar, Sunflower Oil",13,15,60,75,4,Bengali Recipes,Lunch,Vegetarian
Cheesy Garlic Broccoli Nuggets Recipe,"Broccoli  Florets, Mozzarella Cheese, Nutralite Cheesy Garlic Mayo, Corn Flour, Whole Wheat Bread Crumbs, Salt, Nutralite Garlic & Oregano Spread",7,20,15,35,6,Indian,Snack,Eggetarian
Bengali Mooli Aloo Ki Sabzi  Recipe,"Mooli Mullangi, Potato, Onion, Green Chilli, Kasundi Mustard Sauce, Red Chilli Powder, Turmeric Powder, Mustard Seeds, Cumin Seeds, Kalonji, Mustard Oil, Sugar, Salt",13,15,20,35,4,Bengali Recipes,Lunch,Vegetarian
Beetroot Sambar ,"Chakundar, Arhar Dal, , Sambar Powder, Mustard, Asafoetida, Curry Leaves, Dry Red Chili, Sesame Oil, Coriander, Salt",11,10,45,55,3,South Indian Recipes,Lunch,High Protein Vegetarian
Kaddu Palak Roti Recipe (Pumpkin Spinach Flat Bread),"Whole Wheat Flour, Spinach, Kaddu, Red Chilli Powder, Turmeric Powder, Coriander Powder, Cumin Seeds, Salt, Water, Sunflower Oil",10,10,25,35,3,North Indian Recipes,Indian Breakfast,High Protein Vegetarian
Iranian Baida Curry Recipe,"Whole Egg, Onion, Jaggery, Salt, Sunflower Oil, Coriander, Fresh Coconut, Coriander, Dry Red Chilli, Sesame Seeds, Poppy Seeds, Ginger, Garlic, Badam",14,10,30,40,4,Middle Eastern,Lunch,Eggetarian
Vegan Chickpea Omelette Recipe (Spiced Chickpea Flour Pancakes),"Gram Flour, Coconut Milk, Water, Ginger, Garlic, Ajwain, Asafoetida, Turmeric Powder, Baking Soda, Green Chilli  Finely, Onion, Tomato, Coriander, Salt, Sunflower Oil",15,20,30,50,4,North Indian Recipes,North Indian Breakfast,High Protein Vegetarian
Ulundu Kozhukattai Recipe - Uppu Kozhukattai/ Urad Dal Modak,"Rice Flour, Water, Sunflower Oil, Salt, White Urad Dal, Green Chilli, Ginger, Asafoetida, Salt, Sesame, Mustard Seeds, Curry Leaves",12,10,30,40,12,Maharashtrian Recipes,Snack,Vegetarian
Singapore Style Chicken Layered Fried Rice Recipe,"Boneless Chicken, Spring Onion Greens, Green Chilli, Garlic, Soy Sauce, Lemon Juice, Black Pepper Powder, Red Chilli Powder, Cumin Powder, Red Chilli Sauce, Sweet And Spicy Red Chilli Sauce, Salt, Red Chilli Sauce, Sunflower Oil, Rice, Garlic, Ginger, Green Chilli, Green Bell Pepper, Spring Onion, Onion, Carrots, Salt, Chinese  Spice Powder, White Pepper Powder, Sunflower Oil, Egg Noodles, Classic Mayonnaise, Tomato Ketchup, Red Chilli Sauce, Vinegar",31,30,45,75,12,Asian,Main Course,Vegetarian
Tofu Pulao ,"Rice, Ghee, Cumin Seeds, Bay Leaf, Lentil Sugar, , Green Chilli, Ginger Garlic Paste, Onion, Tomato, Capsicum, Red Chilli Powder, Turmeric Powder, Coriander Powder, Garam Masala Powder, Tofu, Salt, Coriander Garnish",18,20,45,65,4,Indian,Dinner,Vegetarian
Masala Sandwich Recipe With Rocket Leaves,"Paneer, Potato, Onion, Ginger, Garlic, Green Bell Pepper, Tomato, Pav Bhaji Masala, Salt, Coriander, French Bread Rye Breadmake Sandwiches, Rocket Leaves Salad Leaves For The Sandwich",12,15,15,30,2,Fusion,Indian Breakfast,Vegetarian
Tomato Relish Recipe,"Tomato, Onion, Red Wine Vinaigrette, Dried Oregano, Garlic, Black Pepper Powder, Dijon Mustard, Cane Sugar, Extra Virgin Olive Oil, Salt",10,0,30,30,4,Continental,Side Dish,Vegetarian
Dubuk Vade Recipe - Khandeshi Gram Flour Dumpling Curry,"Onion, Garlic, Fresh Coconut, Coriander, Cumin Seeds, Red Chilli Powder, Turmeric Powder, Garam Masala Powder, Salt, Gram Flour, Red Chilli Powder, Turmeric Powder, Salt",13,10,35,45,4,Maharashtrian Recipes,Lunch,Vegetarian
Radish Soup Recipe,"Mooli Mullangi, Water, Garam Masala Powder, Salt, Black Pepper Powder, Mooli Mullangi, Coriander",7,10,30,40,4,Indian,Side Dish,Vegetarian
Mango Donut Cake Recipe With Chocolate Glaze,"Vivatta Maida, Mango Pulp, Baking Powder, Baking Soda, Sunflower Oil, Sugar, Salt, Vanilla Extract, Dark Chocolate, Fresh Cream, Cocoa Powder, Sugar",12,25,26,51,4,Continental,Dessert,Vegetarian
Matar Paneer Kachori Korma Recipe - Green Peas And Paneer Kachori Curry,"All Purpose Flour, Sunflower Oil, Ajwain, Salt, Sunflower Oil, Green Peas, Paneer, Coriander Powder, Red Chilli Powder, Amchur, Turmeric Powder, Sunflower Oil, Salt And Pepper, Onion, Homemade Tomato Puree, Ginger Garlic Paste, Whole Cashews, Curd, Cloves, Mace, Cardamom, Cinnamon Stick, Cumin Seeds, Garam Masala Powder, Red Chilli Powder, Turmeric Powder, Coriander Powder, Kasuri Methi, Sugar, Salt, Coriander, Fresh Cream, Sunflower Oil",33,50,30,80,4,North Indian Recipes,Lunch,Vegetarian
Zucchini Roll Up Lasagne Recipe,"Green Zucchini, Salt, Extra Virgin Olive Oil, Mozzarella Cheese, Green Zucchini  Finely, Red Bell Pepper, Onion, Garlic, Dried Thyme Leaves, Rosemary, Red Chilli Flakes, Salt, Tomato, Onion, Garlic, Black Pepper Corns, Red Chilli Flakes, Sugar, Basil Leaves, Salt",20,20,45,65,4,Continental,Dinner,Vegetarian
Thengai Sadam Recipe (A Quick and Healthy Coconut Rice),"Fresh Coconut, Cooked Rice, Mustard Seeds, White Urad Dal, Chana Dal, Raw Peanuts, Curry Leaves, Green Chilli, Ginger, Coconut Oil, Salt",11,30,30,60,4,South Indian Recipes,Lunch,Vegetarian
Karwar Style Ambade Udid Methi Recipe - Hog Plum Curry,"Hog Plum, Fresh Coconut, Turmeric Powder, Coriander, Black Urad Dal, Rice, Methi Seeds, Whole Black Peppercorns, Dry Red Chilli, Jaggery, Asafoetida, Karela, Salt, Sunflower Oil, Sunflower Oil, Mustard Seeds, Asafoetida",17,25,25,50,4,Coastal Karnataka,Lunch,Vegetarian
Roasted Cauliflower Recipe,"Cauliflower, Garlic, Cumin Seeds, Coriander Powder, Black Pepper Powder Red Chilli Powder, Extra Virgin Olive Oil, Anardana Powder, Pomegranate Molasses, Fresh Herbs, Salt",10,15,25,40,4,South Indian Recipes,Dinner,Vegetarian
Pain Viennois | Vienna Bread Recipe,"Lukewarm Water, Active Dry Yeast, Sugar, Milk Powder, Vivatta Maida Half Of Bread Flour, Salt, Butter, Egg White",8,120,15,135,9,European,Main Course,Eggetarian
Crunchy Ginger Capsicum Rice Recipe,"Basmati Rice, Yellow Bell Pepper, Red Bell Pepper, Green Bell Pepper, Green Chilli, Ginger, Butter, Sesame Seeds, Salt",9,20,20,40,9,Indian,Lunch,Vegetarian
Bengali Chirer Payesh / Poha Pudding Recipe With Nolen Gur,"Poha, Rice Flour, Milk, Nolen Gur Brown Sugar, Cardamom, Mixed Nuts  Almondscashews, Raisins, Saffron Strands, Salt",9,15,30,45,6,Bengali Recipes,Dessert,Vegetarian
Makhan Recipe (Homemade Butter),"Fresh Cream, Water",2,10,0,10,10,North Indian Recipes,Side Dish,Vegetarian
Shanghai Style Chap Nian Gao Recipes (Stir Fried Rice Cakes Recipes),"Rice Flour, Salt, Sunflower Oil, Bok Choy, Carrot, Cabbage, Button Mushrooms, Corn Flour, Dark Soy Sauce, Bean Paste, Red Chilli Sauce, Sugar, Sunflower Oil, Salt",14,90,10,100,4,Chinese,One Pot Dish,Vegetarian
White Pumpkin Mor Kuzhambu Recipe - Kerala Style White Pumpkin Curry,"Curd, Fresh Coconut, Vellai Poosanikai, Green Chilli, Black Pepper Powder, Water, Turmeric Powder, Salt, Coconut Oil, Mustard Seeds, Methi Seeds, Curry Leaves, Dry Red Chilli",13,10,25,35,2,Kerala Recipes,Lunch,Vegetarian
Paneer and Green Peas Paratha Recipe,"Green Peas, Cheese, Ginger   Green Chili, Turmeric Powder, Red Chili Powder, Mango Powder Powder, Coriander Powder, Salt, Wheat Flour, Salt, Oil, Water",12,20,45,65,4,North Indian Recipes,North Indian Breakfast,High Protein Vegetarian
Elephant Yam Raita ,"Elephant Yam, Green Chilli, Ginger, Coriander, Salt, Curd, Oil, Asafetida, , ",10,15,25,40,4,Indian,Side Dish,Vegetarian
Drunken Noodles Recipe,"Rice Noodles, Baby Corn, Capsicum, Capsicum, Capsicum, Thai Basil Leaves, Green Onion, Garlic, Ginger, Brown Sugar, Honey, Soy Sauce, Fish Sauce, Sriracha Sauce",14,10,25,35,4,Thai,Main Course,Vegetarian
Chettinad Style Prawn Biryani Recipe,"Shrimps Prawns, Basmati Rice, Shallots, Ginger, Garlic, Fresh Coconut, Green Chilli, Hung Curd, Curry Leaves, Sunflower Oil, Ghee, Coriander Powder, Red Chilli Powder, Turmeric Powder, Garam Masala Powder, Whole Black Peppercorns, Cardamom, Black Cardamom, Cinnamon Stick, Bay Leaves, Dry Red Chilli, Cumin Seeds",22,30,25,55,4,Chettinad,Lunch,Non Vegeterian
Walnut and Flax Seed Trail Mix Recipe With Figs and Honey,"Walnuts, Dried Figs, Flax Seeds, Honey, Roasted Peanuts, Cinnamon Powder",6,5,20,25,4,Continental,World Breakfast,Vegetarian
Murgh Malaiwala Recipe - Chicken In Rich Creamy Gravy,"Chicken, Ginger, Garlic, Fresh Cream, Badam, Lemon Juice, Black Pepper Powder, Salt, Onion, Fresh Cream, Milk, Cardamom Powder, Cinnamon Stick, Bay Leaf, Kasuri Methi, Ghee",16,150,30,180,4,North Indian Recipes,Lunch,Non Vegeterian
Paal Kesari Recipe - South Indian Style Milk Kesari,"Sooji, Ghee, Milk, Sugar, Saffron Strands, Cardamom, Ghee, Cashew Nuts, Raisins, Mixed Dry Fruits",10,10,25,35,4,South Indian Recipes,Dessert,Vegetarian
Spicy Lemon Chicken Kebab Recipe,"Chicken Breasts, Red Bell Pepper, Onion, Lemon Juice, Dried Thyme Leaves, Red Chilli Flakes, Black Pepper Powder, Extra Virgin Olive Oil, Salt",9,60,30,90,4,Indian,Appetizer,Non Vegeterian
Layered Paneer Butter Masala Biryani Recipe,"Rice, Water, Ghee, Cardamom, , Star Anise, Cinnamon, Whole Black Pepper, Salt, Bay Leaf, Onion, Of Green Coriander, Of Mint, Of Cottage Cheese, Tomato, Cream, Onion, Ginger, Garlic, Green Chili, Cardamom Powder, Cumin Powder, Garam Masala Powder, Red Chilli Powder, Kasoori Methi, Honey, Salt, As Per, Cashews",29,20,25,45,4,North Indian Recipes,Main Course,Vegetarian
Gond Ke Ladoo Recipe - Edible Gum Ladoo,"Goond, Ghee, Whole Wheat Flour, Sugar, Dry Coconut, Badam, Cashew Nuts",7,15,60,75,20,North Indian Recipes,Dessert,Vegetarian
Mukhadi Halwa Recipe (Semolina & All Purpose Flour Halwa),"Sooji, All Purpose Flour, Milk, Sugar, Ghee",5,15,25,40,6,North Indian Recipes,Dessert,Vegetarian
Kobbari Chaaru Recipe,"Coconut Milk, Water, Roasted Chana Lentils, Green Chilli, Oil, Mustard, Small Spoon Turmeric Powder, Cumin Seeds, Curry Leaves, Salt, Coriander Leaves",11,10,40,50,4,South Indian Recipes,Lunch,High Protein Vegetarian
Tulsi Kashayam Recipe (Kaada) - Herbal Drink From Tulsi,"Water, Tulsi, Black Pepper Powder, Dry Ginger Powder, Palm Sugar",5,5,5,10,4,Indian,Side Dish,Vegetarian
Carrot Corn Mayo Pancake Recipe With Sandwich Spread,"Carrot, Sweet Corn, Whole Wheat Flour, Onion, Del Monte Sandwich Spread, Coriander, Curd, Whole Eggs, Baking Powder, Baking Soda, Green Chilli, Butter, Salt, Black Pepper Powder",14,15,40,55,4,Continental,World Breakfast,Vegetarian
Tamil Nadu Style Spicy Egg Fry Recipe,"Whole Eggs, Sunflower Oil, Roasted Gram Dal, Dry Red Chilli, Ginger, Garlic, Whole Black Peppercorns, Salt",8,5,30,35,4,Tamil Nadu,Appetizer,Eggetarian
Chirer Dudh Puli Recipe - Bengali Style Beaten Rice Dumpling Kheer,"Fresh Coconut, Palm Jaggery, Poha, All Purpose Flour, Sooji, Milk, Milk, Palm Jaggery",8,20,20,40,4,Bengali Recipes,Dessert,Vegetarian
Appalam Vatha Kuzhambu Recipe - Papad In Tamarind Gravy,"Gingelly Oil, Mustard Seeds, Methi Seeds, Asafoetida, Dry Red Chilli, Pearl Onion, Curry Leaves, Urad Dal Papad, Tamarind Water, Sambar Powder, Jaggery, Turmeric Powder, Water, Salt",14,5,20,25,3,South Indian Recipes,Lunch,Vegetarian
Kashmiri Style Modur Pulao With Pomegranate Recipe,"Basmati Rice, Cinnamon Stick, Cloves, Cardamom, Milk, Water, Saffron Strands, Cumin Powder, Sunflower Oil, Salt, Anardana Powder, Cashew Nuts, Badam, Raisins  Optional, Dates, Ghee",16,40,120,160,4,Kashmiri,Lunch,Vegetarian
North Indian Style Mushroom Matar Masala Recipe,"Button Mushrooms, Green Peas, Sunflower Oil, Cumin Seeds, Mustard Seeds, Asafoetida, Onion, Onion, Tomato, Ginger Garlic Paste, Green Chilli, Red Chilli Powder, Turmeric Powder, Coriander Powder, Garam Masala Powder, Water, Coriander",17,10,30,40,2,North Indian Recipes,Lunch,High Protein Vegetarian
Dhania Chole Masala Recipe - Chickpeas In Fresh Coriander Gravy,"Coriander, Green Chilli, Ginger, Salt, Lemon, Kabuli Chana, Ghee, Onion, Ginger, Garlic, Cinnamon Stick, Bay Leaf, Brown Cardamom, Black Salt, Garam Masala Powder, Coriander Powder, Black Salt, Salt, Salt",19,480,60,540,4,North Indian Recipes,Main Course,High Protein Vegetarian
Capsicum Masala Poriyal ,"Oil, Mustard, Capsicum, Capsicum, Capsicum, Onion, Curry Leaves, Salt, Peanuts, Coconut, Dry Red Chilli, Garlic, Cumin Seeds, Green Coriander",14,38,25,63,4,South Indian Recipes,Lunch,Vegetarian
Kerala Style Plantain & Yam Thoran Recipe,"Raw Banana, Suran, Black Gram, Turmeric Powder, Red Chili Powder, Salt, Cumin Seeds, Coconut, Whole Black Pepper, Garlic, Green Chili, Oil, Mustard",13,360,20,380,4,Kerala Recipes,Dinner,Vegetarian
Cheese Stuffed Aloo Bonda Recipe,"Potato, Mozzarella Cheese, Mustard Seeds, Ginger, Onion, Green Chilli, Asafoetida, Turmeric Powder, Coriander, Sunflower Oil, Gram Flour, Turmeric Powder, Salt",13,15,30,45,5,Indian,Snack,Vegetarian
Dahi Wale Paneer Recipe - Paneer In A Curd Gravy,"Paneer, Garlic, Ginger, Fresh Red Chilli, Red Bell Pepper, Cumin Powder, Coriander Powder, Garam Masala Powder, Curd, Butter, Onion, Homemade Tomato Puree, Whole Cashews Almonds, Fresh Cream, Coriander, Lemon Juice, Turmeric Powder, Lemon Juice, Turmeric Powder",19,65,15,80,6,North Indian Recipes,Lunch,High Protein Vegetarian
Nutty Aloo Paratha Recipe,"Whole Wheat Flour, Spinach Leaves, Water, Potato, Paneer, Coriander, Garam Masala Powder, Salt, Cumin Powder, Red Chilli Powder, Mixed Nuts, Raisins, Ghee Smear",13,25,30,55,4,North Indian Recipes,North Indian Breakfast,Vegetarian
Chicken Tikka Taco Recipe Topped With Cheesy Garlic Mayo,"Hard Taco Shells, Hariyali Chicken Tikka, Summer Salad, Refried Beans, Nutralite Cheesy Garlic Mayo, Tomato Salsa",6,20,0,20,4,Mexican,Dinner,Non Vegeterian
Masalewali Turai Sabzi Recipe,"Trumpet, Mustard, Cumin Seeds, Ginger, Tomato, Turmeric Powder, Red Chilli Powder, Small Spoon Coriander Powder, Jaggery, Oil, Salt, Water, Coriander Leaves",13,20,30,50,4,North Indian Recipes,Side Dish,Vegetarian
Pudina Mushroom And Soya Biryani Recipe,"Basmati Rice  Parboiled With Spices Infused Water, Button Mushrooms, Soy Chunks, Onion, Ginger, Curd, Biryani Masala, Garlic, Turmeric Powder, Garam Masala Powder, Red Chilli Powder, Mint Leaves, Salt, Ghee, Green Chilli, Ajwain, Bay Leaf, Star Anise, Cardamom, Cloves, Cinnamon Stick",21,20,40,60,4,Indian,Main Course,High Protein Vegetarian
White Vegetable Kurma Recipe With Coconut & Cashew,"Carrot, Potato, Cauliflower, Onion, Ginger Garlic Paste, Salt, Sunflower Oil, Fresh Coconut, Whole Black Peppercorns, Green Chilli, Fennel Seeds, Poppy Seeds, Cashew Nuts, Cinnamon Stick, Star Anise, Cloves, Cardamom, Cumin Seeds",18,5,25,30,4,South Indian Recipes,Side Dish,Vegetarian
Muttaikose Poriyal Recipe - Cabbage Stir fry With Coconut,"Cabbage, Mustard Seeds, White Urad Dal, Curry Leaves, Green Chilli, Fresh Coconut, Salt",7,15,30,45,3,South Indian Recipes,Side Dish,No Onion No Garlic (Sattvic)
Bengaluru Style Brinjal Gravy Recipe - For Biryani,"Brinjal, Tomato, Onion, Ginger Garlic Paste, Tamarind, Mustard Seeds, Whole Black Peppercorns, Jaggery, Turmeric Powder, Red Chilli Powder, Sunflower Oil, Salt, Coriander",13,50,40,90,4,Karnataka,Side Dish,Vegetarian
PF Chang's Style Crispy Chicken Lettuce Wraps Recipe,"Iceberg Lettuce, Chicken Breasts, Sunflower Oil, Salt, Black Pepper Powder, Garlic, Button Mushrooms, Spring Onion, Chilli Vinegar, Soy Sauce, Red Chilli Sauce, Sweet And Spicy Red Chilli Sauce",12,10,15,25,4,Asian,Appetizer,Non Vegeterian
Lemon Frozen Yogurt Recipe,"Lemon Juice, Curd, Sugar, Fresh Cream, Turmeric Powder, Vanilla Extract, Orange Zest, Orange",8,600,0,600,3,Continental,Snack,Vegetarian
Paneer Capsicum Sandwich Recipe,"Whole Wheat Brown Bread, Paneer, Green Bell Pepper, Green Chilli, Chaat Masala Powder, Black Pepper Powder, Butter, Salt",8,10,10,20,4,Continental,World Breakfast,High Protein Vegetarian
Sukhi Suran Masala Sabzi Recipe,"Elephant Yam, Onion, Green Chilli, Ginger, Garlic, Curry Leaves, Cumin Seeds, Turmeric Powder, Coriander Powder, Cumin Powder, Red Chilli Powder, Black Pepper Powder, Garam Masala Powder, Salt, Sunflower Oil",15,15,20,35,4,North Indian Recipes,Side Dish,Vegetarian
One Pot Pressure Cooker Chicken Curry Recipe,"Coconut Oil, Curry Leaves, Garlic, Ginger, Onion, Tomato, Turmeric Powder, Garam Masala Powder, Red Chilli Powder, Coriander Powder, Chicken Breast, Salt, Water",13,15,25,40,4,South Indian Recipes,Lunch,Non Vegeterian
Lauki Ka Salan Recipe - Bottle Gourd Salan Recipe,"Bottle Gourd, Onion, Garlic, Ginger, Green Chilli, Cumin Seeds, Mustard Seeds, Methi Seeds, Turmeric Powder, Red Chilli Powder, Coriander Powder, Tamarind Water, Tomato, Sunflower Oil Cook, Salt, Coriander, Roasted Peanuts, Sesame Seeds, Fresh Coconut",19,20,30,50,4,Andhra,Lunch,Vegetarian
Togari Bele Tovve Recipe  - Toor Dal Rasam,"Arhar Dal, Water, Turmeric Powder, Ginger, Green Chilli, Tamarind, Lemon Juice, Ghee, Mustard Seeds, Asafoetida, Curry Leaves, Coriander",12,10,25,35,4,South Indian Recipes,Lunch,High Protein Vegetarian
Chicken Shawarma Recipe,"Chicken Breasts, Coriander Powder, Red Chilli Powder, Cumin Powder, Black Pepper Powder, Turmeric Powder, Ginger Garlic Paste, Extra Virgin Olive Oil, Salt, Whole Wheat Flour, Active Dry Yeast, Milk, Sugar, Salt, Cucumber, Carrot, Tomato, Chilli Vinegar, Salt, Sugar, Homemade Hummus, Tzatziki, Onion",23,40,45,85,2,Middle Eastern,Main Course,Non Vegeterian
Mushroom Paratha Recipe,"Whole Wheat Flour, Sunflower Oil, Salt, Ghee Cook Parathas, Button Mushrooms, Onion, Cumin Seeds, Garam Masala Powder, Green Chilli, Turmeric Powder, Ghee Oil For Cooking",11,30,30,60,4,North Indian Recipes,Lunch,High Protein Vegetarian
Palak Chana Dal Recipe - Healthy Spinach Gram Dal Recipe,"Chana Dal, Spinach Leaves, Water, Turmeric Powder, Salt, Ghee, Asafoetida, Cumin Seeds, Dry Red Chilli, Ginger Garlic Paste, Onion, Green Chilli, Tomato, Turmeric Powder, Red Chilli Powder, Cumin Powder, Salt",17,20,30,50,4,North Indian Recipes,Lunch,High Protein Vegetarian
Pasi Paruppu Kosumalli Recipe (Spiced Lentil Salad Recipe),"Yellow Moong Dal, Cucumber, Carrot, Fresh Coconut, Lemon Juice, Salt, Sunflower Oil, Mustard Seeds, Green Chilli, Asafoetida, Curry Leaves, Coriander",12,15,30,45,4,South Indian Recipes,Lunch,Vegetarian
Maharashtrian Style Semolina and Yogurt Cake Recipe,"Sooji, Curd, Saffron Strands, Cardamom Powder, Baking Powder, Caster Sugar, Cashew Nuts, Raisins, Ghee",9,60,25,85,4,Maharashtrian Recipes,Dessert,Vegetarian
Ragi Masala Roti Recipe,"Ragi Flour, Onion, Green Chilli, Carrot, Dill Leaves, Coriander, Cumin Seeds, Salt, Ghee",9,20,20,40,4,South Indian Recipes,Lunch,Diabetic Friendly
Dry Sweet Potato Thoran Recipe,"Sweet Potato, Onion, Rasam Powder, Turmeric Powder, Asafoetida, Salt, Sunflower Oil, Mustard Seeds, White Urad Dal, Curry Leaves",10,10,10,20,4,Kerala Recipes,Side Dish,Vegetarian
Oreo Milkshake Recipe,"Oreo Biscuits, Vanilla Ice Cream, Milk, Chocolate Sauce, Chocolate Sauce, Heavy Whipping Cream",6,10,15,25,2,Continental,Snack,Vegetarian
Mexican Grilled Corn Flavoured With Cheesy Garlic Mayo Recipe,"Sweet Corn, Butter, Paprika Powder, Del Monte Cheesy Garlic Mayo, Lemon, Coriander, Parmesan Cheese",7,5,20,25,4,Mexican,Snack,Vegetarian
Paneer Matar Butter Masala (Indian Cottage Cheese and Peas Masala With Butter) Recipe,"Paneer, Sunflower Oil, Green Peas, Salt, Sugar, Red Chilli Powder, Milk, Kasuri Methi, Onion, Tomato, Ginger, Clove Garlic, Ghee Clarified Butter, Dry Red Chilli, Cardamom, Cinnamon Stick, Whole Black Peppercorns, Coriander, Cashew Nuts",19,15,45,60,4,North Indian Recipes,Dinner,High Protein Vegetarian
Dhungare Baingan Recipe,"Eggplant, Yogurt, Green Chilli, Cumin Powder, Kashmiri Red Chilli Powder, Garam Masala Powder, Onion, Salt, Coriander",9,5,20,25,4,Lucknowi,Side Dish,Vegetarian
Rajasthani Style Sukhe Gatte Capsicum Ki Sabzi Recipe,"Gram Flour, Ajwain, Red Chilli Powder, Curd, Sunflower Oil, Salt, Green Bell Pepper, Cumin Seeds, Asafoetida, Turmeric Powder, Red Chilli Powder, Garam Masala Powder, Amchur, Coriander Powder, Coriander Powder, Salt, Coriander, Sunflower Oil",18,10,30,40,4,Rajasthani,Side Dish,No Onion No Garlic (Sattvic)
Indo Chinese Crispy Chicken Chilli Recipe,"Chicken, Sunflower Oil, Garlic, Ginger, Green Chilli, Onion, Green Bell Pepper, Soy Sauce, Vinegar, Black Pepper Powder, Salt, Red Chilli Sauce, Green Chilli Sauce, Roasted Tomato Pasta Sauce, Corn Flour, Water, Black Pepper Powder, Soy Sauce, Red Chilli Sauce, Corn Flour, All Purpose Flour, Water, Salt",23,10,60,70,3,Fusion,Appetizer,High Protein Non Vegetarian
Aar Macher Jhol Recipe - Bengali Fish Curry,"Aar Maach, Tomato, Bay Leaf, Ginger Garlic Paste, Green Chilli, Cumin Seeds, Coriander Powder, Red Chilli Powder, Turmeric Powder, Mustard Oil, Salt, Water, Coriander",13,10,40,50,2,Bengali Recipes,Lunch,High Protein Non Vegetarian
Thandu Keerai Puli Kuzhambu Recipe - Amaranth Greens in Tangy Curry,"Green Amaranth Leaves, Tamarind, Onion, Tomato, Garlic, Mustard Seeds, Asafoetida, Curry Leaves, Sambar Powder, Methi Powder, Sesame, Salt, Salt",13,10,20,30,4,South Indian Recipes,Lunch,Diabetic Friendly
Crispy Masala Peanuts Recipe - Gujarati Sing Bhujia,"Raw Peanuts, Gram Flour, Rice Flour, Red Chilli Powder, Coriander Powder, Chaat Masala Powder, Water, Black Pepper Powder, Sunflower Oil, Salt, Sunflower Oil Fry",11,10,25,35,3,Gujarati Recipesï»¿,Snack,High Protein Vegetarian
Maa Ki Dal ,"Black Urad Dal, Kidney Beans, Tomato, Ginger, Ghee, Cumin Seeds, Kashmiri Red Chilli Powder, Coriander Powder, Garam Masala Powder, Salt",10,10,150,160,4,Punjabi,Dinner,High Protein Vegetarian
Palak Mushroom Makhani Recipe - Creamy Spinach & Mushroom,"Button Mushrooms, Spinach Leaves, Tomato, Garlic, Ginger, Green Chilli, Cumin Seeds, Cinnamon Stick, Cumin Powder, Turmeric Powder, Garam Masala Powder, Fresh Cream, Ghee, Salt",14,10,30,40,4,North Indian Recipes,Lunch,High Protein Vegetarian
Dahi Bhalla Papdi Chaat Recipe,"Curd Vada, Papdi Puris, Sweet Chutney, Green Chutney, Chaat Masala Powder, Cumin Powder, Onion, Carrot, Anardana Powder, Raw Peanuts, Boondi Sev, Coriander",12,10,30,40,4,North Indian Recipes,Lunch,High Protein Vegetarian
Wheat Grass Shikanji - Wheat Grass Lemonade Recipe,"Wheat Grass Powder, Black Pepper Powder, Black Salt, Cumin Powder, Lemon",5,10,20,30,3,Indian,Snack,Vegetarian
Dry Masala Chickpeas ,"Kabuli Channa, Oil, Cumin Seeds, Gingerpaste, Chana Masala Powder, Red Chilli Powder, Spoon Cumin Powder, Amchoor Powder, Turmeric Powder, Coriander Powder, Salt",11,10,30,40,2,Punjabi,Lunch,High Protein Vegetarian
Rajasthani Kachri Ki Chutney Recipe,"Kachris, Garlic, Dry Red Chilli, Cumin Seeds, Salt, Curd, Ghee",7,10,8,18,2,Rajasthani,Side Dish,Vegetarian
Potato Paneer Curry Without Onion And Garlic Recipe ,"Potato, Cheese, Tomato, Ginger, Green Chilli, Red Chilli Powder, Coriander Powder, Cumin Powder, Salt, Oil  Green Coriander  Finely  Accordinguse",10,20,60,80,4,North Indian Recipes,Lunch,Vegetarian
Katachi Amti ,"Lentil Water, Water, , Whole Black Peppers, Cumin, Mustard, Bay Leaf, Curry Leaves, Jaggery, Tamarind Paste, Goda Masala, Oil, Coriander Leaves, Salt",14,10,15,25,4,Maharashtrian Recipes,Lunch,Vegetarian
Khara Obbattu Recipe (Bread Stuffed With Spicy Potato Mixture Recipe),"Whole Wheat Flour, All Purpose Flour, Sooji, Curd, Turmeric Powder, Salt, Sunflower Oil, Potato, Cumin Seeds, Onion, Garlic, Ginger, Green Chilli, Curry Leaves, Coriander, Red Chilli Powder, Turmeric Powder, Salt, Sunflower Oil",19,30,45,75,4,Karnataka,Lunch,Vegetarian
Cauliflower Matar Bhurji ,"Cabbage, Green Peas, Onion, Green Chilli, Tomato, Ginger Garlic Paste, Turmeric Powder, Garam Masala Powder, , Red Chilli Powder, Salt, Coriander Leaves",12,10,35,45,3,Indian,Dinner,Vegetarian
Kashmiri Style Paneer Masala Recipe,"Paneer, Asafoetida, Cinnamon Stick, Bay Leaves, Cardamom, Ajwain, Homemade Tomato Puree, Kashmiri Red Chilli Powder, Dry Ginger Powder, Curd, Fennel Seeds, Saffron Strands, Garam Masala Powder, Salt, Coriander",15,5,30,35,4,Kashmiri,Lunch,Vegetarian
Aromatic Vegetable Pulao Recipe,"Rice, Sunflower Oil, Onion, Tomato, Ginger Garlic Paste, Red Chilli Powder, Carrots, Green Peas, Green Bell Pepper, Potato, Cardamom, Cloves, Garam Masala Powder, Star Anise, Cinnamon Stick, Coriander, Mint Leaves, Salt",18,20,30,50,4,Indian,Lunch,Vegetarian
Spiced Curd With Onions ,"Water, Curd, Carrot, Cucumber, Salt, Oil, Coriander Leaves, Cumin Seeds, Teaspoon Red Chilli Powder, Cumin Seeds, Onion, Green Chili",12,10,20,30,2,Indian,Side Dish,Vegetarian
Mustard Vegetable Curry ,"Oil, Cumin Seeds, Garlic, Onion, Red Chilli Powder, Turmeric Powder, Coconut Milk, Vegetable Stock, Dijon Mustard, Carrots, Green Beans, Green Peas, Potato, Salt",14,20,30,50,4,Indian,Side Dish,Vegetarian
One Pot Spicy Vegetable Pulao Recipe with Coconut Milk,"Basmati Rice, Coconut Milk, Turmeric Powder, Green Beans, Cauliflower, Carrots, Garlic, Ginger, Green Chilli, Cloves, Cardamom, Cinnamon Stick, Bay Leaf, Salt, Ghee",15,10,30,40,3,Indian,Dinner,Vegetarian
Bengali Aloo Dum Recipe,"Small Potato, Turmeric Powder, Cardamom, Cinnamon, , Bay Leaf, Tomato Puree, Garam Masala Powder, Yogurt, Red Chilli Powder, Coriander Powder, Sugar, Salt, Oil, Stock Green Coriander, Onion, Ginger, Garlic, Green Chilli",19,20,50,70,4,Bengali Recipes,Main Course,Vegetarian
Hyderabad Soy Biryani Recipe With Vegetables & Palak,"Basmati Rice, Water, Salt, Soy Chunks, Carrots, Green Beans, Green Peas, Cauliflower, Green Bell Pepper, Potato, Tomato, Onion, Ginger Garlic Paste, Sunflower Oil Cook, Cinnamon Stick, Cardamom, Cloves, Cumin Seeds, Spinach Leaves, Coriander, Mint Leaves, Green Chilli, Badam, Cinnamon Stick, Cardamom, Black Cardamom, Cloves, Bay Leaf, Ajwain, Mace, Turmeric Powder, Red Chilli Powder, Coriander Powder, Garam Masala Powder, Salt, Onion, Coriander, Mint Leaves, Milk, Saffron Strands, Ghee",41,40,50,90,4,Hyderabadi,Main Course,Vegetarian
North Indian Pheni Recipe - Seviyan Kheer,"Pheni One Roll, Milk, Sugar, Ghee, Cashew Nuts, Raisins, Almond Meal",7,10,15,25,4,North Indian Recipes,Dessert,Vegetarian
Appalam Vathal Kuzhambu ,"Papad, Tamarind, Sambar Powder, Turmeric Powder, Horsepowder, Mustard, Lentils, Asafoetida, Dry Red Chili, Curry Leaves, Sesame Oil, Salt",12,10,15,25,4,Tamil Nadu,Dinner,Vegetarian
Moong Dal Khichdi Recipe For Babies And Toddlers Over 10 Months,"Rice, Yellow Moong Dal, Carrot, Green Beans, Ghee, Cumin Seeds, Asafoetida, Salt",8,10,20,30,4,Indian,Lunch,Vegetarian
Dahi Wale Aloo Recipe (Indian Yogurt-based Potato Curry),"Potato, Curd, Gram Flour, Asafoetida, Cumin Seeds, Curry Leaves, Onion, Ginger, Garlic, Green Chilli, Red Chilli Powder, Coriander Powder, Turmeric Powder, Salt, Sunflower Oil, Coriander",16,10,45,55,4,North Indian Recipes,Lunch,Vegetarian
Vegetable Fried Brown Rice Recipe,"Brown Rice, Garlic, Green Chilli, Carrots, Green Beans, Green Bell Pepper, Onion, Cabbage, Roasted Tomato Pasta Sauce Store Bought, Red Chilli Sauce, Soy Sauce, Ginger, Spring Onion Greens, Salt, Vinegar, Extra Virgin Olive Oil",16,15,25,40,4,Chinese,Lunch,Vegetarian
Eggless Devil's Food Cake Recipe,"All Purpose Flour, Cocoa Powder, Baking Powder, Salt, Butter, Caster Sugar, Vanilla Extract, Whole Eggs, Curd, Red Food Color, Chocolate Ganache, Flax Seed Powder, Chilled Water",13,20,90,110,6,Continental,Dessert,Vegetarian
Bengali Langcha Recipe With Mawa,"Milk, Sooji, Milk Powder, All Purpose Flour, Baking Soda, Caster Sugar, Sugar, Water, Cardamom Powder, Pistachios, Ghee Vegetable Oil",11,20,30,50,4,Bengali Recipes,Dessert,Vegetarian
Kovakkai Podi Curry Recipe - Tamil Nadu Style Ivy Gourd Stir Fry,"Tindora, Mustard Seeds, White Urad Dal, Asafoetida, Curry Leaves, Dry Red Chilli, Sunflower Oil, Salt, Coriander, White Urad Dal, Chana Dal, Dry Red Chilli, Asafoetida",13,15,20,35,4,Tamil Nadu,Lunch,Diabetic Friendly
Biryani Masala Powder Recipe,"Bay Leaves, Coriander Seeds, Whole Pepper, Celery, Cumin Seeds, Cardamom, Large Cardamom, Mace, Stone Flowers, Star Anis, Small Spoon Nutmeg Powder, Cinnamon, Long",13,5,5,10,4,Hyderabadi,Lunch,Diabetic Friendly
"Chicken Sausages, Baked Beans and Stir Fried Broccoli Recipe","Chicken Sausage, Butter, Dry Beans, Extra Virgin Olive Oil, Onion, Clove Garlic, Tomato, Honey More, Cumin Powder, Dried Oregano, Red Chilli Powder Cayenne Pepper, Salt And Pepper, Broccoli, Garlic, Dried Thyme Leaves, Dried Oregano, Salt, Black Pepper Powder",18,10,30,40,1,Continental,World Breakfast,Non Vegeterian
Crispy Chicken Pakoda Recipe,"Boneless Chicken, Ginger Garlic Paste, Red Chilli Powder, Coriander Powder, Turmeric Powder, Black Pepper Powder, Green Chilli, Curry Leaves, Whole Egg, Gram Flour, Corn Flour, Salt, Sunflower Oil Deep Fry",13,0,35,35,1,Indian,Snack,Vegetarian
Turkish Chicken Gozleme Recipe-Stuffed Spinach Chicken Bread,"All Purpose Flour, Whole Wheat Flour, Hung Curd, Salt, Chicken, Spinach Leaves, Onion, Garlic, Tomato, Cumin Powder, Coriander Powder, Paprika Powder, Black Pepper Powder, Mint Leaves, Spring Onion, Salt, Feta Cheese",17,10,45,55,2,Middle Eastern,Lunch,Non Vegeterian
Moon Biscuits Recipe (Moon Shaped Baked Cookies),"Vivatta Maida, Sugar, Butter, Milk Powder, Baking Powder, Vanilla Extract",6,25,15,40,30,Indian,Snack,Vegetarian
Andaman Style Steamed Garlic Prawns Recipe,"Prawns, Soy Sauce, Sesame, Garlic, Green Chilli, Coriander, Whole Black Peppercorns, Lemon Juice, Sunflower Oil, Salt",10,10,30,40,2,Side Dish,Non Vegeterian,Vegetarian
Fruit Pachadi ,"Fruit, Yogurt, Turmeric Powder, Jaggery, Salt, Water, Coconut, Green Chilli, Mustard, Mustard, Dry Red Peppers, Oil, Curry Leaves",13,5,15,20,4,South Indian Recipes,Side Dish,Vegetarian
Aloo Matar Masala Khichdi Recipe,"Rice, Green Peas, Potato, Onion, Ginger Garlic Paste, Green Chilli, Black Cardamom, Bay Leaf, Cardamom, Cinnamon Stick, Cloves, Cumin Seeds, Coriander Powder, Cumin Powder, Black Pepper Powder, Red Chilli Powder, Ghee, Coriander, Salt",19,5,20,25,4,Indian,Main Course,Vegetarian
Rock Toast Recipe - Semolina Bread Toast,"Sooji, Curd, Onion Powder, Green Bell Pepper, Coriander, Green Chilli, Black Pepper Powder, Salt, Sunflower Oil",9,10,8,18,3,Indian,Indian Breakfast,Vegetarian
Potato Vindaloo Recipe (Spicy Goan Potato Curry),"Kashmiri Dry Red Chilli, Methi Seeds, Garlic, Shallots, Cumin Seeds, Turmeric Powder, Vinegar, Water, Potato, Salt, Sunflower Oil, Mustard Seeds, Curry Leaves, Water, Sugar",15,10,30,40,4,Goan Recipes,Lunch,Vegetarian
Aloo Potol Posto Recipe (Aloo Parwal in Poppy Seed Masala Recipe),"Pointed Gourd, Potato, Methi Seeds, Cumin Seeds, Fennel Seeds, Cloves, Cinnamon Stick, Dry Red Chilli, Ginger, Fresh Coconut, Poppy Seeds, Red Chilli Powder, Turmeric Powder, Green Chilli, Sugar, Salt, Mustard Oil",17,15,45,60,6,Bengali Recipes,Dinner,Vegetarian
Aloo Bhey Ki Sabzi Recipe (Potato Lotus Stem Curry),"Potato, Lotus Stem, Homemade Tomato Puree, Cumin Seeds, Asafoetida, Coriander Powder, Turmeric Powder, Red Chilli Powder, Garam Masala Powder, Salt, Sunflower Oil, Coriander, Onion, Garlic, Ginger, Green Chilli",16,15,30,45,4,North Indian Recipes,Lunch,Vegetarian
Classic Grilled Tomato Cucumber Chutney Sandwich Recipe,"Whole Wheat Brown Bread, Tomato, Cucumber, Salt Sprinkle, Black Pepper Powder Sprinkle, Chaat Masala Powder Sprinkle, Butter, Green Chutney, Tomato Ketchup",9,10,5,15,4,Indian,Snack,Vegetarian
Homemade Granola Mix Recipe with Oats & Wheat Flakes,"Instant Oats, Wheat Flakes, Pine Nuts, Pumpkin Seeds, Dates, Dried Raspberries, Raisins, Badam, Walnuts, Cinnamon Powder, Nutmeg Powder, Vanilla Extract, Sunflower Oil, Honey",14,10,30,40,4,Continental,World Breakfast,High Protein Vegetarian
Baingan Sarson Ka Saag Recipe,"Small Brinjal, Mustard Greens, Onion, Garlic, Ginger, Cumin Seeds, Red Chilli Powder, Coriander Powder, Garam Masala Powder, Amchur, Salt, Mustard Oil",12,10,15,25,4,North Indian Recipes,Lunch,Diabetic Friendly
Kalyana Veetu Senai Curry Recipe - South Indian Spicy Roasted Yam,"Elephant Yam, Fresh Coconut, Mustard Seeds, Curry Leaves, Asafoetida, Mustard Seeds, Red Chilli Powder, Coriander Powder, Turmeric Powder, Sambar Powder, Salt, Sunflower Oil",12,30,30,60,4,Tamil Nadu,Side Dish,Vegetarian
Chettinad Takkali Sadam Recipe (Chettinad Style Tomato Rice),"Rice, Tomato, Onion, Red Chilli Powder, Green Chilli, Mint Leaves, Coriander, Cinnamon Stick, Cloves, Curry Leaves, Ghee, Salt, Ginger, Garlic, Fennel Seeds",15,5,15,20,2,Chettinad,Lunch,Gluten Free
Thai Yellow Coconut Curry Rice Recipe,"Cumin Seeds, Cinnamon Stick, Dry Ginger Powder, Turmeric Powder, Red Chilli Powder, Coriander, Fennel Seeds, Whole Black Peppercorns, Garlic, Cardamom, Mace, Jasmine Rice, Coconut Milk, Salt, Coconut Oil, Onion, Red Bell Pepper, Gawar Phali, Ginger, Stalks Lemongrass, Garlic, Lemon Juice, Jaggery, Salt, Thai Basil Leaves",25,15,60,75,4,Thai,Lunch,Vegetarian
Stuffed Bhindi With Paneer ,"Okra, Oil, Onion, Tomato, Ginger, Garlic, Cumin Seeds, Teaspoon Asafoetida, Salt, Of Cottage Cheese, Coriander Powder, Mango Powder, Red Chilli Powder, Turmeric Powder, Salt",15,10,30,40,2,North Indian Recipes,Lunch,Vegetarian
Bael Ka Sharbat Recipe - Wood Apple Squash Drink,"Wood Apple, Jaggery Sugar, Black Salt, Cumin Powder, Lemon Juice, Mint Leaves, Water, Ice Cubes",8,10,0,10,2,North Indian Recipes,Appetizer,Vegetarian
Raw Mango Murabba Recipe - Cinnamon Spiced Mango Jam,"Mango, Sugar, Saffron Strands, Cinnamon Powder",4,20,15,35,4,Indian,Side Dish,Vegetarian
Karnataka Style Gorai Kai Kara Recipe - Cluster Beans Chutney,"Gawar Phali, Ginger, Garlic, Green Chilli, Roasted Peanuts, Coriander, Cumin Seeds, Tamarind, Salt, Mustard Seeds, White Urad Dal, Asafoetida",12,5,35,40,4,Karnataka,South Indian Breakfast,Diabetic Friendly
Kunafa With Mango Cottage Cheese Cream Recipe,"Kataifi Dough, Butter, Sugar, Rose Water, Sugar, Water, Lemon Juice, Rose Water, Saffron Strands, Paneer, Mango Pulp, Icing Sugar, Thandai Masala, Heavy Whipping Cream, Fresh Cream, Pistachios, Dried Rose Petals",17,10,60,70,4,Arab,Dessert,Vegetarian
Royal Bread Gulab Jamun Recipe,"Whole Wheat Brown Bread, Milk, Khoya, Sugar, Badam, Ghee",6,10,30,40,10,Indian,Dessert,Vegetarian
Safed Achari Baingan Recipe - White Aubergine in pickled spices,"Brinjal, Onion, Cumin Seeds, Mustard Seeds, Ginger, Garlic, Turmeric Powder, Coriander Powder, Red Chilli Powder, Amchur, Tomato, Salt, Coriander, Red Chilli Powder, Mustard Seeds, Cumin Seeds, Fennel Seeds, Kalonji, Ajwain, Methi Seeds, Dry Red Chilli, Sunflower Oil",22,20,40,60,4,Indian,Dinner,Vegetarian
Potlakaya Perugu Pachadi Recipe (Curd and Snake Gourd Chutney),"Snake Gourd, Curd, Fresh Coconut, Sunflower Oil, Turmeric Powder, Salt, Dry Red Chilli, Cumin Seeds, Mustard Seeds, Sunflower Oil, Asafoetida",11,20,20,40,4,South Indian Recipes,Side Dish,Diabetic Friendly
Karela Dahi Puri Recipe - A Chatpata Chaat Made From Bitter Gourd,"Karela, Coriander Powder, Red Chilli Powder, Asafoetida, Gram Flour, Black Salt, Sunflower Oil, Hung Curd, Chaat Masala Powder, Sweet Chutney, Sev, Aloo Bhujia, Dates, Coriander",14,15,10,25,2,Indian,Snack,Vegetarian
Kasuri Methi Aur Aloo Rasedar Recipe,"Potato, Tomato, Ginger  Grated And Ground, Green Chilli, Kasuri Methi, Fennel Seeds, Cumin Seeds, Methi Seeds, Coriander Powder, Red Chilli Powder, Cumin Powder, Turmeric Powder, Garam Masala Powder, Amchur, Ghee, Salt",16,20,10,30,4,North Indian Recipes,Side Dish,Vegetarian
Sprouted Matki Cheela Recipe With Palak -Moth Beans Cheela,"Moth Sprouts, White Urad Dal, Green Chilli, Fennel Seeds, Ginger, Spinach Leaves, Salt, Turmeric Powder, Sunflower Oil",9,250,15,265,4,North Indian Recipes,North Indian Breakfast,Diabetic Friendly
Malabar Kaai Curry Recipe With Nenthrapazham,"Banana Flower, Coconut Milk, Coconut Milk, Rice, Chana Dal, Onion, Cardamom, Sugar, Salt, Water",10,60,30,90,4,Kerala Recipes,Dessert,Gluten Free
Assamese Sweet Kordoi Recipe,"Whole Wheat Flour, Salt, Ghee, Lukewarm Water, Caster Sugar, Water, Sunflower Oil Deep Fry",7,20,20,40,4,Assamese,Snack,Vegetarian
Steamed Bafauri Recipe (Bhojpuri Style Steamed Chana Dal Balls),"Chana Dal, Onion, Garlic, Green Chilli, Ajwain, Coriander, Salt",7,10,20,30,4,Bihari,Snack,High Protein Vegetarian
Jodhpuri Aloo Recipe,"Baby Potato, Dry Red Chilli, Sesame Seeds, Cumin Seeds, Fennel Seeds, Asafoetida, Turmeric Powder, Kashmiri Red Chilli Powder, Red Chilli Flakes, Amchur, Coriander, Sunflower Oil, Salt",13,10,20,30,4,Rajasthani,Lunch,Vegetarian
Vendakkai Thoran Recipe - Kerala Style Bhindi Stir Fry,"Bhindi, Pearl Onion, Fresh Coconut, Green Chilli, Curry Leaves, Mustard Seeds, Turmeric Powder, Salt, Sunflower Oil",9,15,15,30,4,Kerala Recipes,Lunch,Diabetic Friendly
Chana Aur Aloo Ki Sookhi Sabzi Recipe,"Kabuli Chana, Potato, Onion, Tomato, Green Chilli, Ginger Garlic Paste, Red Chilli Powder, Turmeric Powder, Coriander Powder, Garam Masala Powder, Amchur, Cumin Seeds, Coriander, Ginger, Sunflower Oil, Salt",16,10,20,30,3,North Indian Recipes,Lunch,High Protein Vegetarian
Tomato Chicken Roast Recipe Flavoured With Kasuri Methi,"Chicken Thighs, Onion, Garlic, Ginger, Tomato, Coriander, Green Chilli, Kasuri Methi, Turmeric Powder, Kashmiri Red Chilli Powder, Garam Masala Powder, Coriander Powder, Sunflower Oil, Salt",14,10,50,60,3,Indian,Side Dish,Non Vegeterian
Nellikai Oorugai/Amla Sambhariyo Recipe (Instant Gooseberry Pickle Recipe),"Amla, Methi Seeds, Mustard Seeds, Mustard Oil, Red Chilli Powder, Asafoetida, Salt",7,15,0,15,80,Indian,Side Dish,Vegetarian
Baingan Sarson Ka Saag Recipe,"Brinjal, Mustard, Onion, Garlic, Ginger, Cumin, Red Chili Powder, Coriander Powder, Garam Masala Powder, Mango Powder, Salt, Mustard Oil",12,10,15,25,4,North Indian Recipes,Lunch,Diabetic Friendly
Stuffed Arbi Paratha Recipe,"Colocasia Root, Green Chilli, Cumin Powder, Coriander Powder, Red Chilli Powder, Turmeric Powder, Garam Masala Powder, Amchur, Salt, Coriander, Whole Wheat Flour, Sunflower Oil, Salt",13,10,45,55,4,North Indian Recipes,Lunch,Vegetarian
Tomato Curry Leaf Chutney Recipe,"Tomato, Curry Leaves, Green Chilli, Turmeric Powder, Green Coriander, Salt Rock Salt, Sugar",7,20,20,40,4,South Indian Recipes,Side Dish,Vegetarian
Rajasthani Gunde Ki Sabzi Recipe (Bird Lime Stir Fry),"Gunde, Methi Seeds, Sunflower Oil, Water, Cumin Seeds, Asafoetida, Fennel Seeds, Mustard Seeds, Turmeric Powder, Red Chilli Powder, Amchur, Coriander",12,20,30,50,4,Rajasthani,Side Dish,Vegetarian
Raw Jackfruit Burrito Recipe,"Jackfruit Raw, Onion, Garlic, Ginger, Cumin Powder, Black Pepper Powder, Cinnamon Powder, Paprika Powder, Turmeric Powder, Salt, Rajma, Onion, Tomato, Garlic, Cumin Powder, Red Chilli Powder, Black Pepper Powder, Sugar, Salt, Cooked Rice, Dried Thyme Leaves, Paprika Powder, Salt, Red Bell Pepper, Yellow Bell Pepper, Green Bell Pepper, Onion, Paprika Powder, Cumin Powder, Salt And Pepper, Sour Cream, Tomato Salsa, Tortillas",33,20,45,65,4,Mexican,Lunch,Vegetarian
Bengali Cholar Dal Recipe,"Chana Dal, Fresh Coconut, Ghee, Turmeric Powder, Salt, Mustard Oil, Dry Red Chilli, Cloves, Cinnamon Stick, Bay Leaf, Cumin Seeds, Green Chilli, Ginger",13,10,30,40,3,Bengali Recipes,Lunch,High Protein Vegetarian
Hyderabadi Vegetable Biryani Recipe,"Green Beans, Carrots, Cabbage, Potato, Garlic, Ginger, Onion, Rice, Make  Tomatopuree, Curd, Cinnamon, Cardamom, Bay Leaves, Turmeric Powder, Red Chilli Powder, Small Spoon Coriander Powder, Salt, Oil, S Of Mint   Onion  Finely  And Cook Till It Turns Brown",19,20,60,80,4,Hyderabadi,Lunch,Vegetarian
Chocolate Chip & Raisin Rolls Recipe,"Whole Wheat Flour, All Purpose Flour, Milk, Active Dry Yeast, Honey Jaggerysugar, Butter, Salt, Water As Required, Raisins, Chocolate Chips, Butter  Ricotta Cheesecream Cheesesoft Paneer, Orange Zest, Sugar Sprinkle On Top",13,25,180,205,4,Continental,Snack,Vegetarian
Baby Corn Cigar Recipe,"Baby Corn Be Blanched, Whole Wheat Bread Crumbs, Corn Flour, Extra Virgin Olive Oil, Vinegar, Potato, Coriander, Pizza Seasoning, Garlic, Red Chilli Powder, Green Chilli Paste, Ginger, Salt, Sunflower Oil",14,10,40,50,3,North Indian Recipes,Appetizer,Vegetarian
Gehu Bajra Thepla Recipe - Bajra Masala Paratha,"Bajra Flour, Whole Wheat Flour, Turmeric Powder, Black Pepper Powder, Ginger, Green Chilli, Coriander, Sunflower Oil",8,5,40,45,4,Gujarati Recipesï»¿,Main Course,Diabetic Friendly
Kaju Badam Ladoo Recipe,"Cashew Nuts, Badam, Sugar, Water, Cardamom Powder, Ghee",6,15,30,45,8,Indian,Dessert,Vegetarian
Spaghetti Aglio Olio With Parmesan & Greens Recipe,"Spaghetti Pasta, Spinach Amaranth Leaves, Garlic, Lemon Zest, Salt, Extra Virgin Olive Oil, Parmesan Cheese",7,10,60,70,4,Italian Recipes,Dinner,Vegetarian
Mushroom Dumpling Recipe With Potatoes (Momos),"Button Mushrooms, Potato, Onion, Green Chilli, Ginger, Salt, Sunflower Oil, All Purpose Flour",8,20,20,40,4,Asian,Snack,High Protein Vegetarian
Tomato Curry Leaf Chutney With No Onion No Garlic Recipe,"Tomato, S Curry Leaves, Green Chilli, Turmeric Powder, Coriander, Salt Rock Salt, Sugar",7,20,20,40,4,South Indian Recipes,Side Dish,Vegetarian
Baked Oats and Whole Wheat Kachori Stuffed with Peas Recipe,"Whole Wheat Flour, Instant Oats, Extra Virgin Olive Oil, Salt, Ajwain, Water Knead, Green Peas, Green Chilli, Coriander, Amchur, Chaat Masala Powder, Red Chilli Powder, Salt",13,20,45,65,4,North Indian Recipes,Snack,Vegetarian
Masala Carrot And Peas Sandwich Recipe,"Whole Wheat Brown Bread, Carrot, Green Peas, Garlic, Green Chilli, Black Pepper Powder, Chaat Masala Powder, Cheese, Salt",9,20,30,50,4,Continental,World Breakfast,Vegetarian
Bharwa Pyaz Ki Sabzi Recipe,"Small Onion, Red Chili Powder, Turmeric Powder, Mango Powder, Coriander Powder, Salt, Garlic, Ginger, Sprig Coriander",9,10,15,25,4,North Indian Recipes,Side Dish,Vegetarian
Aam Panna Pani Puri Recipe,"Pani Puris, Potato, Green Moong Sprouts, Salt, Cumin Powder, Chaat Masala Powder, Red Chilli Powder, Mango, Mint Leaves, Cumin Powder, Black Salt, Black Pepper Powder, Sugar",13,15,20,35,4,North Indian Recipes,Appetizer,Vegetarian
Quinoa Vegetable Upma Recipe,"Quinoa, Water, Extra Virgin Olive Oil, Mustard Seeds, Cumin Seeds, White Urad Dal, Chana Dal, Curry Leaves, Green Chilli, Shallot, Tomato, Carrot, Del Monte Whole Corn Kernels, Green Peas, Green Beans, Coriander Powder, Garam Masala Powder, Salt, Coriander",19,20,30,50,3,Fusion,Indian Breakfast,Diabetic Friendly
Whole Wheat Espresso Chocolate Streusel Cake Recipe,"Apricots, Whole Wheat Flour, Brown Sugar, Butter, Cinnamon Powder, Sugar, Pecans, Whole Wheat Flour, Butter, Cocoa Powder, Dark Chocolate, Brown Sugar, Coffee Decoction, Whole Eggs, Vanilla Extract, Sour Cream, Baking Powder, Baking Soda",18,10,75,85,2,Continental,Dessert,Vegetarian
Basella Fritters Recipe - Malabar Spinach Fritters,"Basella, Red Chilli Powder, Turmeric Powder, Salt, Gram Flour, Corn Flour, Cumin Seeds, Enos Fruit Salt Baking Powder, Red Chilli Powder, Sunflower Oil, Water, Sunflower Oil, Tomato Ketchup",13,15,10,25,2,Malabar,Snack,Vegetarian
Fig Honey & Paprika Preserve Recipe,"Fresh Figs, Lemon Juice, Lemon Zest, Red Chilli Flakes, Honey, Brown Sugar",6,0,40,40,20,Malabar,Snack,Vegetarian
Sepu Vadi Recipe (Himachali Split Urad Dal Dumplings In Spinach Gravy),"Black Urad Dal, Green Chilli, Ginger, Salt, Enos Fruit Salt Soda, Lemon Juice, Sunflower Oil, Spinach, Curd, Mustard Oil, Dry Red Chilli, Cloves, Cinnamon Stick, Cardamom, Bay Leaf, Cumin Seeds, Green Chilli, Asafoetida, Coriander Powder, Cumin Powder, Red Chilli Powder, Fennel Powder, Black Pepper Powder, Dill Leaves, Salt",25,35,20,55,3,Himachal,Side Dish,High Protein Vegetarian
Himachali Dry Raw Mango Chutney Recipe,"Aam Papad, Mint Leaves, Coriander, Green Chilli, Sugar, Salt, Hot Water",7,10,10,20,3,Himachal,Side Dish,Vegetarian
Vegan Navratan Korma Recipe,"Carrots, Green Beans, Cauliflower, Potato, Tofu, Onion, Green Chilli, Ginger Garlic Paste, Turmeric Powder, Red Chilli Powder, Cardamom, Black Cardamom, Cloves, Ginger, Coconut Yogurt, Coconut Milk, Mint Leaves, Saffron Strands, Edible Silver Foilleaf, Pineapple, Raisins, Cashew Nuts  Toasted, Badam, Pistachios, Garam Masala Powder, Coconut Oil, Poppy Seeds, Cashew Nuts, Badam",29,60,30,90,4,North Indian Recipes,Lunch,Vegan
Lentils and Mixed Grains Kichada Recipe,"Broken Wheat, Bajra, Jowar Seeds, Chana Dal, Masoor Dal, Rice, Garlic, Ginger, Green Chilli, S Curry Leaves, Coriander, Cumin Powder, Red Chilli Powder, Turmeric Powder, Garam Masala Powder, Asafoetida, Sunflower Oil, Onion, Lemon Juice, Salt",20,20,40,60,4,Rajasthani,Dinner,High Protein Vegetarian
Chettinad Pakora Curry Recipe,"Chana Dal, Dry Red Chilli, Fennel Seeds, Salt, Sunflower Oil, Onion, Tomato, Green Chilli, Garlic, Coriander Powder, Red Chilli Powder, Cinnamon Stick, Bay Leaf, Cardamom, Fennel Seeds, Curry Leaves, Coriander, Sunflower Oil, Salt, Fresh Coconut, Poppy Seeds, Fennel Seeds, Cashew Nuts, Roasted Gram Dal",24,20,30,50,4,Chettinad,Side Dish,Vegetarian
Kela Anar Raita ,"Yogurt, Banana, Pomegranate, Red Chili Powder, Sugar, Cumin Powder, Dijon Mustard, Salt",8,135,15,150,2,Indian,Side Dish,Vegetarian
Dhania Wale Aloo Recipe - Coriander Potato Dry,"Baby Potato, Cumin Powder, Black Pepper Powder, Garam Masala Powder, Lemon Juice, Sesame Seeds, Ghee Clarified Butter, Rock Salt, Coriander, Ginger, Green Chilli",11,10,30,40,4,Indian,Lunch,Vegetarian
Vazhakkai Podimas Recipe (South Indian Style Plantain Mash),"Raw Banana, Mustard Seeds, White Urad Dal, Curry Leaves, Onion, Green Chilli, Ginger, Fresh Coconut, Sunflower Oil, Salt",10,10,10,20,4,Tamil Nadu,Side Dish,Diabetic Friendly
Baked Potato-Spaghetti Rolls Recipe,"Potato, Green Chilli, Spaghetti Pasta, Ginger, Lemon Juice, S Coriander, Fried Bread Cubes, Extra Virgin Olive Oil, Salt And Pepper",9,45,25,70,4,Fusion,Appetizer,Vegetarian
Besan Ka Pitta ,"Oil, Cumin Seeds, Asafoetida, Onion, Green Chilli, Green Onion, , Green Coriander, Red Chilli Powder, Turmeric Powder, Salt",11,10,20,30,4,Rajasthani,Lunch,Vegetarian
Andhra Style Vendakaya Charu Recipe - Ladies Finger Rasam,"Bhindi, Tomato, Pearl Onion, Garlic, Tamarind Water, Red Chilli Powder, Turmeric Powder, Asafoetida, Coriander Powder, Sugar, Salt, Ghee, Mustard Seeds, Cumin Seeds, Methi Seeds, Curry Leaves, Dry Red Chilli",17,10,15,25,4,Andhra,Lunch,Vegetarian
Mexican Vegetarian Burrito Bowl Recipe,"Cooked Rice, Coriander, Whole Black Peppercorns, Salt, Lemon Juice, Rajma, Homemade Tomato Puree, Onion, Garlic, Cumin Seeds, Chipotle Chilli  Peppers, Sunflower Oil, Salt, Red Bell Pepper, Green Bell Pepper, Yellow Bell Pepper, Onion, Garlic, Dried Oregano, Red Chilli Flakes, Salt, Extra Virgin Olive Oil, Del Monte Whole Corn Kernels, Onion, Tomato, Coriander, Lemon Juice, Red Chilli Flakes, Salt, Cheddar Cheese Mexican Cheese, Lettuce Leaves, Black Olives, Guacamole",33,30,45,75,4,Mexican,Dinner,Vegetarian
Dahi Bhindi Recipe - Okra in Yogurt Curry with Caramelized Onions,"Bhindi, Onion, Ginger, Curd, Gram Flour, Garam Masala Powder, Turmeric Powder, Red Chilli Powder, Salt, Caramelized Onion, Sunflower Oil, Ghee, Cumin Seeds, Dry Red Chilli, Coriander",15,20,40,60,4,North Indian Recipes,Dinner,Vegetarian
Palak Paneer Bhurji Recipe,"Cheese, Spinach, Green Chilli, Onion, Tomato, Garlic, Small Teaspoon Cumin, Red Chilli Powder, Garam Masala Powder, Mango Powder, Butter, Salt, Oil",13,15,30,45,4,North Indian Recipes,Vegetarian,Vegetarian
Badam Halwa ,"Almonds, Ghee, Milk, Wheat Flour, Sugar, Saffron, Almond",7,5,30,35,4,Awadhi,Dessert,Vegetarian
Sweet & Spicy Vegetable Hong Kong Style Recipe,"Carrot, Green Beans, Tofu, Red Bell Pepper, Green Bell Pepper, Ginger, Garlic, Dry Red Chilli, Soy Sauce, Chilli Vinegar, Red Chilli Sauce, Sugar, Vegetable Stock, Corn Flour, Sunflower Oil, Salt And Pepper",16,15,15,30,4,Cantonese,Side Dish,Vegetarian
Badam Halwa Recipe,"Badam, Ghee, Milk, Whole Wheat Flour, Sugar, Saffron Strands, Slivered Almonds",7,5,30,35,4,Awadhi,Dessert,Vegetarian
Tender Coconut Ice Cream Recipe,"Tender Coconut Water, Fresh Cream, Sugar, Tender Coconut Meat, Condensed Milk, Honey, Ice Cream Cone",7,360,0,360,8,Indian,Dessert,Vegetarian
Milk Powder Chena Burfi Recipe,"Milk, White Vinegar Lime Juice, Sugar, Milk Powder, Condensed Milk, Cardamom, Ghee, Pistachios, Saffron Strands, Yellow Food Colour",10,15,30,45,8,Indian,Dessert,Vegetarian
Carrot Orange Walnut Raita (Fruity Nutty Yogurt) Recipe,"Curd, Carrot, Orange, Walnuts, Cashew Nuts, Salt Sugar As Per Preference, Cumin Powder, Raita Masala",8,15,10,25,3,Indian,Side Dish,Vegetarian
Coffee Chocolate Truffles Recipe,"Heavy Whipping Cream, Instant Coffee Powder, Dark Chocolate, Butter, Cocoa Powder",5,15,75,90,3,Continental,Dessert,Vegetarian
Karnataka Style Ragi Ujju Rotti Recipe,"Ragi Flour, Water, Salt, Sunflower Oil, Ghee, Rice Flour",6,10,30,40,4,Karnataka,South Indian Breakfast,Gluten Free
Pui Shaager Chorchori Recipe - Mixed Vegetable Curry With Malabar Spinach,"Malabar Spinach Leaves  As Well As Stalks  Into Big Pieces, Kaddu, Mooli Mullangi, Potato, Brinjal, Panch Phoran Masala, Dry Red Chilli, Mustard Oil Vegetable Oil, Cumin Powder, Salt, Sugar, Turmeric Powder",12,5,20,25,4,North East India Recipes,Side Dish,Vegetarian
Potato Pancakes Recipe,"Potato, Lemon Juice, Onion, Garlic, Whole Egg, All Purpose Flour, Whole Wheat Bread Crumbs, Parsley Leaves, Chives  Finely, Salt And Pepper, Peanut Oil",11,10,25,35,5,Continental,World Breakfast,Eggetarian
Bamboo Shoot Stir Fry Recipe,"Bamboo Shoots, Button Mushrooms Cremini Mushrooms, Spring Onion, Red Yellow And Green Bell Peppers, Extra Virgin Olive Oil, Red Chilli Flakes, Salt",7,15,15,30,3,Asian,Side Dish,Diabetic Friendly
Udupi Style Red Parboiled Rice Sevai Recipe (Red Rice Vermicelli),"Red Matta Rice, Fresh Coconut, Water, Salt",4,20,20,40,4,Udupi,South Indian Breakfast,Vegetarian
Till Wale Aloo Recipe - Sesame Potato Sabzi,"Sunflower Oil, Potato, Ginger, Green Chilli, Sesame Seeds, Red Chilli Powder, Cumin Powder, Coriander Powder, Salt, Garam Masala Powder, Sweet Chutney, Coriander",12,10,10,20,4,Indian,Lunch,Vegetarian
Beetroot Loni Sponge Dosa Recipe,"Idli Dosa Batter, Rice, Poha, Buttermilk, Cooking Soda, Butter, Beetroot, Curry Leaves, Green Chilli Paste, Salt, Sesame",11,10,30,40,4,North Indian Recipes,North Indian Breakfast,Vegetarian
Sweet & Spicy Stuffed Paneer In Kofta Curry Recipe,"Paneer, Green Chilli, Ginger, Raisins, Cashew Nuts, Badam, Pistachios, Turmeric Powder, Gram Flour, Salt, Cardamom Powder, Sunflower Oil, Bay Leaf, Cardamom, Cinnamon Stick, Cloves, Mace, Star Anise, Homemade Tomato Puree, Ginger, Garlic, Onion, Coriander Powder, Red Chilli Powder, Turmeric Powder, Cashew Nuts, Curd, Salt, Kasuri Methi, Honey, Fresh Cream",31,20,20,40,4,North Indian Recipes,Dinner,Vegetarian
"Sichuan Style Zhong Shui Jiao Recipe (Caramelized Onion, Cabbage And Peas Dumplings in Red Oil Recipe)","All Purpose Flour, Sunflower Oil, Cabbage, Green Peas, Spring Onion, Soy Sauce, Red Chilli Sauce, Honey, Salt, Sesame, Red Chilli Sauce, Sesame Seeds, Soy Sauce, Water, Brown Sugar, Cinnamon Stick, Star Anise, Ginger",18,20,45,65,4,Sichuan,Side Dish,Vegetarian
Spicy Baby Potatoes Recipe,"Baby Potato, Sunflower Oil, Dry Red Chilli, Cumin Seeds, Curry Leaves, Coriander Powder, Turmeric Powder, Cumin Powder, Red Chilli Powder, Garam Masala Powder, Amchur, Salt, Lemon Juice, Coriander",14,10,30,40,4,North Indian Recipes,Lunch,Vegetarian
Barley Whole Wheat Coffee Marble Cake Recipe,"Whole Wheat Flour, Barley Flour, Butter, Caster Sugar, Whole Eggs, Baking Powder, Salt, Instant Coffee Powder, Lukewarm Water",9,10,40,50,4,Continental,Snack,Vegetarian
Chettinad Dry Pepper Chicken Recipe,"Chicken, Onion, Tomato, Curry Leaves, Ginger Garlic Paste, Turmeric Powder, Cumin Powder, Fennel Powder, Coriander Powder, Black Pepper Powder, Salt, Sunflower Oil, Water, Coriander",14,10,30,40,4,Chettinad,Appetizer,High Protein Non Vegetarian
Andhra Style Palakura Pappu Recipe (Spinach Dal Recipe),"Arhar Dal, Yellow Moong Dal, Spinach Leaves, Pearl Onion, Green Chilli, Turmeric Powder, Tamarind Water, Salt, Mustard Seeds, Garlic, Curry Leaves, Dry Red Chilli, Sunflower Oil",13,10,20,30,4,Andhra,Lunch,Vegetarian
Rich Dark Chocolate Mousse Recipe,"Dark Chocolate, Sprig Extract Of Natural Bourbon Vanilla, Egg Yolks, Egg Whites, Caster Sugar, Fresh Cream",6,20,30,50,8,Continental,Dessert,Eggetarian
Hunase Gojju Recipe,"Tamarind Paste, Jaggery, Rasam Powder Red Chili Powder, Salt, Oil, Fenugreek Seeds, Curry Leaves, Mustard, Asafoetida, Green Chilli",10,10,30,40,4,Karnataka,Lunch,Vegetarian
Qahwa | Arabic Coffee Recipe,"Green Coffee Beans, Cardamom, Water, Saffron Strands, Rose Water",5,5,25,30,4,Arab,Snack,Vegetarian
Broccoli Corn & Barley Soup Recipe,"Barley, Broccoli, Green Peas, Sweet Corn, Green Beans, Carrots, Rocket Leaves Spinach Leaves, Tomato, Onion, Garlic, Extra Virgin Olive Oil, Basil Leaves, Fresh Thyme Leaves, Red Chilli Flakes, Salt, Black Pepper Powder, Corn Flour, Water, Sour Cream Serve",19,15,30,45,4,Continental,Dinner,Vegetarian
Spirulina and Mint Basil Pesto Pasta Recipe,"Basil Leaves, Mint Leaves, Spirulina, Badam, Garlic, Tofu, Black Pepper Powder, Salt, Extra Virgin Olive Oil, Pasta, Garlic, Green Zucchini, Yellow Bell Pepper, Tomato, Red Chilli Flakes, Dried Oregano, Salt",17,20,10,30,4,Italian Recipes,Lunch,Vegetarian
Goan Style Sando Recipe (Steamed Rice Cakes Filled With Sweet Coconut),"Red Matta Rice, Basmati Rice, White Urad Dal, Coconut Milk Toddy, Sugar, Active Dry Yeast, Salt, Fresh Coconut, Jaggery, Cardamom",10,480,15,495,4,Goan Recipes,Dessert,Vegetarian
"Til Moongphali Aur Kundru Sabzi Recipe - Sesame, Peanuts And Ivy Gourd Stir Fry","Tindora, Sunflower Oil, Mustard Seeds, Dry Red Chilli, Curry Leaves, Raw Peanuts, Sesame Seeds, Red Chilli Powder, Coriander Powder, Turmeric Powder, Salt",11,10,10,20,4,Indian,Side Dish,Vegetarian
Asian Style Honey Soy Sticky Chicken Recipe,"Chicken, Tablespoon Soy Sauce, Tablespoon Honey, Tablespoon Vinegar, Garlic, Ginger, Sesame, Salt, Black Pepper Powder, Sesame Seeds",10,15,40,55,2,Continental,Appetizer,Non Vegeterian
Kaigari Pirattal Recipe (Chettinad Style Mixed Vegetables),"Cauliflower, Green Beans, Carrots, Potato, Onion, Sunflower Oil, Mustard Seeds, Curry Leaves, Fresh Coconut, Dry Red Chilli, Cumin Seeds, Fennel Seeds",12,15,20,35,4,Tamil Nadu,Lunch,Vegetarian
Pomegranate Frozen Margarita Recipe,"Pomegranate Juice, Fresh Orange Juice, Lemon Juice, Ice Cubes, Fresh Pomegranate Fruit Kernels, Salt, Pomegranate Juice, Lemon Juice, Tequila, Triple Sec, Fresh Pomegranate Fruit Kernels, Ice Cubes, Salt",13,10,10,20,4,Continental,Vegetarian,Vegetarian
Chinese Egg Fried Rice Recipe With Oats,"Brown Rice, Rolled Oats Or Instant Oats, Whole Eggs, Spring Onion Greens, Carrots, Green Beans, Cabbage, Sunflower Oil, Salt And Pepper",9,10,30,40,4,Fusion,Dinner,Eggetarian
Matar Besan And Paneer Cheela Recipe,"Green Peas, Flour, Cheese, Ginger, Green Chilli, Turmeric Powder, Cumin Powder, Salt, Oil",9,10,30,40,4,North Indian Recipes,North Indian Breakfast,Vegetarian
Leftover Roti Cutlet Recipe,"Phulka, Potato, Green Chilli  Finely, Carrot, Sweet Corn, Onion, Red Chilli Powder, Salt, Amchur, Black Pepper Powder, Red Chilli Flakes, Lemon Juice, Whole Wheat Bread Crumbs, Corn Flour",14,20,20,40,4,Indian,Snack,Vegetarian
Flourless Orange Cake With Cream Cheese Frosting Recipe,"Oranges, Orange Zest, Sugar, Whole Eggs, Caster Sugar, Almond Meal, Hazelnut Meal, Baking Powder, Britannia Cream Cheese, Heavy Whipping Cream, Fresh Orange Juice, Icing Sugar",12,20,70,90,4,Continental,Dessert,Eggetarian
Spicy Paneer Bhurji Pav Sandwich Recipe - Breakfast Recipe,"Sunflower Oil, Ginger, Green Chilli, Onion, Tomato, Turmeric Powder, Red Chilli Powder, Paneer, Coriander, Salt, Pav Buns",11,15,20,35,4,North Indian Recipes,Dinner,High Protein Vegetarian
Asian Style Baby Corn With Sesame Seeds & Peanut Sauce Recipe,"Baby Corn, Tofu Paneer, Water, Corn Flour, Rice Flour, Salt, Sunflower Oil, Red Yellow And Green Bell Peppers, Light Soy Sauce, Garlic, Fresh Red Chilli, Rice Vinegar, Honey, Salt, Sunflower Oil, Onion, Garlic, Raw Peanuts, Fresh Orange Juice, Orange Marmalade Jam, Corn Flour, Paprika Powder, Spring Onion, Sesame Seeds",24,10,90,100,4,Asian,Appetizer,Vegetarian
Papaya and Carrot Halwa Recipe,"Papaya, Carrot, Sugar, Milk, Cardamom Powder, Saffron Strands, Badam, Ghee",8,10,40,50,4,North Indian Recipes,Dessert,Vegetarian
Phalguni Dal ,"Lentils, Green Peas, Onion, Tomato, Ginger, Garlic, Green Chilli, Turmeric Powder, Salt, Mustard, Fenugreek Seeds, Cumin Seeds, Aniseed, Kalonji Seeds, Garam Masala Powder, Mustard Oil, Asafetida",17,10,20,30,2,Bengali Recipes,Lunch,High Protein Vegetarian
Soft Millet Taco Recipe Topped With Hummus & Veggies,"Jowar Flour, Bajra Flour, Whole Wheat Flour, Salt, Sunflower Oil, Homemade Hummus, Butter, Broccoli, Cherry Tomato, Onion, Garlic, Sugar, Black Pepper Powder, Cumin Powder, Salt",15,20,40,60,4,Middle Eastern,World Breakfast,Diabetic Friendly
Sprouted Moong And Onion Fritters Recipe,"Gram Flour, Rice Flour, Green Moong Sprouts, Onion, Coriander, Green Chilli, Ginger, Coriander Powder, Garam Masala Powder, Lemon Juice, Salt, Red Chilli Powder, Sunflower Oil Deep Fry",13,15,15,30,4,Indian,Snack,Vegetarian
Lemon And Ginger Spicy Black Eyed Beans Recipe,"Black Eyed Beans, Onion, Garlic, Red Yellowgreen Bell Pepper, Tomato, Ginger, Extra Virgin Olive Oil, Cumin Powder, Red Chilli Powder Red Chilli Flakes, Salt, Coriander, Lemon Juice",12,5,40,45,2,Mexican,Side Dish,High Protein Vegetarian
Gawar Phali Masala Sabzi Recipe - Cluster Beans Gravy Sabzi,"Gawar Phali, Ajwain, Ssp Asafoetida, Onion, Tomato, Garlic, Ginger, Turmeric Powder, Red Chilli Powder, Coriander Powder, Jaggery, Raw Peanuts, Salt, Water, Mustard Oil, Coriander",16,15,20,35,4,North Indian Recipes,Lunch,Vegetarian
Corn Matar Kachori Recipe,"All Purpose Flour, Ghee, Ajwain, Salt, Sunflower Oil, Green Peas, Sweet Corn, Green Chilli, Ginger, Fennel Seeds, Garam Masala Powder, Chaat Masala Powder, Coriander, Salt",14,20,40,60,4,Indian,Snack,Vegetarian
Lacha Pyaz Recipe - Masala Pickled Onions,"Onion, Lemon, Black Salt, Onion, Red Chilli Powder, Chaat Masala Powder, Salt, Lemon",8,10,0,10,4,North Indian Recipes,Side Dish,Vegetarian
Masala Cornflakes Chicken Recipe,"Boneless Chicken, Red Chilli Powder, Coriander Powder, Turmeric Powder, Garam Masala Powder, Ginger Garlic Paste, Coriander, Salt, Corn Flakes, Whole Eggs, Sunflower Oil Fry",11,20,30,50,4,Indian,Appetizer,High Protein Non Vegetarian
Tofu Bhurji Recipe - Spicy Scrambled Tofu,"Tofu, Onion, Red Bell Pepper, Tomato, Green Chilli, Cumin Seeds, Red Chilli Powder, Black Pepper Powder, Turmeric Powder, Coriander, Salt, Sunflower Oil",12,10,30,40,4,North Indian Recipes,North Indian Breakfast,Vegan
Savoury Bread Pudding Recipe,"Whole Wheat Brown Bread  Preferably A Dayold Bread, Green Zucchini, Carrot, Red Bell Pepper, Spinach Leaves, Button Mushrooms, Onion, Garlic, Extra Virgin Olive Oil, Dijon Mustard, Fresh Thyme Leaves Oreganoany Herbs Of Choice, Black Pepper Powder, Milk, Whole Eggs, Cheddar Cheese, Butter, Salt",17,10,40,50,4,Continental,Main Course,Eggetarian
Stuffed Mooli Paneer Paratha Recipe,"Mooli Mullangi, Paneer, Green Chilli, Garlic, Ginger, Cumin Powder, Sunflower Oil, Salt, Turmeric Powder, Cumin Powder, Whole Wheat Flour, Ghee Cook The Parathas",12,10,20,30,5,North Indian Recipes,North Indian Breakfast,Vegetarian
Orange Peppermint Green Tea Punch Recipe,"Fresh Orange Juice, Ginger, Tea Monk Seiki Peppermint Green Tea, Chilled Water",4,20,5,25,4,Continental,Appetizer,Vegetarian
Zucchini Tater Tots Recipe - A Delicious Party Appetizer,"Potato, Green Zucchini, Red Chilli Flakes, Dried Oregano, Dried Thyme Leaves, Black Pepper Powder, Cheddar Cheese, Whole Wheat Bread Crumbs, Salt",9,10,30,40,30,Continental,Appetizer,Vegetarian
Moringa Masoor Dal Recipe - Drumstick Leaves Dal,"Pink Masoor Dal, Drumstick Leaves, Asafoetida, Cumin Seeds, Ginger, Dry Red Chilli, Tomato, Green Chilli, Coriander Powder, Turmeric Powder, Red Chilli Powder, Salt, Ghee, Lemon",14,10,30,40,4,North Indian Recipes,Lunch,High Protein Vegetarian
Gujarati Methi Na Dhebra Recipe,"Bajra Flour, Jowar Flour, Whole Wheat Flour, Methi Leaves, Ginger, Green Chilli, Sesame Seeds, Red Chilli Powder, Turmeric Powder, Asafoetida, Curd, Sugar, Salt, Sunflower Oil",14,15,15,30,2,Gujarati Recipesï»¿,Snack,Diabetic Friendly
Rajasthani Gatte Ki Sabzi Recipe With Onion & Garlic,"Gram Flour, Ajwain, Red Chilli Powder, Curd, Sunflower Oil, Salt, Gram Flour, Curd, Garlic, Onion, Asafoetida, Turmeric Powder, Red Chilli Powder, Bay Leaf, Cloves, Cinnamon Stick, Salt, Coriander, Mustard Seeds, Ghee",20,10,60,70,4,Rajasthani,Lunch,Vegetarian
Bengali Aloo Potol er Dalna Recipe - A Traditional Vegetable Side Dish,"Pointed Gourd, Potato, Turmeric Powder, Bay Leaves, Cumin Seeds, Cinnamon Stick, Cloves, Cardamom, Ginger, Tomato, Coriander Powder, Garam Masala Powder, Kashmiri Red Chilli Powder, Dry Red Chilli, Asafoetida, Sugar, Salt, Sunflower Oil",18,20,45,65,4,Bengali Recipes,Dinner,Vegetarian
Egg Sholay Kebab Recipe,"Whole Eggs, Curry Leaves, Rice Flour, Gram Flour, All Purpose Flour, Kashmiri Red Chilli Powder, Salt, Sambar Powder, Ginger, Garlic, Green Chilli, Garam Masala Powder, Garam Masala Powder, Coriander Powder, Cumin Powder, Sunflower Oil",16,10,15,25,5,South Indian Recipes,Appetizer,Eggetarian
One Pot Methi Mushroom Brown Rice Pulao Recipe,"Brown Rice, Button Mushrooms, Methi Leaves, Onion, Ginger Garlic Paste, Green Chilli, Cumin Seeds, Bay Leaf, Cinnamon Stick, Cloves, Salt, Sunflower Oil",12,5,20,25,4,Indian,Lunch,Vegetarian
Egg and Bread Fried Rice Recipe,"Basmati Rice, Whole Eggs, Onion, Whole Wheat Brown Bread, Ginger Garlic Paste, Cinnamon Stick, Cloves, Cumin Seeds, Whole Black Peppercorns, Sambar Powder, Salt, Sunflower Oil",12,10,20,30,4,Fusion,Dinner,Eggetarian
Veg Mughlai Paratha Recipe,"Whole Wheat Flour, Salt, Sunflower Oil, Sunflower Oil, Onion, Red Bell Pepper, Green Bell Pepper, Carrot, Garlic, Ginger, Green Chilli, Paneer, Garam Masala Powder, Fennel Seeds, Red Chilli Powder, Mint Leaves, Salt, Whole Wheat Flour, Water",19,15,25,40,4,Mughlai,Lunch,Vegetarian
Crispy Vegetable Tempura Recipe,"Baby Corn, Carrot, Broccoli, Red Bell Pepper, All Purpose Flour, Whole Egg, Baking Powder, Salt And Pepper, Ice Cubes",9,10,10,20,4,Japanese,Appetizer,Vegetarian
Andhra Style Saggubiyyam Punugulu Recipe (Crispy Tapioca Snack),"Sabudana, Hung Curd, Rice Flour, Cumin Seeds, Red Chilli Powder, Curry Leaves, Green Chilli, Onion, Salt",9,150,25,175,4,Andhra,Snack,Vegetarian
Andhra Style Palakaru Vepadu Recipe - Spinach Stir Fry Recipe,"Spinach, Onion, Ginger, Red Chilli Powder, Coriander Powder, Cumin Powder, Salt, Cumin Seeds, Garlic, Curry Leaves",10,10,25,35,4,Andhra,Lunch,Vegetarian
Papaya Orange Pomegranate Salad Recipe With Roasted Peanuts,"Papaya, Fresh Pomegranate Fruit Kernels, Oranges, Cucumber, Honey, Salt And Pepper, Lemon Juice, Roasted Peanuts, Chaat Masala Powder",9,20,0,20,3,Continental,Appetizer,Vegetarian
Paka Kela Ki Sabzi Recipe | Paka Kela nu Shaak | Gujarati Jain Recipe,"Ripe Bananas, Gram Flour, Asafoetida, Turmeric Powder, Red Chilli Powder, Cumin Seeds, Mustard Seeds, Curry Leaves, Sunflower Oil, Salt",10,10,20,30,4,Gujarati Recipesï»¿,Dinner,Vegetarian
Chocolate Tart Recipe,"All Purpose Flour, Sugar, Salt, Butter, Water, Heavy Whipping Cream, Milk, Dark Chocolate, Sugar, Salt, Whole Eggs",11,60,120,180,6,Continental,Dessert,Eggetarian
Navrang Dal ,"Green Moong Dal, White Urad Dal, Kali Urad Dal, Masoor Dal, Masoor Dal, Tablespoons Rajma, Tablespoons Kabuli Chana, Cup Yellow Moong Dal, Arhar Dal, Onion, Tomato, Ginger Garlic Paste, Green Chili, Coriander Powder, Red Chilli Powder, Garam Masala Powder, Tablespoon Kasoori Methi, Ginger, Ghee, Dal Sugar, Cumin Seeds, Salt",22,10,30,40,4,North Indian Recipes,Lunch,High Protein Vegetarian
Green Moong Dal Sundal Recipe,"Sesame Oil, Rye, Cumin, Asafoetida, Curry Leaves, Green Chilli, Salt, Coconut, Cup Sprouted Moong, Lemon Juice, Coriander",11,420,20,440,4,South Indian Recipes,Side Dish,Vegetarian
Chow-Chow Sambar ,"Arhar Dal, Chow Chow, Tamarind, Onion, Tomato, Sambar Powder, Turmeric Powder, S Of Coriander, Oil, Salt, Sesame Oil Any Oil, Mustard, Asafoetida, Red Chili, Curry Leaves",15,10,30,40,4,South Indian Recipes,Lunch,High Protein Vegetarian
Tamil Nadu Style Vellai Paniyaram Recipe - Semi Sweet Rice & Dal Fritters,"Rice, Black Urad Dal, Milk, Sugar, Salt, Sunflower Oil",6,30,30,60,4,Chettinad,Snack,Vegetarian
Kurkuri Bhindi With Spicy Tomato Yogurt Gravy Recipe,"Bhindi, Sunflower Oil, Gram Flour, Salt, Red Chilli Powder, Chaat Masala Powder, Water, Sunflower Oil, Mustard Seeds, Cumin Seeds, Asafoetida, Ginger Garlic Paste, Green Chilli, Onion, Curd, Tomato, Red Chilli Powder, Turmeric Powder, Coriander Powder",19,20,40,60,4,North Indian Recipes,Lunch,Vegetarian
Thulli Recipe (Broken Wheat Halwa),"Broken Wheat, Water, Fennel Seeds, Cardamom Powder, Sugar, Ghee, Cashew Nuts, Milk, Saffron Strands",9,10,30,40,4,Indian,Dessert,Vegetarian
Gulkand Chai Recipe - A Delicious Rose Flavored Indian Tea,"Water, Tea Leaves, Milk, Gulkand",4,0,25,25,2,North Indian Recipes,North Indian Breakfast,Vegetarian
Spinach And Tortellini Soup Recipe,"All Purpose Flour, Dried Oregano, Dried Thyme Leaves, Parsley Leaves, Extra Virgin Olive Oil, Red Chilli Flakes, Salt, Sunflower Oil, All Purpose Flour, Cheese, Garlic, Cup Baby Spinach, Parsley Leaves, Onion, Vegetable Stock, Tablespoon Black Pepper Powder, Salt, Italian Seasoning, Extra Virgin Olive Oil",19,20,30,50,4,Italian Recipes,Side Dish,Vegetarian
Chak-Hao Amubi Recipe (Black Rice Pudding),"Black Rice  Soaked For  Hours, Milk, Sugar, Cardamom Powder, Cashew Nuts  Fried, Raisins",6,180,40,220,6,North East India Recipes,Dessert,Vegetarian
Four Cheese and Spinach Stuffed Mushrooms Recipe,"Button Mushrooms, Extra Virgin Olive Oil, Onion, Garlic, Spinach Leaves, White Pepper Powder, Parsley Leaves, Basil Leaves, Black Pepper Powder, Salt, Garlic Powder, Parmesan Cheese, Mascarpone Cheese, Britannia Cream Cheese, Mozzarella Cheese  Shredded",15,10,50,60,4,Continental,Appetizer,Vegetarian
RoastedÂ VegetableÂ PastaÂ PrimaveraÂ Recipe,"Button Mushrooms, Extra Virgin Olive Oil, Onion, Garlic, Spinach Leaves, White Pepper Powder, Parsley Leaves, Basil Leaves, Black Pepper Powder, Salt, Garlic Powder, Parmesan Cheese, Mascarpone Cheese, Britannia Cream Cheese, Mozzarella Cheese  Shredded",15,10,50,60,4,Continental,Appetizer,Vegetarian
Kashmiri Style Chicken Pulao Recipe,"Rice, Chicken Breasts, Mace, Cinnamon Stick, Cloves, Mace, Ginger, Garlic, Onion, Curd, Red Chilli Powder, Turmeric Powder, Coriander Powder, Black Pepper Powder, Cashew Nuts, Badam, Salt, Sunflower Oil",18,10,30,40,4,Kashmiri,One Pot Dish,Non Vegeterian
Stuffed Tomato With Stir-Fried Quinoa And Feta Recipe,"Tomato, Quinoa, Red Bell Pepper, Yellow Bell Pepper, Cheddar Cheese, Feta Cheese, Black Pepper Powder, Salt",8,10,30,40,4,Middle Eastern,Appetizer,Vegetarian
Keeme Ja Bhalla Recipe - Sindhi Mutton Keema Balls In Gravy,"Mutton Kheema, Garlic, Ginger, Green Chilli, Salt, Mint Leaves, Whole Egg, Coriander, Gram Flour, Sunflower Oil, Garlic, Ginger, Onion, Homemade Tomato Puree, Red Chilli Powder, Salt, Cumin Powder, Garam Masala Powder, Coriander Powder",19,15,40,55,6,Sindhi,Main Course,Non Vegeterian
Chickpea Sundal Recipe,"Black, Oil, Rye, Green Chilli, Ginger, Asafoetida, Spoon Coconut, Coriander, Salt",9,20,20,40,5,South Indian Recipes,Snack,High Protein Vegetarian
Spinach And Corn Sandwich Recipe Flavored With Sandwich Spread,"Whole Wheat Brown Bread, Spinach Leaves, Sweet Corn, Del Monte Sandwich Spread, Butter",5,20,20,40,2,Continental,World Breakfast,Vegetarian
Spaghetti Pasta Recipe In Roasted Pumpkin Sauce,"Kaddu, Homemade Tomato Puree, Fresh Cream, Onion, Extra Virgin Olive Oil, Garlic, Parmesan Cheese, Basil Leaves, Salt, Black Pepper Powder, Spaghetti Pasta, Red Chilli Flakes, Italian Seasoning, Parmesan Cheese",14,45,20,65,2,Italian Recipes,Dinner,Vegetarian
Cold Potato Salad With Cilantro Dressing Recipe,"Baby Potato, Hung Curd, Mustard Sauce, Coriander, Apple Cider Vinegar, Extra Virgin Olive Oil, Red Chilli Flakes, Salt",8,10,5,15,4,Continental,Side Dish,Vegetarian
Pista Burfi Recipe - Indian Spiced Pistachio Fudge,"Pistachios, Fresh Coconut, Sugar, Cardamom Powder",4,35,35,70,8,Indian,Dessert,Vegetarian
No Onion No Garlic Lobia Masala Recipe In Electric Pressure Cooker,"Black Eyed Beans, Ginger, Green Chilli, Curry Leaves, Cumin Seeds, Turmeric Powder, Red Chilli Powder, Coriander Powder, Gram Flour, Tamarind Paste, Jaggery, Salt",12,10,20,30,4,Gujarati Recipesï»¿,Dinner,No Onion No Garlic (Sattvic)
Instant Puliyodharai Powder Recipe (Puliyogare/Pulihora Powder),"Tamarind, Jaggery, Asafoetida, Salt, Chana Dal, White Urad Dal, Coriander, Dry Red Chilli, Whole Black Peppercorns, Sesame Seeds, Flax Seeds, Sunflower Seeds, Melon Seeds, Methi Seeds, Sesame, Raw Peanuts, Mustard Seeds, Sesame, Dry Red Chilli, Curry Leaves",20,0,55,55,100,South Indian Recipes,Dinner,No Onion No Garlic (Sattvic)
Vendakka Stew Recipe (Kerala Style Okra Stew),"Bhindi, Onion, Green Chilli, Coconut Milk, Ginger, Mustard Seeds, Curry Leaves, Coconut Oil, Salt",9,10,15,25,4,Kerala Recipes,Dinner,Vegetarian
Party Sev Puri Recipe Filled With Potato & Pomegranate Mint Mayo,"Potato, Anardana Powder, Del Monte Mint Mayo, Onion, Green Chilli, Lemon, Black Salt, Coriander, Papdi Puris, Sev",10,25,10,35,4,North Indian Recipes,Snack,Vegetarian
Rava Chakli Recipe - Karnataka Style With Rava & Rice Flour,"Chiroti Rava, Rice Flour, Cumin Seeds, Ajwain, Asafoetida, Butter, Salt, Sunflower Oil Cook",8,10,60,70,5,Karnataka,Snack,Vegetarian
Roasted Chickpeas Recipe,"Kabuli Chana, Cajun Spice Mix, Garam Masala Powder, Red Chilli Flakes, Dried Oregano, Extra Virgin Olive Oil, Garlic, Salt",8,10,40,50,3,North Indian Recipes,Snack,High Protein Vegetarian
Carrot Chutney Recipe,"Carrots, Dry Red Chilli, Mustard Seeds, Jaggery, Salt, Sunflower Oil, Mustard Seeds, Curry Leaves",8,75,15,90,6,Indian,Side Dish,Vegetarian
Chilke Wali Mung Dal Curry Recipe,"Green Moong Dal, Onion, Garlic, Cloves, Cumin Seeds, Green Chilli, Turmeric Powder, Tomato, Garam Masala Powder, Salt, Ghee Oil, Coriander",12,10,20,30,3,North Indian Recipes,Dinner,High Protein Vegetarian
Til Chikki Recipe - Healthy Sesame Bars,"Sesame Seeds, Jaggery, Ghee",3,10,30,40,6,Indian,Snack,Vegetarian
Chocolate Glazed Coconut Macaroons Recipe,"Sweetened Coconut Flakes, Condensed Milk, Vanilla Extract, Egg Whites, Salt, Chocolate Bar",6,10,25,35,6,Continental,Snack,Vegetarian
Sookhi Moong Palak Dal Recipe (Whole Green Moong Gram with Spinach),"Green Moong Dal, Spinach Leaves, Tomato, Mustard Oil, Cumin Seeds, Onion, Garlic, Ginger, Green Chilli, Salt, Onion, Green Chilli Garnish, Coriander",13,20,45,65,4,North Indian Recipes,Side Dish,High Protein Vegetarian
Coconut Chocolate Balls Recipe,"Dessicated Coconut, Condensed Milk, Milk Chocolate",3,15,60,75,10,Continental,Dessert,Vegetarian
Kerala Style Pacha Mango Avial Recipe,"Carrot, Brinjal, Potato, Elephant Yam, Green Beans, Mango, Turmeric Powder, Fresh Coconut, Ginger, Green Chilli, Cumin Seeds, Pearl Onion, Curry Leaves, Coconut Oil, Salt",15,15,25,40,4,Kerala Recipes,Side Dish,Vegetarian
Stuffed Palak Paneer Paratha,"Whole Wheat Flour, Water, Salt, Sunflower Oil, Paneer, Spinach Leaves, Kasuri Methi, Red Chilli Powder, Turmeric Powder, Amchur, Cumin Powder, Salt, Nutralite Classic Spread Cook Parathas",13,30,50,80,4,Indian,Indian Breakfast,High Protein Vegetarian
Meen Vevichathu Recipe - Kottayam Style Fish Curry,"Seer Fish, Turmeric Powder, Salt, Aachi Fish Masala, Fresh Coconut, Garlic, Ginger, Coriander, Tomato, Cinnamon Stick, Cloves, Kokum, Coconut Oil, Curry Leaves, Pearl Onion, Sambar Powder",16,10,30,40,6,Kerala Recipes,Lunch,High Protein Non Vegetarian
Masoor Dal Gassi Recipe,"Masoor Dal, Turmeric Powder, Salt, Coconut, Tamarind, Dry Red Chilli, Coriander Seeds, Ghee, Teaspoon Mustard, Garlic, Curry Leaves, Dry Red Chilli",12,10,40,50,4,Mangalorean,Dinner,High Protein Vegetarian
Potato Stuffed Dal Dhokli Recipe,"Whole Wheat Flour, Salt, Sunflower Oil, Whole Wheat Flour, Potato, Red Chilli Powder, Garam Masala Powder, Coriander, Sugar, Lemon Juice, Arhar Dal, Turmeric Powder, Raw Peanuts, Salt, Tomato, Green Chilli, Ginger, Lemon Juice, Jaggery, Sunflower Oil, Mustard Seeds, Cumin Seeds, Asafoetida, Curry Leaves, Dry Red Chilli, Cinnamon Stick, Cloves, Bay Leaf, Coriander",29,25,75,100,4,North Indian Recipes,Lunch,Vegetarian
Green Chilli Chicken Fry Recipe,"Of Chicken, Green Chilli, Garlic, Ginger, Green Coriander, Onion, Tomato, , Cinnamon, Coriander Powder, Salt, Water, Lemon, Oil",14,15,25,40,4,Indian,Appetizer,High Protein Non Vegetarian
Tofu and Chickpea Patty Recipe (Cutlets),"Tofu, Whole Wheat Bread Crumbs, Onion, Coriander, Green Chilli, Ginger, Cumin Powder, Kala Chana, Chaat Masala Powder, Salt, Extra Virgin Olive Oil",11,20,45,65,4,Indian,Snack,Vegetarian
Paneer In Coconut Gravy Recipe,"Paneer, Onion, Tomato, Garam Masala Powder, Salt, Water, Butter, Coriander, Cumin Seeds, Dry Red Chilli, Garlic, Ginger, Onion, Fresh Coconut",14,30,15,45,3,North Indian Recipes,Dinner,Vegetarian
Keerai Masiyal ,"Spinach, Amaranth Leaves, Cumin Seeds, Mustard, White Urad Dal, Curry Leaves, Asafetida, Salt",8,15,20,35,4,South Indian Recipes,Side Dish,High Protein Vegetarian
Thai Som Tum Recipe (Thai Green Papaya Salad),"Cherry Tomato, Dried Shrimps, Fresh Red Chilli, Fish Sauce Soya Sauce, Garlic, Green Beans, Papaya, Lemon Juice, Palm Sugar Brown Sugar, Roasted Peanuts",10,10,15,25,4,Thai,Appetizer,Vegetarian
Desiccated Coconut Coriander Chutney Recipe,"Green Chilli, Garlic, Ginger, Cumin Seeds, Lemon Juice, Dessicated Coconut, Salt, Coriander",8,5,5,10,4,South Indian Recipes,Side Dish,Vegetarian
Quick Masala French Toast Recipe,"Whole Wheat Brown Bread, Whole Eggs, Sunflower Oil Butter As Required, Milk, Red Chilli Flakes, Salt, Coriander, Black Pepper Powder, Onion, Green Chilli",10,10,10,20,2,Continental,World Breakfast,Eggetarian
Kerala Style Tapioca with Coconut Curd Chutney Recipe,"Tapioca Root, Fresh Coconut, Shallots, Green Chilli, Hung Curd, Salt",6,5,60,65,4,Kerala Recipes,South Indian Breakfast,Vegetarian
Matcha Cookies Recipe,"All Purpose Flour, Butter, Caster Sugar, Matcha Powder, Vanilla Extract, Butter",6,10,20,30,4,Fusion,Snack,Vegetarian
"Corn Salad With Radishes, JalapeÃ±o And Lime In Mint Mayo Recipe","Sweet Corn, Red Baby Radish, Pickled Jalapenos, Lemon Juice, Del Monte Mint Mayo, Coriander, Salt, White Pepper Powder",8,15,30,45,2,North Indian Recipes,Snack,Vegetarian
Goan Poee Recipe,"All Purpose Flour, Wheat Flour, Wheat Bran, , Sugar, Salt, Water",7,90,10,100,12,Goan Recipes,Lunch,Vegetarian
Chunky Cucumber Salsa Recipe,"Cucumbers, Red Onion, Tomato, Garlic, Pickled Jalapenos, Whole Black Peppercorns, Coriander, Salt, Lemon Juice, Spring Onion Greens  For Garnish",10,15,30,45,4,Mexican,Dinner,Vegetarian
Grilled Eggplant With Tahini & Yogurt Dip Recipe,"Brinjal, Tzatziki, Tahini, Sun Dried Tomato, Pomegranate Sauce, Mint Leaves, Salt And Pepper, Extra Virgin Olive Oil",8,15,30,45,4,Continental,Appetizer,Vegetarian
Potato Paneer Curry Without Onion And Garlic Recipe (Vrat Wale Aloo Paneer),"Potato, Paneer, Tomato, Ginger, Green Chilli, Red Chilli Powder, Coriander Powder, Cumin Powder, Salt, Sunflower Oil, Coriander",11,20,60,80,4,North Indian Recipes,Lunch,Vegetarian
Fansi Muthia Nu Shaak Recipe - Green Beans With Gram Flour Dumplings,"Green Beans, Mustard Seeds, Ajwain, Ssp Asafoetida, Coriander Powder, Red Chilli Powder, Turmeric Powder, Amchur, Jaggery, Salt, Sunflower Oil, Gram Flour, Kasuri Methi, Turmeric Powder, Sugar, Ssp Asafoetida, Enos Fruit Salt, Lemon Juice, Sunflower Oil, Salt",20,10,30,40,4,Gujarati Recipesï»¿,Main Course,Vegetarian
Kerala Style Appam Recipe,"Rice, Rice, Coconut, Active Dry Yeast, Sugar, Salt",6,200,30,230,4,Kerala Recipes,Main Course,Vegetarian
Kashmiri Style Shab Deg Recipe-Mutton Kofta and Turnip Curry,"Turnips, Poppy Seeds, Badam, Mutton, Kashmiri Red Chilli Powder, Ginger Garlic Paste, Gram Flour, Badam, Poppy Seeds, Coriander, Salt, Mutton, Fennel Powder, Curd, Fresh Cream, Ginger Garlic Paste, Onion, Kashmiri Red Chilli Powder, Coriander Powder, Garam Masala Powder, Ajwain, Cloves, Cardamom, Saffron Strands, Milk, Whole Wheat Flour, Water",27,40,180,220,4,Kashmiri,Lunch,Non Vegeterian
Tofu BÃ¡nh MÃ¬ Recipe - Vietnamese Grilled Tofu Sandwich,"Baguette, Classic Mayonnaise, Sriracha Sauce, Coriander, Extra Virgin Olive Oil, English Cucumber, Red Bell Pepper, Green Bell Pepper, Carrot, Mooli Mullangi, Pickled Jalapenos, Chilli Vinegar, Sugar, Salt And Pepper, Tofu, Soy Sauce, Red Chilli Sauce, Honey, Black Pepper Powder, Dry Ginger Powder",20,20,30,50,4,Vietnamese,Dinner,Vegetarian
Khatta Meetha Petha Recipe (Yellow Pumpkin Sabzi),"Kaddu, Green Chilli, Fennel Seeds, Whole Black Peppercorns, Sunflower Oil, Sugar, Salt, Amchur, Coriander",9,10,30,40,2,Indian,Lunch,Vegetarian
Macher Chop Recipe (Bengali Style Fish Croquettes),"Fish Fillet, Onion, Ginger, Ginger, Garlic  Minced, Red Chilli Powder, Green Chilli, Turmeric Powder, Cumin Powder, Garam Masala Powder, Potato, Coriander, Sugar, Salt, Mustard Oil Cook, Whole Eggs, Salt, Whole Wheat Bread Crumbs",18,40,20,60,15,Bengali Recipes,Snack,Non Vegeterian
Mixed Sprouts Sabzi Recipe,"Mixed Sprouts, Water, Sunflower Oil, Cumin Seeds, Asafoetida, Onion, Ginger Garlic Paste, Tomato, Green Chilli, Turmeric Powder, Salt, Red Chilli Powder, Cumin Powder, Garam Masala Powder, Coriander Powder, Coriander",16,30,30,60,4,Indian,Lunch,High Protein Vegetarian
Baked Muesli Tart with Strawberry Yogurt and Chia Seeds Recipe,"Hung Curd, Butter, Egg White, Vanilla Extract, Cinnamon Powder, Salt, Muesli, Almond Meal, Hung Curd, Strawberries, Honey, Chia Seeds",12,45,25,70,4,Continental,Dessert,Vegetarian
Banoffee Pie Recipe,"Digestive Biscuit, Butter, Butter, Condensed Milk, Caster Sugar, Heavy Whipping Cream, Caster Sugar, Dark Chocolate, Ripe Bananas",9,15,60,75,4,British,Dessert,Vegetarian
Himachal Style Khatta Jimikand Recipe - Spicy Tangy Yam,"Elephant Yam, Cumin Seeds, Kalonji, Methi Seeds, Kala Jeera, Mustard Seeds, Curry Leaves, Onion, Garlic, Ginger, Turmeric Powder, Red Chilli Powder, Garam Masala Powder, Amchur, Salt, Mustard Oil",16,10,30,40,4,Himachal,Side Dish,Vegetarian
Tulsi And Betel Leaves Rasam Recipe,"Tulsi, Betel Leaves, Garlic, Ajwain, Black Pepper Powder, Cumin Seeds, Tamarind, Tomato, Curry Leaves, Ginger, Asafoetida, Salt, Turmeric Powder, Water, Rasam Powder, Coriander, Ghee, Mustard Seeds, Dry Red Chilli",19,10,30,40,4,South Indian Recipes,Lunch,Vegetarian
Prawn Ghee Roast Recipe,"Prawns, Dry Red Chilli, Whole Black Peppercorns, Cumin Seeds, Mustard Seeds, Methi Seeds, Coriander, Fennel Seeds, Tamarind, Turmeric Powder, Red Chilli Powder, Cup Curd, Lemon Juice, Garlic, Ghee, Salt",16,10,15,25,2,Mangalorean,Side Dish,Non Vegeterian
Rosemary Roasted Potatoes And Pepper Salad Recipe,"Baby Potato, Red Bell Pepper, Garlic, Extra Virgin Olive Oil, Salt And Pepper, Rosemary",6,10,30,40,4,Italian Recipes,Appetizer,Vegetarian
Baked Roasted Vegetable Lasagna Recipe With Low Fat Cheese & Oat Sauce,"Lasagna Sheets  The One That Needs No Precooking, Garlic, Extra Virgin Olive Oil, Button Mushrooms, Carrots, Green Zucchini, Milk, Instant Oats, Paneer, Mozzarella Cheese",10,10,45,55,4,Italian Recipes,Appetizer,Vegetarian
Dharwad Peda Recipe,"Milk, Milk, Lemon Juice Curd, Ghee, Sugar, Sugar",6,0,120,120,4,North Karnataka,Dessert,Vegetarian
Chickpea Coconut Milk Curry Recipe,"Kabuli Chana, Onion, Ginger, Garlic, Homemade Tomato Puree, Coconut Milk, Turmeric Powder, Red Chilli Powder, Cumin Powder, Coriander Powder, Garam Masala Powder, Chaat Masala Powder, Ghee, Salt",14,15,30,45,4,North Indian Recipes,Lunch,High Protein Vegetarian
Vegan Kofta Curry Recipe,"Carrot, Green Zucchini, Cabbage, Bottle Gourd, Beetroot, Tofu, Ginger Garlic Paste, Green Chilli Paste, Multigrain Flour Besan, Coriander Powder, Cumin Powder, Rice Flour, Asafoetida, Amchur, Salt, Sunflower Oil, Onion, Tomato, Cashew Nuts, Garam Masala Powder, Red Chilli Powder, Cumin Seeds, Ginger Garlic Paste, Sugar, Sunflower Oil, Salt, Coriander",27,30,45,75,5,North Indian Recipes,Dinner,Vegan
Chana Dal Chutney Recipe,"Roasted Gram Dal, Fresh Coconut, Dry Red Chilli, Curry Leaves, Asafoetida, Mustard Seeds, Tamarind Paste, Sunflower Oil, Salt",9,15,10,25,5,South Indian Recipes,Side Dish,Vegetarian
Coriander Prawn Cakes Recipe,"Prawns, Onion, Leek, Dried Oregano, Dried Thyme Leaves, Rosemary, Red Chilli Flakes, Makki Ka Atta, Coriander, Salt, Sunflower Oil",11,10,20,30,4,Continental,Appetizer,Non Vegeterian
Delicious Skillet Plum Cake Recipe,"All Purpose Flour, Brown Sugar, Baking Powder, Salt, Butter, Milk, Orange Zest, Whole Eggs, Almond Essence, Plums",10,10,35,45,5,Continental,Snack,Eggetarian
Sweet Potato Dal Recipe,"Masoor Dal, Sweet Potato, Coconut Oil Any Other Oil, Onion, Tomato, Cumin Seeds, Green Chilli, Garlic, Turmeric Powder, Red Chilli Powder, Garam Masala Powder, Curry Leaves, Salt, Water, Sunflower Oil, Cumin Seeds, White Urad Dal, Mustard Seeds, Coriander",19,10,35,45,4,North Indian Recipes,Lunch,Vegetarian
Beetroot Millet Paniyaram Recipe,"Beetroot, Foxtail Millet, Instant Oats, Rice Flour, Baking Powder, Jaggery, Cardamom Powder, Ghee",8,180,10,190,15,Chettinad,Snack,Vegetarian
Nutty Oats Almond Truffle Recipe - A Healthy Snack,"Dates, Cocoa Powder, Almond Meal, Flax Seed Powder, Vanilla Extract, Multigrain Digestive Oat Biscuits, Dark Chocolate, Dessicated Coconut",8,20,0,20,16,Continental,Snack,High Protein Vegetarian
Chicken and Mushroom Pot Pie Recipe,"Chicken, Button Mushrooms, Onion, Garlic, Basil Leaves, Dried Oregano, Rosemary, Black Pepper Powder, Fresh Cream, Salt, Sunflower Oil, All Purpose Pie Crust",12,20,45,65,4,Continental,Lunch,Non Vegeterian
Paruppu Payasam Recipe - Stewed Dal Coconut Milk Payasam,"Milk, Coconut Milk, Yellow Moong Dal, Chana Dal, Fresh Coconut, Jaggery, Cashew Nuts, Cardamom Powder, Ghee",9,10,40,50,4,Kerala Recipes,Dessert,Vegetarian
Tandoori Aloo Gobi Kathi Roll Recipe - Spicy Aloo Gobi Frankie,"Cauliflower, Baby Potato, Curd, Kashmiri Red Chilli Powder, Chaat Masala Powder, Cumin Seeds, Turmeric Powder, Green Chilli, Onion, Green Bell Pepper, Lemon, Salt, Sunflower Oil, Whole Wheat Flour, Sunflower Oil, Salt",16,20,40,60,5,Indian,Snack,Vegetarian
Roasted Potatoes & Zucchini Bake Recipe In A Creamy Parsley Sauce,"Green Zucchini, Potato, Garlic, Britannia Cream Cheese, Hung Curd, Parsley Leaves, Feta Cheese, Parmesan Cheese, Salt And Pepper, Extra Virgin Olive Oil Cook",10,15,30,45,4,Continental,Main Course,Vegetarian
Spiced Whole Wheat Carrot Cake Recipe,"Whole Wheat Flour, Cinnamon Powder, Dry Ginger Powder, Salt, Baking Powder, Sugar, Nutralite Classic Spread, Whole Eggs, Milk, Carrots, Walnuts, Icing Sugar",12,30,45,75,4,Continental,Snack,Vegetarian
Grilled Tangy Lime Salmon Steak Recipe,"Salmon Fillet, Onion, Lemon Zest, Whole Black Peppercorns, Garlic Powder, Extra Virgin Olive Oil, Paprika Powder, Salt, Lemon Juice, Dijon Mustard, Lemon Juice, Sambal Oelek",12,10,15,25,4,Continental,Dinner,High Protein Non Vegetarian
Bihari Shakarkand Bhujiya Recipe - Spicy Sweet Potato Sabzi,"Sweet Potato, Turmeric Powder, Cumin Seeds, Green Chilli, Mustard Oil, Salt",6,10,10,20,4,North Indian Recipes,Lunch,Vegetarian
Egg White Spinach Omelette Recipe With Garlic & Oregano,"Whole Eggs, Onion, Spinach, Green Chilli, Salt And Pepper, Nutralite Garlic & Oregano Spread",6,10,5,15,2,Continental,World Breakfast,Eggetarian
No Onion No Garlic Spiced Apple Tomato Curry ,"Apples, Tomato, Turmeric Powder, Coriander Powder, Red Chili Powder, Lentil Sugar, Bay Leaf, Salt Kala Namak, S Of Coriander, Oil",10,20,30,50,2,Kashmiri,Dinner,No Onion No Garlic (Sattvic)
Homemade Spicy Ramen with Tofu Recipe,"Wheat Noodles, Red Bell Pepper, Stalks Spring Onion Greens, Milk, Vinegar, Tomato Ketchup, Red Chilli Sauce, Tofu, Sweet And Spicy Red Chilli Sauce, Green Chilli Sauce, Honey, Coriander Powder, Black Pepper Powder, Red Chilli Powder, Garam Masala Powder, Amchur, Onion, Sugar, Methi Seeds, Dry Red Chilli, Garlic, Ginger",22,10,45,55,4,Asian,Lunch,Vegetarian
Ambul Polos Curry - Sri Lankan Jack Fruit Curry Recipe With Pol Sambol,"Fresh Coconut, Dry Red Chilli, Pearl Onion, Lemon, Coriander, Cumin Seeds, Whole Black Pepper Corns, Mustard Seeds, Cloves, Cardamom, Cinnamon Stick, Fennel Seeds, Dry Red Chilli, Sunflower Oil, Garlic, Ginger, Onion, Curry Leaves, Jackfruit Raw, Salt, Water",21,10,20,30,4,Asian,Lunch,Vegetarian
Stuffed Gilka Recipe (Maharashtrian Style Stuffed Silk Squash),"Gilka, Cumin Seeds, Sunflower Oil, Coriander, Onion, Garlic, Groundnut Powder, Sesame Powder, Red Chilli Powder, Maharashtrian Goda Masala, Jaggery, Turmeric Powder, Asafoetida, Salt",14,10,20,30,4,Maharashtrian Recipes,Lunch,Vegetarian
Murungai Keerai Rasam Recipe,"Arhar Dal, Tamarind Water, Drumstick Leaves, Garlic, Salt, Asafoetida, Rasam Powder, Cumin Powder, Black Pepper Powder, Sunflower Oil, Mustard Seeds, Cumin Seeds, Curry Leaves, Curry Leaves",14,10,25,35,4,South Indian Recipes,Lunch,Vegetarian
Palak Paneer Recipe,"Paneer, Spinach, Tomato, Garlic, Ginger, Green Chilli, Cumin Seeds, Cinnamon Powder, Cumin Powder, Turmeric Powder, Garam Masala Powder, Cream, Butter, Salt",14,20,40,60,4,Punjabi,Dinner,High Protein Vegetarian
Broken Wheat Upma Or Dalia Khichdi Recipe for Babies & Toddlers,"Broken Wheat, Water, Salt, Carrots, Ghee, Mustard Seeds, Turmeric Powder, Curry Leaves",8,10,10,20,2,Indian,Indian Breakfast,Vegetarian
Hesaru Bele Southekayi Kosambari Recipe - Cucumber Kosambari,"Cucumbers, Yellow Moong Dal, Lemon, Fresh Coconut, Coriander, Salt, Coconut Oil, Mustard Seeds, Asafoetida, Green Chilli, Curry Leaves",11,65,0,65,4,South Indian Recipes,Snack,High Protein Vegetarian
Kurkure Karela Sabzi Recipe - Crispy Karela Bhujiya,"Karela, Salt, Mustard Oil, Fennel Seeds, Turmeric Powder, Coriander Powder, Red Chilli Powder, Amchur",8,380,30,410,4,North Indian Recipes,Lunch,Diabetic Friendly
Dried Neem Flower Flavoured Rice ,"Black Rice, Oil Ghee, Asafoetida, White Urad Dal, Neem Leaves, Red Chili, Few Curry Leaves",7,320,50,370,2,South Indian Recipes,Lunch,Vegetarian
Cauliflower Croquettes Recipe,"Cauliflower, All Purpose Flour, Milk, Butter, Garlic, Rosemary, Dried Thyme Leaves, Tabasco Original, Salt, Whole Egg, Whole Wheat Bread Crumbs, Sunflower Oil",12,15,45,60,4,Continental,Appetizer,Vegetarian
Broccoli And Aloo Poriyal Recipe - South Indian Broccoli And Potato Stir Fry,"Broccoli, Potato, Mustard Seeds, Curry Leaves, Red Chilli Powder, Turmeric Powder, Salt, Sunflower Oil",8,20,15,35,4,South Indian Recipes,Lunch,Vegetarian
Hot and Spicy Chicken Curry Noodles Recipe,"Sunflower Oil, Spring Onion Greens, Garlic, Ginger, Sriracha Sauce, Tofu, Chicken Breasts, Rolled Oats Or Instant Oats, Coconut Milk, Egg Noodles, Red Chilli Powder, Salt",12,10,40,50,4,Chinese,Lunch,Non Vegeterian
Nendra Pazham Pulissery Recipe - Ayurvedic Recipe,"Nendra Pazham Banana, Turmeric Powder, Salt, Curd, Coconut Oil, Fresh Coconut, Green Chilli, Curry Leaves, Cumin Seeds, Mustard Seeds, Curry Leaves, White Urad Dal, Sunflower Oil",13,10,15,25,4,Kerala Recipes,Lunch,Vegetarian
Spinach And Coriander Dosa Recipe,"Rice, White Urad Dal, Fenugreek Seeds, Salt, Spinach, Green Coriander, Oil",7,10,45,55,5,South Indian Recipes,South Indian Breakfast,High Protein Vegetarian
Rosemary And Thyme Chicken Recipe,"Chicken Breasts, Rosemary, Fresh Thyme Leaves Dried, Garlic, Lemon Juice, Honey, Extra Virgin Olive Oil, Lemon Zest, Black Pepper Powder, Lemon Wedges",10,60,20,80,2,Continental,Dinner,High Protein Non Vegetarian
Akoori with Green Peas Recipe (Parsi Style Scrambled Eggs with Green Peas),"Whole Eggs, Green Peas, Onion, Tomato, Green Chilli, Ginger Garlic Paste, Turmeric Powder, Curry Powder, Red Chilli Powder, Coriander, Sunflower Oil, Lemon Juice, Ginger, Salt",14,5,10,15,4,Parsi Recipes,Indian Breakfast,Eggetarian
Mishti Doi Recipe - Traditional Bengali Sweet Yogurt,"Milk, Sugar, Curd, Water",4,10,30,40,3,Bengali Recipes,Dessert,Vegetarian
Whole Wheat Flour Murukku Recipe,"Whole Wheat Flour, Salt, Butter, Sesame Seeds, Ajwain, Red Chilli Powder, Water, Sunflower Oil",8,10,20,30,4,South Indian Recipes,Snack,Vegetarian
Indian Beaten Coffee Recipe | Dalgona Coffee,"Instant Coffee Powder, Sugar, Water, Milk, Cinnamon Powder, Instant Coffee Powder",6,5,0,5,1,North Indian Recipes,Indian Breakfast,Vegetarian
Green Coriander And Coconut Chutney ,"Coconut, Coriander, Green Chili, Ginger, Cumin Seeds, Salt, According",7,10,10,20,4,Indian,Side Dish,Vegetarian
Lauki Badi Ki Sabzi ,"Gourd, Wood, Oil, Cumin Seeds, Mustard, Asafoetida, Green Chili, Ginger, Garlic, Red Chilli Powder, Turmeric Powder, Coriander Powder, Garam Masala Powder",13,10,20,30,3,Rajasthani,Main Course,Vegetarian
Guilt Free Coconut Barfi Recipe,"Badam, Dates, Dessicated Coconut, Milk, Ghee, Cardamom Powder",6,10,30,40,3,North Indian Recipes,Dessert,Vegetarian
Kerala Chicken Curry Recipe With Freshly Ground Spices,"Chicken, Onion, Ginger, Garlic, Mustard Seeds, Curry Leaves, Coconut Oil, Salt, Coconut Milk Grated Fresh Coconut, Whole Black Peppercorns, Coriander, Cinnamon Stick, Fennel Seeds, Dry Red Chilli",14,10,45,55,4,Kerala Recipes,Lunch,Non Vegeterian
Fulkopir Paturi Recipe,"Cabbage, Turmeric Powder, Red Chilli Powder, Cumin Seeds, Sugar, Mustard Oil, Salt, Rye, Poppy Seeds, Green Chilli, Coconut, Garlic, Banana Leaves, Banana Leaves, Oil Grease, Sunflower Oil",16,10,75,85,2,Bengali Recipes,Lunch,Vegetarian
Apple Tart with Puff Pastry Recipe (Open Pie),"Puff Pastry Sheet, Apple, Cinnamon Powder, Brown Sugar",4,15,30,45,4,Continental,Dessert,Vegetarian
Broccoli Soup Recipe - For Babies/Toddlers above 7 months,"Broccoli, Salt, Black Pepper Powder, Butter, Badam",5,15,10,25,2,Continental,Lunch,High Protein Vegetarian
Karnataka Special Huli Tovve Recipe,"Mixed Vegetables, Raw Peanuts, Arhar Dal, Salt, Jaggery, Fresh Coconut, Dry Red Chilli, Chana Dal, White Urad Dal, Cinnamon Stick, Sunflower Oil, Mustard Seeds, Asafoetida, Curry Leaves",14,10,30,40,2,Kerala Recipes,Lunch,Vegetarian
Lehsuni Tikki Recipe,"Potato, Paneer, Cashew Nuts, Onion, Garlic, Green Chilli, Coriander, Corn Flour, Red Chilli Powder, Sunflower Oil, Salt",11,20,30,50,4,North Indian Recipes,Appetizer,Vegetarian
Baked Fish Crisps Recipe (Fish Fry In Oven),"Fish, Sunflower Oil, Red Chilli Powder, Turmeric Powder, Salt, Water",6,10,30,40,4,Indian,Appetizer,High Protein Non Vegetarian
Left Over Vadai Upma Recipe,"Medu Vada, Ginger, Green Chilli, Onion, Asafoetida, Mustard Seeds, Chana Dal, Dry Red Chilli, Curry Leaves, Coriander, Salt, Sunflower Oil",12,0,15,15,4,South Indian Recipes,South Indian Breakfast,Vegetarian
Hyderabadi Chand Biscuits Recipe,"Butter, Sugar, Salt, All Purpose Flour, Baking Powder, Milk Powder, Vanilla Extract",7,20,20,40,8,Hyderabadi,Lunch,Vegetarian
Mullu Murukku Recipe,"Rice Flour, Urad Dal Flour, Asafoetida, Sesame, Red Chilli Powder, Turmeric Powder, Butter, Water, Salt, Oil",10,10,40,50,4,Tamil Nadu,Snack,Vegetarian
Prawns Fried Rice ,"Rice, Bay Leaves, Onion, Garlic, Ginger, Soy Sauce, Carrot, Green Chilli Sauce, Capsicum, Small Spoon Roasted Tomato Sauce, Prawns, Butter, Oil, Long, Whole Pepper, Teaspoon Dal Sugar Powder, Black Pepper Powder, Green Coriander, Salt, Red Chilli Powder, Turmeric Powder, Salt",22,0,40,40,4,Indian,Lunch,High Protein Non Vegetarian
Homemade Vada Pav Recipe With Spinach Corn Tikki,"Pav Buns, Herb Butter, Lahsun Ki Chutney, Onion, Classic Mayonnaise, Butter, Garlic, Green Chilli, Onion, Ginger, Spinach, Sweet Corn, Chaat Masala Powder, Potato, Salt, Butter, Whole Wheat Bread Crumbs",17,20,40,60,8,Maharashtrian Recipes,Snack,Vegetarian
Carrot Rice ,"Rice, Small Onion, Ginger, Green Coriander, Oil, Ghee, Salt",7,20,30,50,4,Indian,Dinner,Vegetarian
Gur Paare Recipe (A traditional Punjabi Wedding Sweet),"All Purpose Flour, Ghee, Jaggery, Fennel Seeds, Sunflower Oil",5,15,30,45,4,Punjabi,Snack,Vegetarian
Spinach & Garlic Potato Patties Recipe,"Potato, Milk, Butter, Garlic, Onion, Salt, Spinach Leaves, Black Pepper Powder, Whole Wheat Bread Crumbs, Cheese, Lemon Juice, Cumin Powder, Extra Virgin Olive Oil Shallow Fry The Patties",13,10,20,30,6,Continental,Appetizer,Vegetarian
Pumpkin Peas Palya Recipe,"Kaddu, Green Peas, Fresh Coconut, Amchur, Garam Masala Powder, Red Chilli Powder, Coconut Oil, Mustard Seeds, Chana Dal, Curry Leaves, Water, Salt",12,10,20,30,4,South Indian Recipes,Lunch,Vegetarian
Thandai Shrikhand Tart Recipe,"All Purpose Flour, Salt, Cardamom Powder, Cinnamon Powder, Black Pepper Powder, Nutmeg Powder, Butter, Fresh Coconut, Badam, Cashew Nuts, Pistachios, Poppy Seeds, Sugar, Chilled Water, Shrikhand, Pistachios, Mixed Fruits",17,10,90,100,4,North Indian Recipes,Dessert,Vegetarian
Masala Dosa With Red Chutney Recipe,"Idli Dosa Mixture, Oil, Chaat Masala Powder, , Garlic Chutney, Potato, Onion, Ginger, Green Chilli, Turmeric Powder, Curry Leaves, Coriander, Salt",13,10,45,55,4,South Indian Recipes,South Indian Breakfast,Vegetarian
Palak (Spinach) Puri Recipe,"Whole Wheat Flour, Spinach Leaves, Ginger, Green Chilli, Cumin Powder, Water, Sunflower Oil",7,20,25,45,3,Indian,Indian Breakfast,Vegetarian
Matar Aur Chilke Ka Sabzi (Peas & Peel Stir Fry Recipe),"Green Peas, Spring Onion, Panch Phoran Masala, Turmeric Powder, Red Chilli Powder, Green Chilli, Salt, Sunflower Oil",8,20,10,30,3,Indian,Side Dish,Vegetarian
How To Boil Eggs At Home - Boiled Eggs Recipe,"Whole Eggs, Water",2,0,10,10,2,Continental,Eggetarian,Vegetarian
Boiled Egg With Salt And Pepper Recipe - Finger Food For Babies Above 9 Months,"Whole Egg, Water, Salt And Pepper",3,2,10,12,6,Indian,Snack,High Protein Non Vegetarian
Spinach Thalipeeth Recipe,"Whole Wheat Flour, Rice Flour, Gram Flour, Spinach Leaves, Onion, Cumin Seeds, Turmeric Powder, Red Chilli Powder, Cumin Powder, Salt, Sunflower Oil Smear",11,5,30,35,4,Maharashtrian Recipes,North Indian Breakfast,Vegetarian
Paneer Satay Recipe,"Paneer, Ginger, Garlic, Turmeric Powder, Dark Soy Sauce, Sesame, Salt",7,15,30,45,4,North Indian Recipes,Appetizer,High Protein Vegetarian
Poosanikai Rasavangi Recipe - Ash Gourd Curry With Dal,"Vellai Poosanikai, Yellow Moong Dal, Chana Dal, Tamarind, Turmeric Powder, Mustard Seeds, White Urad Dal, Curry Leaves, Sunflower Oil, Salt, White Urad Dal, Chana Dal, Coriander, Dry Red Chilli, Fresh Coconut",15,10,30,40,3,Tamil Nadu,Lunch,Vegetarian
Taiwanese Pineapple Cake Recipe - Shortcrust Pastry Cake,"All Purpose Flour, Whole Egg, Butter, Baking Powder, Sugar, Milk, Salt, Pineapple, Jaggery",9,20,25,45,8,Asian,Dessert,Non Vegeterian
Malvani Vatli Dal Recipe,"Chana Dal, Green Chilli, Sunflower Oil, Mustard Seeds, Cumin Seeds, Asafoetida, Turmeric Powder, Curry Leaves, Salt, Sugar, Lemon Juice, Coriander",12,10,25,35,3,Maharashtrian Recipes,Lunch,High Protein Vegetarian
Chettinad Vengaya Kosu Recipe (Spicy Curry from Chettinad Cuisine),"Onion, Tomato, Curry Leaves, Sesame, Fennel Seeds, Turmeric Powder, Salt, Dry Red Chilli, Fresh Coconut, Coriander",10,15,20,35,4,Chettinad,Lunch,Vegetarian
Greek Style Spinach Spanakopita Recipe,"Spinach Leaves, Paneer, Onion, Garlic, Fresh Thyme Leaves, Dried Oregano, All Purpose Flour, Butter, Salt",9,10,60,70,4,Greek,Appetizer,Vegetarian
Lauki Burfi With Paneer Recipe - Bottle Gourd Fudge With Cottage Cheese,"Bottle Gourd, Ghee, Ghee Butter For Greasing, Sugar, Cardamom Powder, Slivered Almonds, Chenna",7,10,40,50,10,Indian,Dessert,Vegetarian
Menthi Aaku Badeela Koora Recipe - Besan Muthia Cooked With Methi Leaves,"Methi Leaves, Gram Flour, Ginger, Garlic, Garam Masala Powder, Red Chilli Powder, Turmeric Powder, Salt, Water, Sunflower Oil, Cumin Seeds, Mustard Seeds, Curry Leaves, Dry Red Chilli",14,20,20,40,4,Andhra,Side Dish,Diabetic Friendly
Microwaved Egg-Omelette-In-A-Mug Recipe,"Whole Eggs, Egg Whites, Black Pepper Powder, Salt, Green Bell Pepper, Onion, Sunflower Oil",7,10,5,15,4,Continental,World Breakfast,Eggetarian
Assamese Komolar Kheer Recipe (Orange Kheer),"Milk, Sugar, Badam, Mixed Nuts, Orange Pulp",5,5,15,20,2,Assamese,Dessert,Vegetarian
Hari Matar Ke Pakode Recipe - Green Pea Fritters,"Green Peas, Coriander, Garlic, Green Chilli, Cumin Seeds, Gram Flour, Asafoetida, Onion, Salt, Sunflower Oil",10,20,20,40,4,Indian,Snack,Vegetarian
Sooji Halwa Breakfast Bowl Recipe,"Sooji, Ghee, Cardamom Powder, Cane Sugar, Cashew Nuts, Badam, Mixed Fruits",7,10,10,20,3,Indian,Indian Breakfast,Vegetarian
Banana Digestive Pudding Recipe With Pistachios,"Ripe Bananas, Hung Curd, Honey, Multigrain Digestive Oat Biscuits, Pistachios",5,5,0,5,2,Continental,World Breakfast,Vegetarian
Chawli Ki Phali & Aloo Sabzi Recipe,"Green Chawli Beans, Potato, Fennel Seeds, Coriander Powder, Red Chilli Powder, Turmeric Powder, Amchur, Gram Flour, Sunflower Oil, Salt",10,10,20,30,4,North Indian Recipes,Side Dish,Vegetarian
Karnataka Style Gasagase Payasa Recipe- Poppy seed Payasam,"Poppy Seeds, Rice, Fresh Coconut, Jaggery, Milk, Cardamom, Salt, Ghee, Cashew Nuts, Raisins",10,0,30,30,4,Karnataka,Dessert,Vegetarian
Meethe Chawal Recipe - Zarda Pulao,"Basmati Rice Any  Grain Rice, Saffron Strands, Milk, Sugar, Cardamom, Cinnamon Stick, Badam, Pistachios, Raisins, Turmeric Powder, Sunflower Oil",11,10,40,50,4,Awadhi,Main Course,Vegetarian
Navratan Korma Recipe,"Cashew Nuts, Badam, Melon Seeds, Onion, Tomato, Mixed Vegetables, Ginger Garlic Paste, Coconut Milk, Turmeric Powder, Red Chilli Powder, Coriander Powder, Garam Masala Powder, Salt, Ghee Oil, Anardana Powder, Cashew Nuts, Raisins, Ghee",18,15,50,65,4,North Indian Recipes,Lunch,Vegetarian
Steamed Rice Recipe,"Rice, Salt, Water",3,5,20,25,4,Indian,Main Course,Vegetarian
Malpua Recipe with Rabri (A Spiced Indian Pancake with Milk Pudding),"All Purpose Flour, Fennel Seeds, Cardamom, Baking Soda, Khoya, Milk Powder, Curd, Caster Sugar, Ghee, Sugar, Water, , Lemon Juice",13,40,25,65,6,Indian,Dessert,Vegetarian
Mexican Style Omelette With Avocado Dressing Recipe,"Avocado, Fresh Red Chilli, Curd, Lemon Zest, Lemon, Coriander, Salt, Onion, Red Bell Pepper, Green Bell Pepper, Coriander, Salt, Whole Eggs, Black Pepper Powder, Cheese, Milk, Extra Virgin Olive Oil Butter",17,10,20,30,2,Mexican,World Breakfast,Eggetarian
Bavarian Mushroom Sauce Recipe,"Button Mushrooms, Butter, S Mint Leaves, S Parsley Leaves, All Purpose Flour, Milk, Fresh Cream, Black Pepper Powder, Salt",9,0,25,25,1,Mexican,World Breakfast,Eggetarian
Paneer Mushroom Stuffed Spinach Wrap Flavoured With Prunes,"Extra Virgin Olive Oil, Spinach Basil Sauce, Green Chilli, Whole Wheat Flour, Salt, Extra Virgin Olive Oil, Garlic, Red Bell Pepper, Onion, Stalks Spring Onion, Button Mushrooms, Tofu, Soy Sauce, Red Chilli Sauce, Mixed Herbs, Sunflower Oil",16,10,45,55,4,Continental,Lunch,Vegetarian
Karpooravalli Chutney Recipe (Tamil Nadu Chutney With Big Thyme),"Indian Borage, Fresh Coconut, Tamarind, Dry Red Chilli, Asafoetida, Mustard Seeds, White Urad Dal, Chana Dal, Salt, Sunflower Oil",10,5,10,15,3,Tamil Nadu,Side Dish,Vegetarian
Tarkari Ni Kari Recipe (Parsi Style Vegetable Curry),"Mixed Vegetables, Tomato, Turmeric Powder, Coriander Powder, Red Chilli Powder, Sugar, Salt, Fresh Coconut, Onion, Green Chilli, Garlic, Ginger, Cumin Seeds, Tamarind, Sunflower Oil, Mustard Seeds, Dry Red Chilli",17,10,20,30,4,Parsi Recipes,Lunch,Vegetarian
Chicken With Mushroom Sauce Recipe,"Chicken Breasts, Button Mushrooms, Onion, Garlic, Dried Thyme Leaves, Red Chilli Flakes, Black Pepper Powder, Milk, Corn Flour, Salt, Butter",11,10,15,25,4,Continental,Lunch,Non Vegeterian
Goan Chicken Vindaloo Recipe,"Chicken, Onion, Tomato, Homemade Tomato Puree, Sunflower Oil, Green Chilli, Tamarind, Coriander, Salt, Sunflower Oil, Garlic, Ginger, Kashmiri Dry Red Chilli, Mustard Seeds, Black Pepper Corns, Cumin Seeds, Coriander, Methi Seeds, Cloves, Cinnamon Stick, Vinegar, Turmeric Powder, Jaggery, Salt",24,10,40,50,5,Goan Recipes,Dinner,Non Vegeterian
Indo Chinese Hot and Sour Spinach Soup Recipe,"Spinach, Green Chilli, Coriander, Ginger, Garlic, Carrots, Cabbage, Green Bell Pepper, Hot Water, Corn Flour, Soy Sauce, Vinegar, Salt, Sunflower Oil, Spring Onion Greens, Coriander",16,15,15,30,4,Fusion,Side Dish,Vegetarian
Kashmiri Kokur T Nadir Recipe-Chicken and Lotus Stem Curry,"Lotus Stem, Chicken, Water, Bay Leaf, Fennel Seeds, Black Cardamom, Cloves, Ginger, Mustard Oil, Cumin Seeds, Asafoetida, Curd, Kashmiri Red Chilli Powder, Fennel Powder, Dry Ginger Powder, Salt, Mint Powder, Ajwain, Coriander",19,30,40,70,4,Kashmiri,Lunch,High Protein Non Vegetarian
Spicy Chickpea Tacos Recipe With Indian Twist,"Hard Taco Shells, Tomato, Onion, Green Chilli, Coriander, Cup Kabuli Chana, Red Chilli Powder, Turmeric Powder, Coriander Powder, Chana Masala Powder, Tablespoon Ginger Garlic Paste, Salt, Sunflower Oil Cook",13,15,15,30,4,Mexican,Appetizer,Gluten Free
Nepalese Style Dhal Bhat Recipe,"Yellow Moong Dal, Onion, Turmeric Powder, Coriander, Salt, Cinnamon Stick, Cardamom Powder, Cloves, Dry Red Chilli, Whole Black Peppercorns, Cumin Seeds",11,10,30,40,4,Nepalese,Lunch,High Protein Vegetarian
Ginger Sesame Chicken With Bok Choy And Mushrooms Recipe,"Chicken Stock, Soy Sauce, Sherry White Wine, Sugar, Corn Flour, Rice Vinegar, Sesame, Fresh Red Chilli, Sunflower Oil, Button Mushrooms, Chicken Breasts, Salt And Pepper, Bok Choy, Red Bell Pepper, Ginger, Garlic, Sesame Seeds",17,10,30,40,4,Chinese,Lunch,Vegetarian
Murungakkai Mor Kuzhambu Recipe-Drumstick Buttermilk Curry,"Drumstick, Curd, Turmeric Powder, Fresh Coconut, Rice, Coriander, Cumin Seeds, Dry Red Chilli, Salt, Coconut Oil, Mustard Seeds, Curry Leaves",12,10,20,30,4,Tamil Nadu,Lunch,Vegetarian
Parsi Style Lagan Sara Istew Recipe - Rich Sweet Assorted Vegetable Curry,"Carrot, Baby Potato, Elephant Yam, Green Peas, Raisins, Dates, Vinegar, Jaggery, Onion, Tomato, Garlic, Ginger, Green Chilli, Turmeric Powder, Red Chilli Powder, Dhansak Masala, Salt, Sunflower Oil",18,15,45,60,4,Parsi Recipes,Dinner,Vegetarian
Arunachal Pradesh Zan Recipe - Finger Millet Porridge with Vegetables Recipe,"Ragi Flour, Water, Carrot, Spinach, Soybeans, Green Peas, Salt, Black Pepper Powder, Coriander, Ghee",10,10,10,20,2,North East India Recipes,North Indian Breakfast,Gluten Free
Green Chana Chutney (Green Chickpea Chutney) Recipe,"Fresh Green Chickpeas Frozen, Green Chilli, Garlic, Salt, Water, Sunflower Oil, Cumin Seeds, Curd",8,5,10,15,2,Rajasthani,Side Dish,Vegetarian
Mixed Beans Vegetable Pulao Recipe,"Rice, Rajma, Double Beans, Potato, Carrot, Green Beans, Cloves, Cardamom, Cinnamon Stick, Turmeric Powder, Onion, Green Chilli, Ginger Garlic Paste, Garam Masala Powder, Lemon Juice, Coriander, Salt, Sunflower Oil",18,15,30,45,2,Indian,Dinner,Vegetarian
Pacha Manga Pachadi Recipe - Raw Mango Pachadi,"Mango, Tamarind Water, Jaggery, Sambar Powder, Turmeric Powder, Salt, Mustard Seeds, Asafoetida, Curry Leaves, Dry Red Chilli, Sunflower Oil",11,5,30,35,4,Tamil Nadu,Side Dish,Vegetarian
Odiya Style Chana Dal With Potato & Pumpkin Curry Recipe,"Chana Dal, Kaddu, Potato, Ginger, Tomato, Cumin Seeds, Dry Red Chilli, Red Chilli Powder, Turmeric Powder, Ghee, Fresh Coconut  Grated, Sugar, Salt, Coriander",14,5,30,35,4,Oriya Recipes,Dinner,Vegetarian
Kali Mirch Singhare Ki Sabzi Recipe,"Singhade, Mustard Seeds, Curry Leaves, Black Pepper Powder, Turmeric Powder, Asafoetida, Salt, Sunflower Oil",8,10,30,40,4,North Indian Recipes,Side Dish,No Onion No Garlic (Sattvic)
Puli Upma Recipe - Tamarind & Rice Rava Upma,"Rice, Tamarind, Water, Curry Leaves, Dry Red Chilli, Asafoetida, Sunflower Oil, Mustard Seeds, Salt",9,15,15,30,2,South Indian Recipes,Snack,Gluten Free
Whole Wheat Eggless Cinnamon & Raisin Swirl Bread Recipe,"Whole Wheat Flour, Active Dry Yeast, Sugar, Lukewarm Water, Extra Virgin Olive Oil, Salt, Confectioners Sugar, Cinnamon Powder, Raisins",9,60,30,90,4,Continental,Snack,Vegetarian
Egg Pulao Recipe,"Whole Eggs  Hardboiled, Ghee, Red Chilli Powder, Whole Black Peppercorns, Green Chilli, Garlic, Ginger, Basmati Rice, Onion, Tomato, Curd, Green Chilli, Mint Leaves, Coriander, Lemon Juice, Water, Cumin Seeds, Cardamom, Bay Leaves, Cinnamon Stick, Star Anise, Turmeric Powder, Whole Black Peppercorns, Ghee Oil, Salt",25,50,20,70,4,Indian,Lunch,Eggetarian
Methi Muthiya (Wheat Flour And Fenugreek Dumplings) Recipe,"Methi Leaves, Whole Wheat Flour, Salt, Turmeric Powder, Red Chilli Powder, Asafoetida, Cumin Powder, Ajwain, Sesame Seeds, Sunflower Oil, Lemon Juice, Sugar, Sunflower Oil, Fennel Seeds, Mustard Seeds, Cumin Seeds, Sunflower Oil",17,20,30,50,4,Indian,Snack,Vegetarian
High Protein Spinach Basil & Cheese Omelette Recipe,"Whole Egg, Milk, Green Chilli, Garlic  Sliced, Basil Leaves, Sunflower Oil, Salt And Pepper, Spinach, Sweet Corn, Tomato, Garlic, Cheese",12,10,30,40,4,French,World Breakfast,Vegetarian
Mixed Vegetable Sagu Recipe - Karnataka Style Vegetable Kurma Recipe,"Carrot, Potato, Green Beans, Knol Khol, Green Peas, Onion, Tomato, Turmeric Powder, Sunflower Oil, Mustard Seeds, White Urad Dal, Curry Leaves, Salt, Fresh Coconut, Ginger, Garlic, Coriander, Cumin Seeds, Roasted Gram Dal, Poppy Seeds, Green Chilli, Cinnamon Stick, Cloves, Star Anise, Cardamom, Coriander, Mint Leaves",27,25,20,45,4,Karnataka,South Indian Breakfast,Vegetarian
Mexican Lime Chicken Recipe,"Chicken Breasts, Extra Virgin Olive Oil, Lemon Juice, Lemon Zest, Garlic, Coriander, Salt, Paprika Powder, Coriander",9,70,30,100,4,Mexican,Appetizer,Non Vegeterian
Andhra Style Paakundalu/ Pakam Undalu Recipe (Rice flour Coconut Fritters),"Rice, Jaggery, Fresh Coconut, Cardamom Powder, Ghee Oil For Cooking",5,130,30,160,4,Andhra,Dessert,Vegetarian
Makhana ki Sabzi Recipe,"Phool Makhana, Green Peas, Ginger, Onion, Cashew Nuts, Poppy Seeds, Pumpkin Seeds, Bay Leaf, Cardamom, Cinnamon Stick, Cloves, Green Chilli, Red Chilli Flakes, Fresh Cream, Ghee, Sunflower Oil Cook",16,10,30,40,4,North Indian Recipes,Lunch,Vegetarian
Szechuan Vegetarian Fried Rice,"Rice, Green Beans, Carrot, Green Bell Pepper, Dry Red Chilli, Garlic, Ginger, Red Chilli Sauce, Soy Sauce, Vinegar, Salt, Black Pepper Powder",12,20,30,50,2,Sichuan,Lunch,Vegetarian
Achari Gobi Shimla Mirch Ki Sabzi Recipe - Capsicum And Cauliflower Sabzi,"Cauliflower, Green Bell Pepper, Tomato, Onion, Coriander Powder, Cumin Powder, Garlic, Sunflower Oil, Mustard Seeds, Methi Seeds, Lemon Juice, Salt, Red Chilli Powder",13,15,10,25,3,North Indian Recipes,Lunch,Vegetarian
Carrot and Oats  Whole Wheat Bread Recipe,"Carrots, Sooji, Instant Oats, Whole Wheat Flour, Baking Powder, Milk, Honey, Whole Eggs, Sunflower Oil",9,15,50,65,4,Continental,World Breakfast,Eggetarian
Chole Biryani Recipe - Spicy Chana Biryani  Recipe,"Rice, Cardamom, Clove Cloves, Cinnamon Stick, Bay Leaf, Milk, Water, Ghee, Salt, Onion, Sunflower Oil, Potato, Amchur, Red Chilli Powder, Cumin Powder, Coriander, Mint Leaves, Kabuli Chana, Garlic, Ginger, Green Chilli, Garam Masala Powder, Red Chilli Powder, Curd, Turmeric Powder, Tomato, Ghee, Salt",28,510,40,550,6,North Indian Recipes,Main Course,Vegetarian
Herbed Butter Garlic Quinoa Recipe,"Quinoa, Garlic, Onion, Red Chilli Flakes, Mixed Herbs, Extra Virgin Olive Oil, Butter, Salt, Lemon Juice",9,10,20,30,4,Continental,Main Course,Vegetarian
Rajgira Paneer Paratha Recipe (Navratri Fasting/Vrat Recipe),"Rajgira Flour, Potato, Paneer, Green Chilli, Turmeric Powder, Cumin Powder, Coriander, Whole Black Peppercorns, Salt Rock Salt, Sunflower Oil Ghee For Cooking",10,15,10,25,4,North Indian Recipes,Lunch,Diabetic Friendly
Grilled Paneer Pineapple Sandwich Recipe,"Whole Wheat Brown Bread, Butter, Britannia Cheese Spread, Red Chilli Flakes, Pineapple, Paneer, Green Bell Pepper, Salt, Cheese",9,5,20,25,2,Continental,Snack,Vegetarian
Oats and Vegetable Kebab Recipe,"Suran, Raw Banana, Carrot, Onion, Ginger, Garlic, Red Chili Powder, Turmeric Powder, Cumin Powder, Coriander Powder, Amchur Powder, Oats Coat, Milk, Salt, Black Chili Powder, Oil",16,15,35,50,4,North Indian Recipes,Snack,Vegetarian
Strawberry Chocolate Loaf Cake Recipe,"Whole Wheat Flour, Baking Powder, Baking Soda, Vanilla Extract, Cocoa Powder, Strawberry Compote Fresh Puree, Curd, Extra Virgin Olive Oil, Condensed Milk, Butterscotch Chips Almonds",10,20,40,60,6,Continental,Dessert,Eggetarian
Cheddar Beer Bread Recipe - Cheesy Bread Recipe,"All Purpose Flour, Cheddar Cheese, Garlic, Sugar, Baking Powder, Salt, Beer, Tablespoons Butter, Mixed Herbs",9,10,30,40,4,Continental,Appetizer,Vegetarian
Healthy Fruit & Nut Watermelon Dessert Recipe With Greek Yogurt,"Watermelon, Black Grapes, Walnuts, Badam, Mint Leaves, Hung Curd, Fresh Cream, Sugar, Vanilla Extract",9,15,0,15,4,Continental,Dessert,Vegetarian
Tandoori Potatoes Recipe,"Baby Potato, Sunflower Oil, Tikka Masala, Fresh Cream Milk, Kasuri Methi, Salt, Kashmiri Dry Red Chilli, Garlic, Ginger, Coriander Powder, Cumin Powder, Water",12,10,30,40,3,North Indian Recipes,Appetizer,Vegetarian
Mango Kalakand Recipe,"Mango, Paneer, Condensed Milk, Cardamom, Fresh Coconut",5,10,190,200,4,North Indian Recipes,Dessert,Vegetarian
Sesame Noodles Recipe With Napa Cabbage,"Napa Cabbage, Carrot, Hakka Noodles, Sesame Seeds, Soy Sauce, Vinegar, Ginger, Garlic, Onion, Sunflower Oil, Salt",11,15,15,30,4,Asian,Dinner,Vegetarian
Bengali Potol Bhaja Recipe-Bengali Style Parwal Sabzi,"Pointed Gourd, Mustard Oil, Turmeric Powder, Salt",4,10,25,35,3,Bengali Recipes,Side Dish,Vegetarian
Kerala Style Arbi Curry,"Gm Arabic, Peel, Tamarind, Salt, Coconut, Red Chilli Powder, Onion, Coconut Oil, Onion, Mustard, Cumin Seeds, Dry Red Chilli, Curry Leaves",13,15,25,40,3,Kerala Recipes,Lunch,Vegetarian
Awadhi Khaas Nihari Recipe,"Mutton, Sunflower Oil, Water, Ginger, Garlic, Onion, Curd, Rose Water, Saffron Strands, Coriander, Ginger  Julienne, Cardamom, Cinnamon Stick, Black Cardamom, Bay Leaves, Turmeric Powder, Coriander Powder, Red Chilli Powder, Garam Masala Powder, Nutmeg Powder, Cardamom Powder, Salt, Whole Wheat Flour, Water",24,15,120,135,4,Awadhi,Dinner,Non Vegeterian
Cabbage Onion Vada Recipe,"White Urad Dal, Cabbage, Onion, Ginger, Green Chilli, Coriander, Salt",7,180,40,220,5,South Indian Recipes,Snack,Vegetarian
Cantonese Chicken With Mushrooms Recipe,"Boneless Chicken, Shiitake Mushrooms, Bok Choy, Spring Onion, Garlic, Black Pepper Powder, Light Soy Sauce, Fish Sauce, Oyster Sauce, Red Chilli Sauce, Rice Wine Vinegar, Salt, Sesame, Brown Sugar, Corn Flour, Spring Onion Greens, Sesame Seeds",17,20,25,45,5,Cantonese,Dinner,Non Vegeterian
Goan Style Banana Halwa Recipe (Kelyacho Halwo),"Ripe Bananas, Sugar, Ghee, Cloves, Cardamom Powder",5,5,30,35,3,Goan Recipes,Dessert,Vegetarian
Chocolate Coffee Sticky Cake Recipe,"All Purpose Flour, Brown Sugar, Instant Coffee Powder, Dark Chocolate Chips, Cinnamon Powder, Nutmeg Powder, Baking Powder, Salt, Walnuts, Butter, Whole Eggs, Vanilla Extract, Water",13,20,50,70,6,Continental,Dessert,Eggetarian
Chole Capsicum Masala Recipe ,"Kabuli Channa, Green Capsicum, Onion, Ginger Garlic Paste, Coriander Powder, Red Chili Powder, Cumin Powder, Turmeric Powder, Kasuri Methi, Cashew Nuts, Tomato Puree, Oil Cook, Salt",13,30,40,70,4,North Indian Recipes,Dinner,Vegetarian
Carrot Tadka Raita Recipe- Crunchy Grated Carrot In Yogurt,"Curd, Carrots, Coriander, Mint Leaves, Green Chilli, Black Salt, Cumin Powder, Salt, Sunflower Oil, Cumin Seeds, Garlic, Asafoetida",12,10,5,15,2,Indian,Side Dish,Vegetarian
Besan Arbi Roast Recipe - Spicy Colocasia Stir Fry,"Colocasia Root, Gram Flour, Red Chilli Powder, Coriander Powder, Turmeric Powder, Amchur, Cumin Powder, Salt, Asafoetida, Sunflower Oil, Sunflower Oil, Ajwain, Cumin Seeds, Green Chilli, Lemon Juice, Coriander",16,20,30,50,4,Indian,World Breakfast,Gluten Free
Carrot And Capsicum Rice ,"Rice, Cumin Seeds, Curry Leaves, Green Chili, Carrot, Capsicum, Onion, Red Chilli Powder, Black Pepper Powder, Ghee  Coriander  Little, Salt",11,20,45,65,2,Indian,Lunch,Vegetarian
Senai Kizhangu Varuval Recipe - Spicy Chettinad Style Yam Stir Fry,"Elephant Yam, Turmeric Powder, Red Chilli Powder, Coriander Powder, Curry Leaves, Salt, Sunflower Oil",7,15,30,45,4,South Indian Recipes,Lunch,Vegetarian
"Date, Nuts And Quinoa Energy Bite Recipe","Cashew Nuts, Raw Peanuts, Quinoa, Instant Oats, Dates, Honey, Dessicated Coconut, Cocoa Powder, Ghee",9,20,5,25,6,Continental,Snack,Vegetarian
Gavarfali Ki Sukhi Sabzi ,"Onion, Gwar Pods   Into Small Pieces, Cumin Seeds, Garlic, Oil, Turmeric Powder, Coriander Powder, Cumin Powder, Red Chili Powder, Salt",10,10,30,40,4,Rajasthani,Lunch,Vegetarian
Mullangi Curry ,"Radishes, Turmeric Powder, Red Chilli Powder, Coriander Powder, Salt, Chana Dal, Sesame Oil, Black Urad Dal, Cumin Seeds, Curry Leaves",10,15,25,40,4,Tamil Nadu,Dinner,Diabetic Friendly
Dum Pukht Gosht Recipe - Slow Cooked Mutton Curry,"Mutton, Curd, Cardamom, Brown Cardamom, Black Pepper Corns, Cloves, Cinnamon Stick, Cumin, Onion, Garlic, Ginger, Green Chilli, Coriander, Red Chilli Powder, Turmeric Powder, Garam Masala Powder, Coriander, Ghee, Whole Wheat Flour, Water",20,15,60,75,4,Lucknowi,Lunch,Non Vegeterian
Idli Manchurian Recipe With Oriental Twist,"Idli, Onion, Green Bell Pepper, Ginger, Red Chilli Powder, Soy Sauce, Green Chilli, Sunflower Oil, Dried Oregano, Salt, Spring Onion Greens, Coriander",12,120,10,130,2,Indo Chinese,Snack,Vegetarian
Konkani Style Avnas Ambe Sasam Recipe-Fruit Salad with Coconut,"Pineapple, Mango, Green Seedless Grapes, Fresh Coconut, Dry Red Chilli, Jaggery, Mustard Seeds, Mustard Seeds, Curry Leaves, Sunflower Oil",10,10,5,15,4,Konkan,Dessert,Vegetarian
Kakdi Chi Koshimbir Recipe - Maharashtrian Style Cucumber Salad,"Cucumber, Coriander, Green Chilli, Fresh Coconut, Roasted Peanuts, Sugar, Lemon Juice, Salt, Ghee, Mustard Seeds, Dry Red Chilli, Curry Leaves",12,15,10,25,4,Maharashtrian Recipes,Lunch,Diabetic Friendly
Chatpati Sattu Ki Kachori Recipe - Kachori Stuffed With Sattu And Pickle,"All Purpose Flour, Sooji, Sunflower Oil, Water, Roasted Gram Flour, Ajwain, Salt, Mustard Oil, Lemon Juice, Pickle, Garlic  Finely, Ginger  Finely, Green Chilli, Onion, Coriander, Sunflower Oil",16,15,45,60,15,Rajasthani,Snack,Vegetarian
Foxtail Millet Pongal Recipe,"Foxtail Millet, Yellow Moong Dal, Green Chilli, Cumin Seeds, Whole Black Peppercorns, Curry Leaves, Cashew Nuts, Asafoetida, Ginger, Ghee, Sunflower Oil, Salt",12,70,35,105,15,South Indian Recipes,South Indian Breakfast,Vegetarian
Shepuchi Bhaji Recipe (Stir Fried Maharashtrian Suva/Dill Greens),"Dill Leaves, Onion, Garlic, Yellow Moong Dal, Green Chilli, Sunflower Oil, Mustard Seeds, Cumin Seeds, Turmeric Powder, Salt",10,10,30,40,2,Maharashtrian Recipes,Dinner,Vegetarian
Bhindi & Capsicum Sabzi Recipe,"Bhindi, Green Bell Pepper, Cumin Seeds, Ginger, Turmeric Powder, Red Chilli Powder, Coriander Powder, Fresh Coconut, Salt, Sunflower Oil",10,10,35,45,4,North Indian Recipes,Side Dish,Vegetarian
Oats Ven Pongal Recipe,"Ghee, Instant Oats, Yellow Moong Dal, Salt, Ghee, Cashew Nuts, Ginger, Asafoetida, Whole Black Peppercorns, Curry Leaves",10,10,30,40,4,South Indian Recipes,South Indian Breakfast,Vegetarian
Kerala Style Chicken Chatti Pathiri Recipe,"Chicken, Onion, Curry Leaves, Garlic, Ginger, Turmeric Powder, Red Chilli Powder, Garam Masala Powder, Black Pepper Powder, Coconut Oil, Salt, Whole Wheat Flour, All Purpose Flour, Salt",14,10,40,50,4,Kerala Recipes,Snack,Non Vegeterian
Black Eyed Peas Masala Vadas Recipe,"Black Eyed Beans, Sweet Corn, Curry Leaves, Coriander, Mint Leaves, Green Chilli, Ginger, Dry Coconut, Asafoetida, Sesame Seeds, Onion, Salt, Sunflower Oil Deep Fry",13,20,30,50,4,Karnataka,Snack,Vegetarian
Nawabi Paneer Curry Recipe,"Paneer, Lemon Juice, Salt, Cumin Powder, Chaat Masala Powder, Black Pepper Powder, Oil, Coconut, Cashews, Green Chilli, Cinnamon, , Cardamom, Cumin, Water, Ghee, Onion, Garlic, Ginger, Green Peas, Capsicum, Coriander, Salt, Turmeric Powder, Pepper Powder, Coconut Milk, Water",27,15,20,35,4,Hyderabadi,Main Course,Vegetarian
Broccoli Chilli Noodles With Grilled Salmon Recipe,"Salmon Fillet, Sesame, Rice Wine Vinegar, Fish Sauce, Lemongrass, Ginger, Garlic, Red Chilli Flakes, Lemon Zest, Whole Black Peppercorns, Egg Noodles, Sesame, Red Chilli Flakes, Garlic, Ginger, Soy Sauce, Vinegar, Salt, Broccoli, Extra Virgin Olive Oil, Salt, Whole Black Peppercorns",22,10,45,55,4,Fusion,Lunch,Vegetarian
Palak Pulao ,"Rice, Spinach, Cumin Seeds, Ginger, Tomato Puree, Turmeric Powder, Sambar Powder, Garam Masala Powder, Ghee Til Oil, Salt",10,10,40,50,4,Indian,Lunch,Vegetarian
Roasted Garlic Potato Soup Recipe,"Potato, Garlic, Rosemary, Black Pepper Powder, Salt, Extra Virgin Olive Oil, Garlic, Extra Virgin Olive Oil",8,10,20,30,4,Continental,Appetizer,Vegetarian
Vegetable Filled Souffle Recipe,"Margarine, All Purpose Flour, Salt, Cayenne Pepper, Milk, Egg Whites, Egg Yolks, White Vinegar, Basil Leaves, Onion, Clove Garlic, Extra Virgin Olive Oil, Yellow Zucchini, Basil Leaves, Parmesan Cheese",15,15,50,65,6,Continental,World Breakfast,Eggetarian
Vegetarian Hakka Noodles Recipe,"Hakka Noodles, Onion, Ginger, Carrot, Capsicum, Cabbage, Green Beans, Green Onion, Pepper Powder, Soy Sauce, Red Chilli Sauce, Chilli Vinegar, Salt, As Per",14,20,30,50,4,Cantonese,Main Course,Vegetarian
Mysore Chutney Recipe,"Oil, Chana Dal, Dry Red Chilli, Lemon Juice, Salt, Coconut Powder, Spoon Curry Leaves, Ginger",8,20,45,65,4,Karnataka,Side Dish,Vegetarian
Ragi Halwa Recipe | Healthy Indian Sweet Made With Ragi,"Ragi Seeds, Jaggery, Cardamom Powder, Milk, Water, Cashew Nuts, Ghee",7,5,60,65,4,Karnataka,Dessert,High Protein Vegetarian
Indian Festive Sweet Rice And Jamun Bhog Recipe,"Govind Bhog Rice, Sugar, Water, Rose Water, Cardamom Powder, Bay Leaf, Ghee, Saffron Strands, Paneer, All Purpose Flour, Caster Sugar, Cardamom Powder, Ghee, Saffron Strands, Sugar, Water",16,30,60,90,4,Bengali Recipes,Dessert,Vegetarian
Raw Tomato Chutney Recipe,"Tomato, Green Chilli, Garlic, Methi Seeds, Salt, Jaggery, Curry Leaves, Onion, Mustard Seeds, Sunflower Oil Cook",10,20,20,40,4,South Indian Recipes,Side Dish,Vegetarian
Raw Banana Raita Recipe,"Curd, Raw Banana, Cumin Powder, Ginger, Mustard Seeds, White Urad Dal, Dry Red Chilli, Curry Leaves, Salt",9,10,5,15,4,Indian,Side Dish,Vegetarian
Vegan Burger Recipe With Beans And Tofu Patty,"Moth Dal, Kala Chana, Onion, Carrot, Button Mushrooms, Potato, Tofu  Grated, Ginger Garlic Paste, Coriander Powder, Cumin Powder, Coriander, Mint Leaves, Whole Wheat Bread Crumbs, Red Chilli Powder, Garam Masala Powder, Rice Flour, Lemon Juice, Sunflower Oil, Salt And Pepper, Burger Buns, Tomato, Onion, Iceberg Lettuce, Roasted Tomato Pasta Sauce",24,20,60,80,4,Continental,Lunch,Vegan
Bengali Style Kucho Nimki Recipe (Diamond Shaped Salty Snacks),"All Purpose Flour, Kala Jeera Kalonji, Sunflower Oil, Water, Salt, Sunflower Oil Cook",6,15,30,45,4,Bengali Recipes,Snack,Vegetarian
Tzatziki Recipe - A Greek Yogurt Dip,"Hung Curd, English Cucumber, Extra Virgin Olive Oil, Garlic, Parsley Leaves, Black Pepper Powder, Salt",7,5,20,25,4,Mediterranean,Side Dish,Vegetarian
Crispy Palak Pakora Recipe,"Spinach, Flour, Red Chilli Powder, Celery, Turmeric Powder, Chaat Masala Powder Sprinkle, Salt, Oil",8,15,25,40,5,Indian,Snack,Vegetarian
Malabar Mutton Biryani Recipe,"Basmati Rice, Mutton, Green Chilli, Ginger Garlic Paste, Coriander, Mint Leaves, Curd, Tomato, Onion, Cumin Seeds, Bay Leaf, Cashew Nuts, Raisins, Cardamom, Ghee, Coriander Powder, Milk, Saffron Strands, Water, Green Chilli, Cinnamon Stick, Cloves, Fennel Seeds, Cardamom, Whole Black Peppercorns",25,20,40,60,2,Malabar,Main Course,Non Vegeterian
Thalicha Thayir Sadam Recipe - Spicy Seasoned Curd Rice,"Cooked Rice, Curd, Anardana Powder, Green Chilli, Salt, Mustard Seeds, White Urad Dal, Curry Leaves, Sunflower Oil",9,20,30,50,4,Chettinad,Lunch,Vegetarian
Eggless Fudgy Chocolate Chunk Brownie Recipe,"All Purpose Flour, Baking Powder, Cocoa Powder, Salt, Sugar, Butter, Vanilla Extract, Chocolate Bar, Flax Seed Powder, Chilled Water",10,20,40,60,6,Continental,Dessert,Vegetarian
Marwadi Gatte Ki Kadhi Recipe - Gram Flour Dumpling In Yogurt Curry,"Gram Flour, Red Chilli Powder, Ajwain, Curd, Salt, Gram Flour, Curd, Garlic, Green Chilli, Turmeric Powder, Salt, Coriander, Ghee, Cumin Seeds, Dry Red Chilli, Cinnamon Stick",16,10,45,55,4,Rajasthani,Lunch,Vegetarian
Whole Wheat Flour Chakli Recipe,"Whole Wheat Flour, Red Chilli Powder, Cumin Seeds, Butter, Sunflower Oil, Asafoetida, Salt",7,30,40,70,4,South Indian Recipes,Snack,Vegetarian
Raw Mango Dal Fry Recipe,"Cup Arhar Dal, Tablespoon Mango, Turmeric Powder, Red Chilli Powder, Tomato, Green Chilli, Curry Leaves, Onion, Dry Red Chilli, Garlic, Salt, Ghee",12,10,30,40,2,North Indian Recipes,Side Dish,High Protein Vegetarian
KhiraSaku ( Odiya Style Rice Pan Cake) Recipe,"Basmati Rice, Sugar, Milk, Dry Fruits, Ghee",5,10,225,235,3,Oriya Recipes,Dessert,Vegetarian
Maharashtrian Goda Masala Powder Recipe,"Coriander, Cumin Seeds, Cinnamon Stick, Whole Black Peppercorns, Cloves, Bay Leaves, Dagad Phool, Nagkesarcassia Buds, Ajwain, Asafoetida, Dried Turmeric, Methi Leaves, Sesame Seeds, Dessicated Coconut, Poppy Seeds, Red Chilli Powder, Salt, Sunflower Oil",18,0,300,300,200,Maharashtrian Recipes,Dessert,Vegetarian
Assamese Fish Fried Rice ,"Rice, Fish, Onion, Dry Coconut, Coriander Powder, Turmeric Powder, Cumin Powder, Ginger, Green Peas, Carrot, Bay Leaf, Oil, Lemon Juice, Salt, Green Coriander, Green Onion",16,10,15,25,2,Assamese,Dinner,High Protein Non Vegetarian
Chatpata Rajma Salad Recipe - Kidney Beans Salad Recipe,"Rajma, Onion, Tomato, Green Chilli, Chaat Masala Powder, Lemon, Mint Leaves, Salt",8,15,25,40,4,North Indian Recipes,Side Dish,High Protein Vegetarian
Odisha Style Aloo Bharta Recipe -Aloo Mash Sabzi,"Potato, Mustard Seeds, Curry Leaves, Dry Red Chilli, Onion, Green Chilli, Salt",7,10,30,40,4,Oriya Recipes,Side Dish,Vegetarian
Kashmiri Style Bharit Marchavangun Recipe-Stuffed Chillies,"Badi Hari Mirch, Walnuts, Cumin Seeds, Anardana Powder, Dry Ginger Powder, Salt, Vinegar, Sunflower Oil",8,10,50,60,4,Kashmiri,Appetizer,Vegetarian
Karwar Style Bibya Usal Recipe (Spiced Cashew Nut Sabzi),"Cashew Nuts, Fresh Coconut, Sugar, Salt, Coconut Oil, White Urad Dal, Mustard Seeds, Dry Red Chilli, Garlic, Turmeric Powder, Curry Leaves",11,5,10,15,2,Karnataka,Side Dish,Vegetarian
Chocolate Banana Smoothie Bowl Recipe,"Ripe Bananas, Milk, Peanut Butter, Instant Oats, Cocoa Powder, Dates, Walnuts, Ripe Bananas, Wheat Bran, Cranberries Raisins",10,10,0,10,2,Continental,World Breakfast,High Protein Vegetarian
Rava Vada Recipe,"Sooji, Curd, Onion, Green Chilli, Curry Leaves, Coriander, Cumin Seeds, Whole Black Peppercorns, Sunflower Oil, Salt",10,20,20,40,3,South Indian Recipes,South Indian Breakfast,Vegetarian
Mushroom Caldine Recipe | Vegetarian Goan Mushroom Curry,"Button Mushrooms, Coconut Milk, Onion, Green Chilli, Garlic, Ginger, Salt, Sunflower Oil, Fresh Coconut, Tamarind, Cumin, Coriander, Dry Red Chilli, Turmeric Powder, Water",15,10,15,25,4,Goan Recipes,Lunch,Vegetarian
Thai Ice Tea Recipe,"Lukewarm Water, Tea Monk Bodh Second Flush Black Tea, Honey, Brown Sugar, Vanilla Extract, Coconut Milk, Ice Cubes",7,10,5,15,4,Thai,Appetizer,Vegetarian
Awadhi Style Karela Ka Dulma Recipe - Stuffed Bitter Gourd In Yogurt Gravy,"Karela, Curd, Onion, Garlic, Coriander Powder, Turmeric Powder, Amchur, Kalonji, Ajwain, Badam, Salt, Sunflower Oil",12,10,30,40,4,Awadhi,Side Dish,Diabetic Friendly
Tamarind Ginger Chutney,"Tamarind Paste, Ginger, Green Chilli, Turmeric Powder, Fenugreek Seeds, Red Chilli Powder, Asafoetida, Jaggery, Sesame Oil, Rye, Curry Leaves  Finely, Salt",12,10,20,30,4,South Indian Recipes,Side Dish,Vegetarian
Whole Masala Gobhi Recipe - Spiced Whole Roasted Cauliflower Masala,"Cauliflower, Onion, Potato, Sunflower Oil, Hung Curd, Red Chilli Powder, Coriander Powder, Garam Masala Powder, Garlic, Ginger, Salt, Coriander",12,10,40,50,4,Indian,Side Dish,Diabetic Friendly
Konkani Style Maskasangi Magge Koddel Recipe-Drumstick and Mangalore Cucumber Curry,"Drumstick, Mangalorean Cucumber, Tamarind Water, Red Chilli Powder, Turmeric Powder, Jaggery, Garlic, Salt, Dry Red Chilli, Coriander, Fresh Coconut",11,20,30,50,4,Konkan,Lunch,Vegetarian
Karachi Biscuits Recipe,"All Purpose Flour, Butter, Custard Powder, Caster Sugar, Cashew Nuts, Tutti Frutti, Baking Powder, Milk",8,15,20,35,4,Indian,Snack,Vegetarian
Malvani Masala Powder Recipe,"Dry Red Chilli, Coriander Seeds, Whole Black Pepper, Fennel Seeds, Cumin Seeds, Poppy Seeds, Mace, , Cinnamon, Star Anis, Stone Flower, Nutmeg Powder, Turmeric Powder, Asafoetida",14,5,10,15,4,Maharashtrian Recipes,Snack,Vegetarian
Padipe Saasmi Recipe - Udupi Style Amaranth Leaves Curry With Coconut & Tamarind,"Red Amaranth Leaves, Fresh Coconut, Dry Red Chilli, Green Chilli, Mustard Seeds, Cumin Seeds, Tamarind, Salt, Sunflower Oil, Sunflower Oil, Mustard Seeds, Dry Red Chilli, White Urad Dal, Curry Leaves",14,15,20,35,4,Udupi,Side Dish,Vegetarian
Bengali Style Cholar Dal Recipe-Chana Dal,"Chana Dal, Ghee, Ginger, Fresh Coconut, Fresh Coconut, Raisins, Green Chilli, Turmeric Powder, Salt, Sugar, Cumin Seeds, Cardamom, Cinnamon Stick, Dry Red Chilli, Bay Leaf, Asafoetida",16,10,40,50,4,Bengali Recipes,Lunch,High Protein Vegetarian
Savory Flax Seed Multigrain Crackers Recipe,"Whole Wheat Flour, Jowar Flour, Ragi Flour, Sunflower Oil, Sesame Seeds, Flax Seeds, Green Chilli, Few  Coriander, Few Curry Leaves, Water, Salt",11,45,20,65,4,Chettinad,Lunch,Non Vegeterian
Broccoli & Bell Pepper Zunka Recipe,"Cumin Seeds, Turmeric Powder, Asafoetida, Red Chilli Powder, Gram Flour, Water, Broccoli, Cabbage, Red Bell Pepper, Green Bell Pepper, Sunflower Oil",11,15,20,35,4,Maharashtrian Recipes,North Indian Breakfast,No Onion No Garlic (Sattvic)
Stuffed Omelette Recipe With Cheesy Garlic Mushroom & Corn,"Button Mushrooms, Sweet Corn, Nutralite Cheesy Garlic Mayo, Basil Leaves, Nutralite Garlic & Oregano Spread, Nutralite Garlic & Oregano Spread, Whole Eggs, Salt And Pepper",8,10,15,25,4,Continental,World Breakfast,High Protein Vegetarian
Vegetarian Sloppy Joe Recipe,"Burger Buns, Cucumber, Del Monte Cheesy Garlic Mayo, Onion, Garlic, Masoor Dal, Homemade Tomato Puree, Sweet And Spicy Red Chilli Sauce, Sugar, Cumin Powder, Salt",11,150,30,180,2,Continental,Dinner,High Protein Vegetarian
Bengali Beetroot And Raw Banana Chop Recipe (Spiced Cutlet Recipe),"Beetroot, Raw Banana, Fresh Coconut, Roasted Peanuts, Ginger, Green Chilli, Cumin Powder, Coriander Powder, Fennel Seeds, Red Chilli Powder, Corn Flour, Salt, Whole Wheat Bread Crumbs, Sunflower Oil",14,20,45,65,4,Bengali Recipes,Snack,Vegetarian
Quick and Easy Bread Upma Recipe,"Whole Wheat Brown Bread, Tomato, Onion, Green Chilli, Sambar Powder, Turmeric Powder, Mustard Seeds, Curry Leaves, Salt, Butter, Coriander",11,15,30,45,4,Indian,South Indian Breakfast,Vegetarian
Vegan Baingan Makhani Recipe (Eggplant In Rich Coconut Gravy),"Brinjal, Tomato, Garlic, Ginger, Green Chilli, Coriander Powder, Red Chilli Powder, Garam Masala Powder, Cardamom Powder, Fennel Powder, Coconut Cream, Kasuri Methi, Coriander, Onion, Bay Leaf, Sunflower Oil, Salt",17,10,30,40,4,Indian,Dinner,Vegan
Thandai Kulfi Recipe - Holi Recipe,"Milk, Sugar, Badam, Cashew Nuts, Pistachios, Poppy Seeds, Cardamom Powder, Fennel Seeds, Cinnamon Powder, Whole Black Peppercorns",10,20,60,80,8,Indian,Dessert,Vegetarian
Crispy Eggless Pinwheels Bread Recipe,"Whole Wheat Brown Bread, Potato, Chenna, Onion, Green Chilli, Cheddar Cheese, Garam Masala Powder, Red Chilli Powder, Cumin Powder, Red Chilli Flakes, Dried Oregano, Dried Thyme Leaves, Red Chilli Flakes, Salt, Butter, Sunflower Oil Grease",16,50,10,60,4,Fusion,Appetizer,Vegetarian
Watalappan Recipe - Steamed Egg Pudding With Jaggery,"Coconut Milk, Jaggery, Whole Eggs, Cardamom Powder, Cinnamon Powder, Pistachios, Cashew Nuts, Raisins",8,20,30,50,5,Sri Lankan,Dessert,Eggetarian
Calcutta Style Ghugni Recipe-Tangy Yellow Peas Curry,"Dried Yellowwhite Peas, Ginger, Kalonji, Turmeric Powder, Lemon Be Used When Serving, Green Chilli, Ginger, Coriander, Salt, Cumin Seeds, Coriander, Rock Salt, White Pepper Powder, Amchur, Red Chilli Powder, Bay Leaves",16,250,40,290,4,Bengali Recipes,Snack,High Protein Vegetarian
Karantaka Style Seke Undlaka/ Undlige Recipe (Mini steamed sweet dumplings Recipe),"Rice Flour, Salt, Jaggery, Fresh Coconut, Cardamom",5,0,30,30,4,Karnataka,Dessert,Vegetarian
Homemade Easy Gulab Jamun Recipe - Delicious & Tasty,"Milk Powder, All Purpose Flour, Cardamom Powder, Baking Soda, Fresh Cream, Ghee, Sunflower Oil, Sugar, Water, Rose Water, Saffron Strands",11,15,30,45,40,North Indian Recipes,Dessert,Vegetarian
Aamras Ki Kadhi Recipe - Mango Kadhi Recipe,"Aamras, Curd, Gram Flour, Turmeric Powder, Water, Dry Red Chilli, Asafoetida, Cumin Seeds, Red Chilli Powder, Ginger, Curry Leaves, Ghee, Salt",13,10,10,20,2,Gujarati Recipesï»¿,Dinner,Vegetarian
Kerala Pazham Pori Recipe - Banana Fritters Recipe | Nedra Pazham Fry,"Nendra Pazham Banana, All Purpose Flour, Rice Flour, Baking Soda, Salt, Turmeric Powder, Cardamom Powder, Sugar, Sunflower Oil",9,5,15,20,4,Kerala Recipes,Snack,Vegetarian
Mexican Taco Recipe With Spicy Tofu Crumble,"Soft Taco Shells Hard Taco Shells, Achari Mayo, Cheddar Cheese, Tofu, Sweet Corn, Tabasco Original, Extra Virgin Olive Oil, Cucumber, Tomato, Onion, Salt And Pepper",11,10,15,25,4,Mexican,Lunch,Gluten Free
Rava Ladoo Recipe | Sooji Laddu Recipe,"Ghee, Raisins, Cashew Nuts, Ghee, Sooji, Ghee, Dessicated Coconut, Sugar, Cardamom Powder",9,10,40,50,20,Indian,Dessert,Vegetarian
Mixed Millet Phulka Recipe - Ragi Jowar Bajra Wheat Phulka,"Ragi Flour, Bajra Flour, Jowar Flour, Whole Wheat Flour, Salt, Sunflower Oil, Ghee",7,10,20,30,4,North Indian Recipes,Side Dish,Vegetarian
Pavakka Theeyal Recipe - Spicy & Tangy Karela In Tamarind Gravy,"Karela, Onion, Tamarind Water, Water, Jaggery, Sunflower Oil, Salt, Fresh Coconut, Turmeric Powder, Coriander, Dry Red Chilli, Methi Seeds, Whole Black Peppercorns, Curry Leaves, Coconut Oil, Sunflower Oil, Mustard Seeds, Curry Leaves, Dry Red Chilli",19,20,30,50,3,Tamil Nadu,Lunch,Vegetarian
Parsi Salli Boti Recipe,"Mutton, Onion, Tomato, Garlic, Ginger, Green Chilli, Curd, Coriander Powder, Turmeric Powder, Red Chilli Powder, Bay Leaf, Salt, Sunflower Oil, Black Pepper Powder, Cloves, Cardamom, Black Cardamom, Cinnamon Stick, Mace, Ajwain, Coriander, Potato",22,10,60,70,4,Parsi Recipes,Lunch,Non Vegeterian
Smoked Tandoori Paneer Tikka Recipe,"Paneer, Pickled Onion, Sunflower Oil, Coal, Hung Curd, Gram Flour, Mint Leaves, Garlic, Ginger, Fennel Seeds, Ajwain, Saffron Strands, Cumin Powder, Coriander Powder, Black Pepper Powder, Turmeric Powder, Black Salt, Salt",18,10,45,55,4,Punjabi,Appetizer,Vegetarian
Khatti Meethi Tindora Sabzi Recipe - Gujarati Tindora Nu Shaak,"Tindora, Mustard Seeds, Cumin Seeds, Coriander Powder, Cumin Powder, Red Chilli Powder, Turmeric Powder, Ssp Asafoetida, Amchur, Salt, Jaggery, Curry Leaves, Sunflower Oil, Coriander, Raw Peanuts",15,10,30,40,4,Indian,Lunch,Vegetarian
Chettinad Style Chilli Gobhi Recipe,"Cauliflower, Curry Leaves, Kashmiri Red Chilli Powder, Black Pepper Powder, Ginger Garlic Paste, Sunflower Oil, Corn Flour, Rice Flour, Curd, Coriander, Ghee, Mustard Seeds, Green Chilli, Dry Red Chilli",14,20,30,50,4,Indian,Snack,Vegetarian
Shandong Spicy Eggplant With Peppers And Potato Recipe (Di San Xian Recipe),"Brinjal, Potato, Red Bell Pepper, Corn Flour, Soy Sauce, Vinegar, Black Pepper Powder, Garlic, Ginger, Spring Onion, Dry Red Chilli, Sesame, Salt",13,20,30,50,4,Chinese,Side Dish,Vegetarian
Roasted Fennel and Tomato Soup Recipe,"Fennel Bulb, Tomato, Extra Virgin Olive Oil, Butter, Garlic, Vegetable Stock, Salt, Whole Black Peppercorns, Rosemary, Dried Basil Leaves, Fresh Cream",11,20,40,60,4,European,Appetizer,Vegetarian
Healthy Aloo Roll Recipe (Baked Bread Potato Roll),"Whole Wheat Brown Bread, Butter, Sweet Potato, Onion, Coriander, Green Chilli, Green Bell Pepper, Raw Peanuts, Cumin Powder, Chaat Masala Powder, Lemon Juice, Red Chilli Powder, Salt, Sesame Seeds",14,30,30,60,4,Continental,Appetizer,Vegetarian
Chicken Donne Biryani Recipe - Bangalore Shivaji Military Style,"Chicken, Curd, Turmeric Powder, Lemon Juice, Salt, Coriander, Mint Leaves, Green Chilli, Seeraga, Sunflower Oil, Bay Leaf, Cinnamon Stick, Cloves, Cardamom, Star Anise, Onion, Ginger, Garlic, Salt",19,40,30,70,4,Karnataka,Main Course,Non Vegeterian
Andey Ki Kheer Recipe - Egg White Kheer,"Whole Eggs, Milk, Sugar, Dry Fruits  AÂ Handful Of Dry Fruits, Cardamom Powder, Kewra Water",6,10,90,100,4,Indian,Dessert,Eggetarian
Lilve Ki Sabzi Recipe (Green Chickpea Curry),"Sunflower Oil, Fresh Green Chickpeas, Potato, Bay Leaf, Black Cardamom, Ginger Garlic Paste, Onion, Onion, Curd, Red Chilli Powder, Turmeric Powder, Coriander Powder, Salt, Water, Coriander",15,15,45,60,3,North Indian Recipes,Lunch,Vegetarian
Tomato Onion Cucumber Raita ,"Hung Curd, Cucumber, Tomato, Green Chilli, Cumin Powder, Oil, Mustard, Salt",8,15,20,35,3,Indian,Side Dish,Vegetarian
Pudina Idli Recipe - Mint Flavoured Idli,"Idli Dosa Batter, Green Chutney",2,10,20,30,6,South Indian Recipes,South Indian Breakfast,Vegetarian
Kothamalli Thovayal Recipe (Dry Coriander Leaves Chutney),"Coriander, White Urad Dal, Dry Red Chilli, Asafoetida, Tamarind, Fresh Coconut, Sunflower Oil, Salt",8,5,10,15,4,South Indian Recipes,Side Dish,Vegetarian
Tomato Noodle Soup Recipe,"Tomato, Onion, Olive Oil, Salt, Black Pepper Powder",5,10,30,40,2,Fusion,Dinner,Vegetarian
Cheesy Vegetarian Pizza Muffins Recipe,"All Purpose Flour, Baking Powder, Salt, Green Bell Pepper, Whole Egg, Extra Virgin Olive Oil, Homemade Pizza And Pasta Sauce, Dried Oregano, Basil Leaves, Mozzarella Cheese",10,10,45,55,2,Fusion,Appetizer,Vegetarian
Ari Pathiri Recipe | Malabar Rice Flatbread Recipe,"Rice Flour  Roastedpathiri Podi, Water, Salt, Coconut Oil",4,30,30,60,3,Malabar,Indian Breakfast,Gluten Free
Amaranth Leaves Khichdi Recipe,"Yellow Moong Dal, Rice, Green Amaranth Leaves, Turmeric Powder, Green Chilli, Salt, Ghee, Cinnamon Stick, Cumin Seeds",9,10,30,40,3,Indian,Lunch,Vegetarian
Chole Semiya Pulao Recipe - Chickpea Vermicelli Pulao,"Semiya, Onion, Green Bell Pepper, Carrot, Kabuli Chana, Sunflower Oil, Ghee, Cumin Seeds, Red Chilli Powder, Turmeric Powder, Coriander Powder, Cumin Powder, Amchur, Chana Masala Powder, Salt, Coriander",16,20,15,35,4,Indian,Indian Breakfast,Vegetarian
Farali Pattice Recipe - A Popular Fasting Food,"Potato, Arrowroot Flour Corn Flour, Butter, Whole Wheat Bread Crumbs Sesame Seedspoppy Seedseven Â Rajgira Lahyas, Salt, Roasted Peanuts, Fresh Coconut, Sugar, Raisins, Lemon, Cashew Nuts, Green Chilli, Ginger, Garam Masala Powder, Coriander, Salt",16,20,40,60,4,Gujarati Recipesï»¿,Snack,No Onion No Garlic (Sattvic)
Matar Paneer Galette Recipe,"All Purpose Flour, Butter, Paneer, Green Peas, Homemade Tomato Puree, Onion, Ginger Garlic Paste, Coriander Powder, Red Chilli Powder, Asafoetida, Salt, Sunflower Oil, Fresh Cream, Cheddar Cheese, Coriander",15,10,60,70,4,Fusion,Snack,High Protein Vegetarian
Udupi Red Parboiled Rice Shavige Recipe,"Red Matta Rice, Dosa Rice, Fresh Coconut, Salt, Water",5,60,60,120,4,Udupi,South Indian Breakfast,Vegetarian
Masala Roti ,"Wheat Flour, Corn Flour, Oatmeal, Millet Flour, Ragi Flour, Red Chilli Powder, Coriander Powder, Turmeric Powder, Flaxseed Powder, Celery, Kasuri Methi, Water, Ghee Oilcook, Salt",14,10,30,40,4,Indian,Lunch,Vegetarian
Fruit And Nut Lauki Brownies Recipe,"Rolled Oats, Cocoa Powder, Baking Soda, Salt, Peanut Butter Almond Butter, Apple Puree, Bottle Gourd, Walnuts, Cranberries, Chocolate Chips, Honey, Vanilla Extract, Chocolate Ganache Chocolate Sauce As Needed",13,20,30,50,4,Continental,Dessert,Vegetarian
Maakhmi Dal Recipe-Sindhi Style Moong Dal,"Yellow Moong Dal, Ghee, Cinnamon Stick, Cloves, Cardamom, Onion, Tomato, Ginger, Green Chilli, Red Chilli Powder, Turmeric Powder, Coriander Powder, Cumin Powder, Garam Masala Powder, Mint Leaves, Salt, Water",17,30,15,45,4,Sindhi,Main Course,Vegetarian
Corn Cheese Balls Recipe,"Cheese, Potato, Corn Kernels, Green Bell Pepper, Coriander, Red Chilli Flakes, Dried Oregano, Black Pepper Powder, Garlic, Corn Flour, Salt, All Purpose Flour, Whole Wheat Bread Crumbs, Sunflower Oil",14,10,30,40,2,Continental,Appetizer,Vegetarian
Sorekai Majjige Huli Recipe (Bottle Gourd In Coconut Yogurt Curry Recipe),"Bottle Gourd, Salt, Turmeric Powder, Curd, Salt, Fresh Coconut, Chana Dal, Green Chilli, Cumin Seeds, Asafoetida, Sunflower Oil, Mustard Seeds, Curry Leaves, Dry Red Chilli",14,20,30,50,5,South Indian Recipes,Lunch,Diabetic Friendly
Dum Murgh Kali Mirch Recipe - Chicken In Rich White Gravy,"Boneless Chicken, Curd, Garam Masala Powder, Ginger Garlic Paste, Cashew Nuts, Onion, Ginger, Garlic, Green Chilli, Fresh Cream, Whole Black Peppercorns, Cumin Powder, Coal, Ghee, Coriander, Salt",16,20,30,50,5,Indian,Side Dish,High Protein Non Vegetarian
Paneer Matar Keema Recipe,"Green Peas, Potato, Paneer, Tomato, Homemade Tomato Puree, Cumin Seeds, Mustard Seeds, Asafoetida, Onion, Ginger Garlic Paste, Coriander, Red Chilli Powder, Turmeric Powder, Coriander Powder, Garam Masala Powder, Sunflower Oil, Salt, Water",18,35,30,65,5,North Indian Recipes,Lunch,Vegetarian
Palak Onion Kadhi Pakora Recipe,"Gram Flour, Spinach, Onion, Red Chilli Powder, Turmeric Powder, Green Chilli, Enos Fruit Salt, Sunflower Oil, Gram Flour, Hung Curd, Lukewarm Water, Turmeric Powder, Red Chilli Powder, Coriander Powder, Garam Masala Powder, Asafoetida, Salt, Cumin Seeds, Green Chilli, Curry Leaves, Ghee, Coriander, Salt",23,10,30,40,4,Punjabi,Lunch,Vegetarian
Dry Navratan Korma ,"Cabbage, Carrots, Green Beans, Green Chili, Capsicum, Potato, Onion, Ginger, Garlic, Green Chilli, Tomato, , Garam Masala Powder, Red Chili Powder, Salt, Oil, Bay Leaves, Cinnamon, Cardamom, Celery, Cottage Cheese, Butter, Cashew Nuts, Cups Pineapple, Pomegranate, Raisins, Cashews, Green Coriander Garnish, Coriander",29,20,20,40,4,North Indian Recipes,Lunch,Vegetarian
Madurai Spicy Tomato Chutney Recipe,"Onion, Dry Red Chilli, Tomato, Curry Leaves, Rye, Urad Dal, Salt, Water, Sesame Oil, Tamarind Paste, Sugar",11,10,10,20,4,Tamil Nadu,Side Dish,Vegetarian
Baked Cauliflower Samosa Recipe,"Whole Wheat Flour, Sunflower Oil, Baking Soda, Salt, Water, Cauliflower, Potato, Raw Peanuts, Ginger, Cumin Seeds, Fennel Seeds, Asafoetida, Dry Red Chilli, Green Chilli, Turmeric Powder, Sugar, Sunflower Oil, Kasuri Methi, Salt, Sunflower Oil Spray",20,45,40,85,6,Indian,Snack,Vegetarian
Tomato Basil Chicken Recipe,"Chicken Breasts, Mixed Herbs, Lemon Juice, Extra Virgin Olive Oil, Salt, Basil Leaves, Extra Virgin Olive Oil, Homemade Tomato Puree, Basil Leaves, Onion, Garlic, Mixed Herbs, Red Chilli Powder, Salt, Sugar",15,15,30,45,4,Continental,Main Course,High Protein Non Vegetarian
How to Cook Root Vegetables like Potatoes using a Pressure Cooker,"Potato, Water",2,2,30,32,300,Continental,Main Course,High Protein Non Vegetarian
Turai Pyaz Hari Mirch Ki Sabzi Recipe-Ridge Gourd Stir Fry With Green Chili And Onions,"Ridge Gourd, Badi Hari Mirch, Ajwain, Onion, Garlic, Ginger, Tomato, Turmeric Powder, Coriander Powder, Amchur, Jaggery, Salt, Sunflower Oil, Coriander",14,10,20,30,4,North Indian Recipes,Lunch,Vegetarian
Baby Corn Carrot Sabzi Recipe,"Baby Corn, Carrot, Green Chilli, Fennel Seeds, Red Chilli Powder, Coriander Powder, Amchur, Jaggery, Turmeric Powder, Salt, Fresh Coconut, Coriander, Sunflower Oil",13,10,30,40,4,North Indian Recipes,Side Dish,Vegetarian
Moong Dal Dubka Recipe,"Yellow Moong Dal, Tomato, Turmeric Powder, Mustard Oil, Salt, Onion, Ginger, Garlic, Dry Red Chilli, Cumin Seeds, Coriander, Whole Black Peppercorns",12,10,15,25,4,North Indian Recipes,Side Dish,High Protein Vegetarian
Cucumber Honey Limeade Recipe,"Cucumber, Honey, Salt, Lemon Juice, Aerated Water, Water, Ice Cubes Serve",7,15,7,22,2,Continental,Vegetarian,High Protein Vegetarian
Konkani Style Vengaya Sagle Recipe - Eggplant Drumstick Curry,"Drumstick, Brinjal, Mustard Seeds, Urad Dal Flour, Salt, Sunflower Oil, Fresh Coconut, Dry Red Chilli, Coriander, White Urad Dal, Tamarind, Jaggery",12,10,25,35,4,Konkan,Lunch,Vegetarian
Kerala Style Fish Curry Recipe,"Fish, Tamarind Water, Shallots, Coconut Oil, Mustard Seeds, Curry Leaves, Salt, Garlic  Split Lengthwise, Ginger Garlic Paste, Kashmiri Red Chilli Powder, Coriander Powder, Methi Powder",12,10,30,40,4,Kerala Recipes,Lunch,High Protein Non Vegetarian
Eggplant Steaks Recipe,"Brinjal, Kabuli Chana, Red Yellowgreen Bell Pepper, Feta Cheese, Parsley Leaves, Salt, Black Pepper Powder  Freshly Crushed, Extra Virgin Olive Oil, Tomato Ketchup, Worcestershire Sauce, Dried Oregano, Paprika Powder, Brown Sugar, Salt",14,10,20,30,2,Continental,Main Course,Vegetarian
Keri Na Gotla Nu Shaak Recipe - Gujarati Style Ripe Mango Curry,"Mango, Gram Flour, Red Chilli Powder, Cumin Powder, Coriander Powder, Jaggery, Salt, Water, Sunflower Oil, Mustard Seeds, White Urad Dal, Turmeric Powder, Asafoetida, Dry Red Chilli, Curry Leaves",15,5,20,25,3,Gujarati Recipesï»¿,Lunch,Vegetarian
Indo Mexican Roasted Vegetable Taco Recipe With Creamy Mayo,"Hard Taco Shells, Herb Butter, Potato, Cumin Powder, Cauliflower, Red Bell Pepper, Yellow Bell Pepper, Green Bell Pepper, Red Chilli Flakes, Sweet Corn, Salt, Eggless Mayonnaise, Achari Mayo, Nutralite Cheesy Garlic Mayo",14,10,35,45,4,Mexican,Appetizer,Vegetarian
Tomato Kurma Recipe - Thakkali Kurma For Biryani & Parotta,"Onion, Tomato, Cinnamon Stick, Cumin Seeds, Star Anise, Sambar Powder, Salt, Ghee, Roasted Gram Dal, Fresh Coconut, Green Chilli, Fennel Seeds, Water",13,10,20,30,3,South Indian Recipes,Lunch,Vegetarian
Bhojpuri Style Bharbhara Recipe,"Gram Flour, Green Peas, Onion, Green Chilli, Red Chilli Powder, Chaat Masala Powder, Cumin Powder, Sunflower Oil Shallow Fry, Salt",9,10,15,25,2,Bihari,Snack,Vegetarian
Maa Ki Dal Recipe - Punjabi Style Black Urad Dal Recipe,"Black Urad Dal, Rajma, Tomato, Ginger, Ghee, Cumin Seeds, Kashmiri Dry Red Chilli, Coriander Powder, Garam Masala Powder",9,10,150,160,4,Punjabi,Dinner,High Protein Vegetarian
Mini Chilli Cheese Aloo Kulcha Recipe,"Whole Wheat Flour, All Purpose Flour, Active Dry Yeast, Curd, Sugar, Salt, Water, Sunflower Oil, Potato, Onion, Green Chilli, Chaat Masala Powder, Amchur, Britannia Cheezza, Mint Leaves, Ghee Cook The Kulchas, Britannia Cheese Spread, Hung Curd, Cucumber, Saffron Strands, Parsley Leaves, Salt",22,45,20,65,4,North Indian Recipes,Side Dish,Vegetarian
Onion Thepla Recipe,"Whole Wheat Flour, Onion, Green Chilli, Ginger, Garlic, Garam Masala Powder, Amchur, Turmeric Powder, Black Pepper Powder, Salt, Sunflower Oil, Ghee Oil For Making The Theplas",12,25,15,40,4,North Indian Recipes,Lunch,Vegetarian
Cauliflower Thoran Recipe (Kerala Style Cauliflower),"Cauliflower, Onion, Coconut Oil, White Urad Dal, Mustard Seeds, Cumin Seeds, Curry Leaves, Fresh Coconut, Green Chilli, Turmeric Powder, Salt",11,10,10,20,4,South Indian Recipes,Lunch,Vegetarian
Atte Ka Halwa Recipe - Whole Wheat Flour Halwa with Khoya,"Whole Wheat Flour, Sooji, Khoya, Cardamom Powder, Badam, Cashew Nuts Garnish, Ghee, Sugar",8,10,30,40,4,North Indian Recipes,Dessert,Vegetarian
Stuffed Half Moon Shaped Kaju Burfi Recipe,"Cashew Nuts, Oats Flour, Saffron Strands, Rose Essence, Water, Sugar, Water, Dessicated Coconut, Paneer, Milk Powder, Cashew Nuts, Oats Flour, Sugar, White Chocolate",14,15,50,65,4,Indian,Dessert,Vegetarian
Nellor Kathirikai - Nellor Brinjal Fry Recipe,"Sesame, Mustard Seeds, Curry Leaves, Small Brinjal, Turmeric Powder, Salt, Turmeric Powder, Salt, Chana Dal, Coriander, Dry Red Chilli, Sesame, Onion, Fresh Coconut, Sesame, Salt, Water",17,15,30,45,4,Andhra,Main Course,Vegetarian
Jeera Miri Kolambi Recipe - Cumin & Black Pepper Prawns,"Prawns, Onion, Tomato, Curry Leaves, Sunflower Oil, Coriander, Ginger, Garlic, Turmeric Powder, Dry Red Chilli, Whole Black Peppercorns, Salt, Malt Vinegar",13,30,20,50,4,Goan Recipes,Appetizer,Non Vegeterian
Savory Waffles With Roasted Peppers In Sun Dried Tomato Pesto Recipe,"Sun Dried Tomato, Basil Leaves, Garlic, Badam, Parmigiano Reggiano Cheese, Extra Virgin Olive Oil, Whole Black Peppercorns, Salt, Extra Virgin Olive Oil, Red Bell Pepper, Green Bell Pepper, Yellow Bell Pepper, Black Olives, Pickled Jalapenos, Sun Dried Tomato Pesto, Whole Egg, Milk, Sunflower Oil, Sugar, Baking Powder, Salt, Whole Wheat Flour, Black Pepper Powder, Dried Oregano",24,10,20,30,2,Continental,World Breakfast,Eggetarian
Chicken Kathi Roll Recipe,"Whole Wheat Flour, Sunflower Oil, Salt, Sunflower Oil Roast The Parathas, Chicken Breasts, Hung Curd, Tandoori Masala, Lemon Juice, Turmeric Powder, Salt, Ginger, Garlic, Onion, Green Bell Pepper, Pickled Onion, Chaat Masala Powder Sprinkle, Whole Eggs",17,15,25,40,4,Indian,Main Course,Non Vegeterian
Guacamole Stuffed Quesadilla With Mint Mayo Recipe,"Whole Wheat Flour, All Purpose Flour, Sunflower Oil, Salt, Avocado, Tomato, Onion, Red Bell Pepper, Yellow Bell Pepper, Garlic, Green Chilli, Coriander, Lemon, Salt, Butter, Del Monte Mint Mayo",16,10,30,40,4,Mexican,Appetizer,Vegetarian
Bharwa Lauki Recipe In No Onion No Garlic Makhani Gravy,"Bottle Gourd, Paneer, Gram Flour, Garam Masala Powder, Green Chilli, Salt, Ginger, Cashew Nuts, Cardamom, Cloves, Dry Red Chilli, Homemade Tomato Puree, Turmeric Powder, Red Chilli Powder, Coriander Powder, Fresh Cream, Garam Masala Powder, Salt, Emami Rice Bran Oil, Kasuri Methi",20,20,40,60,4,North Indian Recipes,Main Course,No Onion No Garlic (Sattvic)
Assamese Narasingh Masor Jhol Recipe (Fish In Curry Leaves Gravy),"Sardine Fish Carps, Curry Leaves, Garlic, Green Chilli, Whole Black Peppercorns, Turmeric Powder, Dry Red Chilli, Mustard Oil, Lukewarm Water",9,5,15,20,4,Assamese,Side Dish,Non Vegeterian
Shrimp Walnut Bruschetta Recipe Flavored With Cheesy Dip,"Shrimps, Baguette, Garlic, Green Olives, Walnuts, Del Monte Cheesy Dip, Dill Leaves, Salad Leaves, Extra Virgin Olive Oil, Butter, Salt, Black Pepper Powder, Red Chilli Flakes",13,20,40,60,4,Italian Recipes,Appetizer,Non Vegeterian
Kiwi Guava Spritzer Recipe,"Guava, Kiwi, Ginger, Lemon Juice, Sugar, Aerated Water, Mint Leaves",7,15,0,15,6,Indian,Appetizer,Vegetarian
Soya Chunks Masala in Coconut Milk Recipe,"Soy Chunks, Tomato, Onion, Green Chilli, Garlic, Cumin Seeds, Curry Leaves, Turmeric Powder, Red Chilli Powder, Coriander Powder, Curry Powder, Coconut Milk, Sunflower Oil, Salt",14,10,30,40,4,South Indian Recipes,Dinner,High Protein Vegetarian
Orange Lemon Tea Cake Recipe,"Whole Wheat Flour, Caster Sugar, Baking Powder, Salt, Orange Zest, Fresh Orange Juice, Lemon Juice, Milk, Extra Virgin Olive Oil, Whole Eggs",10,10,35,45,4,Continental,Dessert,Eggetarian
Watermelon Carrot Radish Juice Recipe,"Watermelon, Carrots, Mooli Mullangi, Salt, Lemon Juice",5,10,10,20,2,Continental,World Breakfast,Vegetarian
Fennel Potato Croquettes With Paneer Recipe,"Paneer, Potato, Onion, Cumin Powder, Fennel Seeds, Green Chilli, Coriander, Salt, All Purpose Flour, Whole Wheat Bread Crumbs, Sunflower Oil, Egg White",12,20,40,60,4,Continental,Snack,Vegetarian
Drumstick Leaves Sabzi With Crushed Peanuts Recipe,"Drumstick Leaves, Fresh Coconut, Onion, Garlic, Cumin Seeds, Mustard Seeds, Red Chilli Powder, Sunflower Oil, Roasted Peanuts, Water, Salt, Salt",12,15,15,30,2,South Indian Recipes,Lunch,Vegetarian
Vegetable Lo Mein Recipe,"Wheat Noodles, Extra Virgin Olive Oil, Garlic, Red Bell Pepper, Green Bell Pepper, Yellow Bell Pepper, Carrot, Broccoli, White Onion, Spring Onion Greens, Soy Sauce, Red Chilli Sauce, Brown Sugar, Sriracha Sauce, Salt, Sunflower Oil",16,10,15,25,4,Chinese,Dinner,Vegetarian
Doddapatre Soppina Chitranna Recipe (Spiced Indian Thyme Rice),"Cooked Rice, Sunflower Oil, Indian Borage, Cumin Seeds, Chana Dal, White Urad Dal, Dessicated Coconut, Byadagi Dried Chilli, Guntur Dried Chilli, Coriander, Mustard Seeds, Chana Dal, White Urad Dal, Asafoetida, Raw Peanuts, Curry Leaves, Salt",17,20,30,50,4,South Indian Recipes,Lunch,Vegetarian
Bhindi Masala Gravy Recipe - Ladies Finger In Tomato Onion Gravy,"Bhindi, Onion, Ginger, Garlic, Green Chilli, Cloves, Cardamom, Cinnamon Stick, Mace, Tomato, Curd, Kasuri Methi, Bay Leaf, Turmeric Powder, Red Chilli Powder, Coriander Powder, Sunflower Oil, Salt, Sunflower Oil, Salt",20,20,30,50,3,North Indian Recipes,Side Dish,Vegetarian
Goan Style French Beans Foogath Recipe,"Green Beans, Onion, Green Chilli, Sunflower Oil, Mustard Seeds, Cumin Seeds, Curry Leaves, Kashmiri Dry Red Chilli, Fresh Coconut, Salt, Sugar",11,10,15,25,4,Goan Recipes,Side Dish,Vegetarian
Medu Vada With Onion (Savoury Donuts) Recipe,"White Urad Dal, Onion, Ginger, Baking Soda, Curry Leaves, Coriander, Salt, Sunflower Oil Deep Fry",8,10,25,35,2,South Indian Recipes,South Indian Breakfast,Vegetarian
Coriander Semiya Recipe - Vermicelli Pulao,"Rice Vermicelli Noodles, Coriander, Green Chilli, Fresh Coconut, Garlic, Red Onion, Carrots, Green Peas, Cloves, Bay Leaf, Cardamom, Star Anise, Garam Masala Powder, Salt, Sunflower Oil",15,10,10,20,3,South Indian Recipes,Dinner,Vegetarian
Mango Chia Seeds Smoothie Topped with Muesli Recipe,"Mango, Milk, Chia Seeds, Muesli, Prunes, Cranberries",6,20,0,20,1,Continental,World Breakfast,Sugar Free Diet
Knol Khol Gravy Recipe - Kohlrabi In A Yogurt Based Gravy,"Knol Khol, Onion, Tomato, Curd, Red Chilli Powder, Garam Masala Powder, Ginger, Garlic, Coriander Powder, Water, Salt, Sunflower Oil, Cumin Seeds, Coriander",14,10,30,40,3,Indian,Side Dish,Vegetarian
Corn Bhel Recipe,"Sweet Corn, Onion, Potato, Sweet Chutney, Green Chutney, Chaat Masala Powder, Green Chilli, Coriander, Salt And Pepper, Sev Garnish",10,30,10,40,2,North Indian Recipes,Snack,Vegetarian
Egg And Spinach Breakfast Pizza Recipe,"All Purpose Flour, Whole Wheat Flour, Active Dry Yeast, Lukewarm Water, Sugar, Salt, Mozzarella Cheese, Spinach, Cherry Tomato, Caramelized Onion, Whole Eggs, Red Chilli Flakes, Dried Oregano",13,10,120,130,3,Continental,World Breakfast,Eggetarian
Dal Dhokli Recipe With Sprouted Moong Dal,"Whole Wheat Flour, Gram Flour, Red Chilli Powder, Turmeric Powder, Coriander, Green Moong Sprouts, Coriander Powder, Turmeric Powder, Red Chilli Powder, Cinnamon Stick, Kokum, Jaggery, Raw Peanuts, Coriander, Lemon Juice, Salt, Cumin Seeds, Mustard Seeds, Green Chilli, Curry Leaves, Asafoetida, Ghee",22,10,45,55,4,Gujarati Recipesï»¿,Lunch,Vegetarian
Ragi Sankati Recipe - Andhra Style Ragi Mudda,"Cooked Rice, Ragi Flour, Water, Salt, Ghee",5,10,25,35,4,Andhra,Lunch,Vegetarian
Instant Baked Aloo Tikki Recipe,"Potato, Spring Onion, Green Bell Pepper, Whole Wheat Flour Maida, Rice Flour, Salt, Red Chilli Powder, Sunflower Oil Brush",8,5,10,15,2,Indian,Snack,Vegetarian
Sukhe Chole Recipe - Dry Masala Chickpeas,"Kabuli Chana, Sunflower Oil, Cumin Seeds, Ginger, Chana Masala Powder, Red Chilli Powder, Cumin Powder, Amchur, Turmeric Powder, Coriander Powder, Salt",11,10,30,40,2,Punjabi,Lunch,High Protein Vegetarian
Quick and Easy Eggless Whole Wheat Chocolate Cupcake Recipe,"Whole Wheat Flour, Cocoa Powder, Baking Soda, Sunflower Oil Canolaolive Oil, Caster Sugar, Vanilla Extract, Curd",7,0,40,40,6,Continental,Dessert,Vegetarian
Corn and Spinach Whole Wheat Calzone Recipe,"Whole Wheat Flour, Spinach, Salt, Sweet Corn, Red Bell Pepper, Green Bell Pepper, Paneer, Cheese, Green Chilli, Coriander, Sunflower Oil",11,10,60,70,4,Italian Recipes,Snack,Vegetarian
Masala Palak Bhurji Recipe,"Whole Eggs, Spinach, Onion, Tomato, Green Bell Pepper, Garlic, Ginger, Green Chilli, Ajwain, Red Chilli Powder, Cumin Powder, Turmeric Powder, Salt And Pepper",13,10,25,35,4,Indian,North Indian Breakfast,Eggetarian
Broccoli & Water Chestnut Soup Recipe,"Singhade, Broccoli, Garlic, Milk, Dried Oregano, Rosemary, Black Pepper Powder, Salt, Bean Sprouts Garnish",9,10,30,40,2,Continental,Appetizer,Vegetarian
Kadhai Tofu Sabji Recipe,"Tofu, Green Bell Pepper, Onion, Garlic, Ginger, Tomato, Cumin Seeds, Kasuri Methi, Sunflower Oil, Turmeric Powder, Sugar, Salt, Coriander, Coriander, Whole Black Peppercorns, Fennel Seeds, Cumin Seeds, Anardana Powder, Dry Red Chilli, Bay Leaf, Black Cardamom, Amchur",22,10,15,25,4,North Indian Recipes,Lunch,High Protein Vegetarian
Vrat Ki Kachori Recipe (Savory Buckwheat Paneer Pastry),"Buckwheat Flour, Green Chilli, Rock Salt, Red Chilli Powder, Potato, Water Knead The Dough, Sunflower Oil Fry, Paneer, Rock Salt, Black Pepper Powder, Green Chilli, Coriander",12,20,20,40,4,North Indian Recipes,Snack,Vegetarian
Jeera Milagu Rasam Recipe  - South Indian Pepper Cumin Rasam,"Tamarind, Whole Black Peppercorns, Cumin Powder, Black Pepper Powder, Turmeric Powder, Salt, Ghee, Mustard Seeds, Cumin Seeds, Curry Leaves",10,20,10,30,4,South Indian Recipes,Lunch,No Onion No Garlic (Sattvic)
Bengali Style Hilsa Fish In Poppy Seeds & Yogurt Curry Recipe,"Hilsa Fish, Mustard Oil, Kalonji, Red Chilli Powder, Turmeric Powder, Curd, Water, Poppy Seeds, Kasundi Mustard Sauce, Green Chilli, Salt",11,20,20,40,3,Bengali Recipes,Side Dish,High Protein Non Vegetarian
Malabar Style Dates Pickle Recipe,"Dates, Ginger, Garlic, Green Chilli, Turmeric Powder, Red Chilli Powder, Vinegar, Mustard Seeds, Asafoetida, Sugar, Sunflower Oil, Curry Leaves, Salt",13,10,10,20,4,Malabar,Side Dish,Vegetarian
Carrot Semolina Phirni Recipe,"Carrots, Milk, Sugar, Sooji, Cardamom Powder, Badam, Ghee, Saffron Strands",8,10,30,40,4,North Indian Recipes,Dessert,Vegetarian
Oil Free Gujarati Undhiyu Recipe - No Onion No Garlic,"Gram Flour, Methi Leaves, Red Chilli Powder, Turmeric Powder, Asafoetida, Sugar, Cooking Soda, Coriander, Green Chilli, Dessicated Coconut, Red Chilli Powder, Turmeric Powder, Coriander Powder, Garam Masala Powder, Salt, Sugar, Avarekalu  Lilva Beans, Tindora, Raw Banana, Green Peas, Cabbage, Purple Cabbage, Brinjal, Coriander",24,20,40,60,3,Gujarati Recipesï»¿,Side Dish,No Onion No Garlic (Sattvic)
Karnataka Style Orange Peels Curry Recipe,"Orange, Tamarind, Jaggery, Rasam Powder, Red Chilli Powder, Rice Flour, Salt, Sunflower Oil, Mustard Seeds, Cumin Seeds, Methi Seeds, White Urad Dal, Dry Red Chilli, Green Chilli, Asafoetida, Turmeric Powder",16,15,15,30,4,Karnataka,Lunch,Vegetarian
Kerala Style Chakka Pal Kozhukattai Recipe-Rice Dumpling In Jackfruit flavored Coconut Milk,"Jackfruit Ripe, Rice Flour, Sunflower Oil, Salt, Lukewarm Water Knead, Fresh Coconut, Cardamom",7,5,45,50,4,Kerala Recipes,One Pot Dish,Vegetarian
Dhaba Style Tawa Pulao Recipe - Masala Brown Rice Tawa Pulao,"Brown Rice, Ghee, Cumin Seeds, Green Chilli, Onion, Tomato, Carrot, Green Peas, Sweet Corn, Salt, Red Chilli Powder, Pav Bhaji Masala, Coriander",13,15,20,35,3,North Indian Recipes,Lunch,Vegetarian
Apple Burfi Recipe,"Apples, Fresh Coconut, Condensed Milk, Milk, Ghee, Raisins, Cashew Nuts, Canned Cherries, Cardamom Powder",9,15,15,30,3,Indian,Dessert,Vegetarian
Kerala Style Sugiyan Recipe (Sweet Moong Dal Bondas),"Green Moong Dal, Jaggery, Cardamom Powder, Fresh Coconut, Gram Flour, Rice Flour, Turmeric Powder, Salt",8,60,30,90,4,Kerala Recipes,Snack,Vegetarian
Makki Ki Baked Mathri Recipe (Baked Cornmeal Flaky Biscuit),"Corn Meal, Sesame Seeds, Kasuri Methi, Sunflower Oil, Whole Black Peppercorns, Salt, Water",7,20,30,50,15,North Indian Recipes,Snack,Vegetarian
Khara Bhath Recipe-South Indian Rava Bhath,"Sooji, Onion, Tomato, Green Bell Pepper, Mixed Vegetables, Ginger, Green Chilli, Vangi Bath Powder, Water, Lemon, Coriander, Fresh Coconut, Salt, Mustard Seeds, White Urad Dal, Chana Dal, Cashew Nuts, Curry Leaves, Dry Red Chilli, Turmeric Powder, Sunflower Oil Cook, Ghee",22,10,30,40,2,Karnataka,South Indian Breakfast,Vegetarian
Hyderabadi Chicken Shikampuri Kebab Recipe,"Hung Curd, Onion, Green Chilli, Coriander, Mint Leaves, Salt, Boneless Chicken, Chana Dal, Red Chilli Powder, Turmeric Powder, Ginger, Garlic, Coriander, Mint Leaves, Cardamom, Cinnamon Stick, Cloves, Whole Black Peppercorns, Ajwain, Whole Egg, Salt, Sunflower Oil",22,15,40,55,4,Hyderabadi,Appetizer,Non Vegeterian
Kadai Broccoli Masala Recipe - Broccoli Cooked With Indian Spices,"Broccoli, Red Bell Pepper, Onion, Tomato, Ginger, Garlic, Red Chilli Powder, Garam Masala Powder, Black Cardamom, Water, Salt, Sunflower Oil, Kasuri Methi, Coriander, Cumin Seeds, Fennel Seeds",16,10,20,30,2,North Indian Recipes,Main Course,Vegetarian
Bhindi Raita Recipe (Okra Salad),"Bhindi, Hung Curd, Sunflower Oil, Mustard Seeds, Cumin Seeds, Red Chilli Powder, Groundnut Powder, Chaat Masala Powder, Asafoetida, Sugar, Salt",11,15,15,30,4,Indian,Side Dish,Vegetarian
Chana Methi Dal Recipe - Fenugreek & Split Bengal Gram Curry,"Chana Dal, Methi Leaves, Asafoetida, Onion, Tomato, Coriander Powder, Turmeric Powder, Red Chilli Powder, Salt, Ghee, Cumin Seeds, Dry Red Chilli",12,15,30,45,4,North Indian Recipes,Lunch,High Protein Vegetarian
Sheer Khurma Recipe - Seviyan or Vermicelli Kheer Pudding,"Milk, Semiya, Sugar, Dates, Raisins, Pistachios, Cardamom Powder, Saffron Strands",8,10,40,50,4,Hyderabadi,Dessert,Vegetarian
Baked Fish In Coconut Milk Recipe,"Fish Fillet, Sunflower Oil, Onion, Lemon Juice, Garlic, Ginger, Green Chilli, Tomato, Sunflower Oil, Coriander Powder, Cumin Powder, Red Chilli Powder, Turmeric Powder, Fennel Seeds, Salt, Coconut Milk, Coriander",17,60,30,90,4,South Indian Recipes,Dinner,High Protein Vegetarian
Andhra Style Chicken Fry Recipe,"Chicken Breasts, Turmeric Powder, Red Chilli Powder, Ginger Garlic Paste, Hung Curd, Salt, Onion, Green Chilli, Fennel Seeds, Tomato, Ginger Garlic Paste, Curry Leaves, Black Pepper Powder, Garam Masala Powder, Coriander Powder, Kashmiri Red Chilli Powder, Sunflower Oil Ghee As Required",17,35,15,50,2,Andhra,Appetizer,High Protein Non Vegetarian
Kashmiri Monj Haakh Recipe - Knol Khol Flavored With Asafoetida,"Knol Khol, Stalks Knol Khol Leaves, Asafoetida, Dry Red Chilli, Baking Soda, Kashmiri Masala Powder, Mustard Oil, Salt",8,20,30,50,6,Kashmiri,Lunch,Vegetarian
Tamatar Chaat Banarasi Style Recipe,"Potato, Red Chilli Powder, Tomato, Black Salt, Cumin Powder, Black Pepper Powder, Tomato Ketchup, Sugar, Garam Masala Powder, Onion, Green Chilli, Coriander, Puffed Rice, Sunflower Oil",14,10,25,35,2,Uttar Pradesh,Snack,Vegetarian
Mexican Salsa Chicken With Italian Cream Cheese Recipe,"Boneless Chicken, Black Pepper Powder, Rock Salt, Penne Pasta, Salt, Mozzarella Cheese, Tomato, Onion, Coriander, Garlic, Pickled Jalapenos, Sugar, Lemon Juice, Britannia Cream Cheese, Butter, Garlic, Milk",17,10,30,40,3,Italian Recipes,Dinner,High Protein Non Vegetarian
Baked Pasta Recipe With Spinach And Artichoke,"Penne Pasta, Butter, Black Olives, Spinach, Artichokes  Roughly, Extra Virgin Olive Oil, Onion, Garlic, All Purpose Flour, Milk, Feta Cheese Any Other Soft Cheese, Dried Oregano, Salt And Pepper",13,15,60,75,4,Italian Recipes,Dinner,Vegetarian
Chicken Chilli Cheese Quesadillas Recipe,"Boneless Chicken, Chipotle Sauce, Cheddar Cheese, Onion, Green Bell Pepper, Black Pepper Powder, Salt, Sweet Corn, Roasted Tomato Pasta Sauce, Lemon Juice, Butter, Tortillas",12,10,60,70,4,Mexican,Lunch,Non Vegeterian
Eggless Oats Cranberry Almond Cookies Recipe,"Icing Sugar, Butter, Vanilla Extract Almond Essence, Whole Wheat Flour, Oats Flour, Salt, Cranberries, Badam",8,15,15,30,4,Continental,Dessert,Vegetarian
Italian Style Broccoli And Cauliflower Soup Recipe,"Carrot, Broccoli, Cauliflower, Onion, Tomato, Garlic, Vegetable Stock, Black Pepper Powder, Red Chilli Flakes, Italian Seasoning, Paprika Powder, Salt, Extra Virgin Olive Oil, Cheese, Coriander",15,15,15,30,4,Italian Recipes,Dinner,Vegetarian
Restaurant Style Chettinad Style Fish Curry Recipe,"Fish Fillet  Surmaipomphret Variety, Turmeric Powder, Sunflower Oil, Cumin Seeds, Whole Black Peppercorns, Cloves, Cinnamon Stick, Cardamom, Dry Red Chilli, Curry Leaves, Fresh Coconut, Garlic, Ginger, Onion, Pearl Onion, Tomato, Tamarind Water, Salt, Water, Coriander",20,20,35,55,4,Chettinad,Main Course,High Protein Non Vegetarian
Arugula & Fig Salad Recipe,"Arugula Leaves, Fresh Figs, Green Beans, Red Wine Vinaigrette, Sunflower Seeds, Lemon Juice, Extra Virgin Olive Oil, Honey, Tabasco Original, Salt, Black Pepper Powder",11,15,10,25,4,Continental,Appetizer,Vegetarian
French Toast BLT Bagel Sandwich Recipe,"Bagel, Whole Egg, Milk, Salt, Bacon Strips, Tomato, Arugula Leaves, Cheese, Extra Virgin Olive Oil, Dried Oregano, Salt And Pepper",11,10,30,40,4,Continental,World Breakfast,Non Vegeterian
Parmesan Cheese Biscuits Recipe,"All Purpose Flour, Parmesan Cheese, Butter, Red Chilli Flakes",4,10,60,70,4,Continental,Snack,Vegetarian
Sooji Manpasand Burfi Recipe - Semolina Coconut Fudge,"Sooji, Fresh Coconut, Milk, Sugar, Ghee, Cardamom Powder, Saffron Strands, Slivered Almonds",8,10,35,45,10,Indian,Dessert,Vegetarian
Eggless Beetroot Brownie Recipe Made With Amaranth Flour,"Beetroot Puree, Chocolate Chips, Brown Sugar, Cocoa Powder, Butter, Vanilla Extract, Ripe Bananas, Rajgira Flour, Baking Powder, Walnuts, Salt",11,20,40,60,6,Continental,Dessert,Vegetarian
Coconut Thumbprint Cookies With Pineapple And Apricot Preserve Recipe,"Pineapple, Sugar, Water, Lemon Juice, Apricots, Sugar, Water, Lemon Juice, All Purpose Flour, Butter, Caster Sugar, Salt, Baking Powder, Vanilla Extract, Fresh Coconut",15,45,120,165,4,Continental,Snack,Vegetarian
Bharwa Karela With Sweet Potato Filling Recipe,"Karela, Sweet Potato, Tomato, Ginger, Green Chilli, Turmeric Powder, Red Chilli Powder, Garam Masala Powder, Chaat Masala Powder, Salt, Sunflower Oil Cook",11,10,45,55,4,Indian,Appetizer,Vegetarian
Kerala Cherupayar Curry Recipe (Green Moong and Yellow Moong Dal Recipe),"Green Moong Dal, Yellow Moong Dal, Pearl Onion, Mustard Seeds, Curry Leaves, Dry Red Chilli, Turmeric Powder, Salt, Coconut Oil, Fresh Coconut, Green Chilli, Cumin Seeds",12,60,30,90,4,Kerala Recipes,Lunch,High Protein Vegetarian
Rava Kakdi Thalipeeth Recipe (Maharashtrian Style Semolina-Cucumber Flatbread),"Sooji, Cucumbers, Green Chilli, Curd, Coriander, Ghee  Ghee As Required For Cooking The Thalipeeth, Salt",7,10,20,30,4,Maharashtrian Recipes,Indian Breakfast,Vegetarian
Kachi Tikya Recipe  - Chicken In Tomato Gravy With Potatoes,"Chicken, Onion, Green Chilli, Coriander, Whole Egg, Salt, Red Chilli Powder, Cumin Powder, Tomato, Cumin Seeds, Sunflower Oil, Garam Masala Powder, Mace Powder, Ginger Garlic Paste, Potato",15,16,30,46,8,North Indian Recipes,Lunch,High Protein Non Vegetarian
Nei Appam / Unniyappam Recipe - Coconut Banana Fritters,"Rice, Jaggery, Ripe Bananas, Fresh Coconut, Cardamom Powder, Enos Fruit Salt, Ghee, Salt",8,130,90,220,4,Kerala Recipes,Snack,Vegetarian
Maharashtrian Batatyacha Kees Recipe (Pan Fried Spiced Potatoes with Peanuts),"Potato, Roasted Peanuts, Green Chilli, Cumin Seeds, Ghee, Salt, Lemon Juice, Coriander, Fresh Coconut",9,10,25,35,4,Maharashtrian Recipes,Snack,Vegetarian
Kathiri Urulai Masala Kuzhambu Recipe - Brinjal And Potato Masala Gravy,"Brinjal, Potato, Tamarind, Onion, Tomato, Red Chilli Powder, Turmeric Powder, Fresh Coconut, Fennel Seeds, Khuskhus, Cashew Nuts, Dry Red Chilli, Mustard Seeds, Cinnamon Stick, Curry Leaves, Sunflower Oil, Salt, Water",18,10,30,40,4,South Indian Recipes,Main Course,Vegetarian
Kashmiri Style Yakhni Pulao With Chicken Recipe,"Basmati Rice, Chicken, Onion, Black Cardamom, Whole Black Peppercorns, Cloves, Cinnamon Stick, Bay Leaf, Nutmeg Powder, Mace, Garlic, Ginger, Coriander, Water, Salt, Onion, Ginger Garlic Paste, Tomato, Cumin Seeds, Curd, Coriander Powder, Red Chilli Powder, Garam Masala Powder, Cardamom, Fennel Seeds",25,60,10,70,5,Kashmiri,Lunch,Non Vegeterian
Mexican Black Bean Corn Soup Recipe,"Onion, Garlic, Black Beans, Homemade Tomato Puree, Sweet Corn, Vegetable Stock Water, Carrot, Cumin Powder, Green Zucchini, Red Chilli Powder, Lemon Juice, Pickled Jalapenos  Sliced, Coriander, Black Pepper Powder, Salt, Extra Virgin Olive Oil, Avocado, Sour Cream, Tortillas",19,10,25,35,4,Mexican,Appetizer,Vegetarian
Malvani Fish Curry Recipe - Delicious And Spicy Fish Curry,"Ginger, Garlic, Onion, Tomato, Coconut Milk, Tamarind Water, Curry Leaves, Mustard Seeds, Mustard Oil, Salt, King Fish, Red Chilli Powder, Turmeric Powder, Cumin Powder, Coriander Powder, Lemon Juice, Salt, Coriander, Cumin Seeds, Fennel Seeds, Cinnamon Stick, Cloves, Bay Leaf, Nutmeg, Whole Black Peppercorns, Dry Red Chilli, Star Anise",27,10,30,40,2,Malvani,Lunch,High Protein Non Vegetarian
Dibba Rotti/Minapa Rotti Recipe (Pan Idli Recipe),"Rice Rava, White Urad Dal, Cumin Seeds, Salt, Sunflower Oil",5,250,30,280,4,Andhra,South Indian Breakfast,Vegetarian
Kasuri Malai Murgh Recipe,"Chicken, Onion, Garlic, Ginger  Grated, Green Chilli, Curd, Fresh Cream, Cashew Nuts, Melon Seeds, Kasuri Methi, Whole Black Peppercorns, Coriander Powder, Red Chilli Powder, Turmeric Powder, Salt, Sunflower Oil, Ajwain, Cardamom, Black Cardamom, Cloves, Cinnamon Stick, Bay Leaf, Mace",23,10,60,70,6,North Indian Recipes,Dinner,High Protein Non Vegetarian
Crispy Bakwan Sayur Recipe (No Onion No Garlic Vegetable Fritter),"Cabbage, Carrot, All Purpose Flour, Rice Flour, Turmeric Powder, Red Chilli Powder, Salt, Sugar, Black Pepper Powder, Water, Sunflower Oil",11,15,10,25,2,Indonesian,Snack,Vegetarian
Spicy Sichuan Cauliflower Recipe,"Cauliflower, Onion, Spring Onion, Corn Flour, Soy Sauce, Red Chilli Sauce, Vinegar, Ginger, Garlic, Green Chilli  Slit Lengthwise, Sesame Seeds, Sunflower Oil",12,20,15,35,2,Indo Chinese,Appetizer,Vegetarian
How To Make Homemade Idiyappam Recipe - Rice Sevai Recipe,"Rice, Water, Salt",3,120,30,150,4,South Indian Recipes,South Indian Breakfast,Vegetarian
Baklava Recipe - Turkish Traditional Sweet,"Lb Phyllo Dough, Butter, Walnuts, Pistachios, Sugar, Cinnamon Powder, Cloves, Honey, Lemon Juice, Water, Vanilla Extract If Available Orange Blossom",11,20,120,140,8,Mediterranean,Dessert,Vegetarian
Vegetable Tagine Recipe,"Carrots, Potato, Parsnip, Leek, Red Onion, Extra Virgin Olive Oil, Salt, Prunes, Mint Leaves, Onion, Garlic, Ginger, Honey, Cumin Powder, Paprika Powder, Kashmiri Red Chilli Powder, Turmeric Powder, Lemon Juice, Extra Virgin Olive Oil, Coriander",20,10,60,70,8,African,Dinner,Vegetarian
Spicy Kiwi Salsa Recipe with Feta Cheese,"Kiwi, Onion, Parsley Leaves, Tabasco Original, Honey, Lemon Juice, Salt, Feta Cheese",8,10,15,25,2,Mexican,Side Dish,Vegetarian
Mexican Brown Rice and Quinoa Casserole Recipe,"Quinoa, Brown Rice, Extra Virgin Olive Oil, Garlic, Green Chilli  Finely, Vegetable Stock, Rajma, Green Bell Pepper, Orange Bell Pepper, Tomato, Avocado, Red Chilli Powder, Lemon, Coriander",14,20,40,60,4,Mexican,Dinner,Diabetic Friendly
Eggless Christmas Tree Chocolate Cookies Recipe,"All Purpose Flour, Cocoa Powder, Butter, Caster Sugar, Baking Powder, Sunflower Oil, Vanilla Extract, Water, Butter, Caster Sugar, Vanilla Extract, Water, Decorative Sugar",13,15,30,45,10,Continental,Dessert,Vegetarian
Swedish Saffron Buns Recipe,"All Purpose Flour, Active Dry Yeast, Milk, Butter, Whole Eggs, Saffron Strands, Raisins, Salt, Caster Sugar, Egg White",10,30,20,50,10,European,Snack,Vegetarian
Saragva Nu Shaak Recipe-Drumstick Masala Sabzi,"Drumstick   Into   Size Pieces, Kalonji, Ginger, Curry Leaves, Bay Leaves, Cinnamon Stick, Tomato, Turmeric Powder, Red Chilli Powder, Coriander Powder, Cumin Powder, Jaggery, Salt, Coriander, Sunflower Oil",15,10,20,30,4,Gujarati Recipesï»¿,Lunch,Vegetarian
Bihari Aloo Bhujiya Recipe,"Potato, Turmeric Powder, Cumin Seeds, Green Chilli, Mustard Oil, Salt",6,10,20,30,2,Bihari,Lunch,Vegetarian
Stuffed Mushroom Recipe With Italian Sausage,"Button Mushrooms, Pork Sausage, Extra Virgin Olive Oil, Black Pepper Powder, Salt, Britannia Cream Cheese, Dried Oregano, Paprika Powder, Parsley Leaves, Cheese",10,15,20,35,2,Italian Recipes,Appetizer,Non Vegeterian
Kohlrabi Recipe (Knol Khol Poriyal),"Kohl Rabi, Onion, Tomato, Green Peas, Dry Red Chilli, Cumin Seeds, Mustard Seeds, Black Urad Dal, Curry Leaves, Turmeric Powder, Red Chilli Powder, Coriander Powder, Dessicated Coconut, Salt",14,10,15,25,3,Indian,Lunch,Vegetarian
Heart Shaped Tea Sandwiches Recipe,"Whole Wheat Brown Bread, Beetroots, Green Bell Pepper, Cabbage, Spring Onion Greens, Classic Mayonnaise, Black Pepper Powder, Red Chilli Flakes, Butter, Nutella Spread, Jam",11,10,20,30,6,Indian,World Breakfast,Vegetarian
"Watermelon, Chena, Cucumber With Soy Dressing Recipe","Watermelon, Cucumber, Chenna, Mint Leaves, Pistachios, Soy Sauce, Honey, Salt And Pepper",8,25,0,25,4,Continental,Appetizer,Vegetarian
Mixed Millet Khichdi Recipe,"Mixed Millets, Badi, Onion, Tomato, Cumin Seeds, Methi Seeds, Kasuri Methi, Asafoetida, Red Chilli Powder, Ghee, Salt",11,20,30,50,4,North Indian Recipes,Lunch,Vegetarian
Golpapdi Recipe | Gur Papdi | Sukhdi recipe | Gujarati Gol Papdi,"Whole Wheat Flour, Ghee, Jaggery, Cardamom Powder, Dry Ginger Powder, Dessicated Coconut, Badam",7,10,20,30,4,Gujarati Recipesï»¿,Dessert,Vegetarian
Chironji Ki Dal Recipe,"Chironji, Bhindi, Cumin Seeds, Cardamom, Whole Black Peppercorns, Ginger, Green Chilli, Kashmiri Red Chilli Powder, Coriander Powder, Curd, Salt, Sunflower Oil",12,30,60,90,4,North Indian Recipes,Lunch,Vegetarian
Apple Upside Down Cake Recipe,"Apples, Butter, Sugar, Cinnamon Powder, Lemon Juice, Butter, Sugar, Whole Eggs, Vanilla Extract, Britannia Cream Cheese, Vivatta Maida, Baking Powder, Slivered Almonds, Raisins",14,15,40,55,4,Continental,Dessert,Eggetarian
Green Chutney Rava Dhokla Recipe - Sooji Dhokla,"Green Chutney, Sooji, Curd, Sunflower Oil, Salt, Enos Fruit Salt, Coriander, Sunflower Oil, Mustard Seeds, Cumin Seeds, Asafoetida, Sesame Seeds, Curry Leaves",13,10,15,25,4,Gujarati Recipesï»¿,North Indian Breakfast,Vegetarian
Mamidikaya Pesara Pappu Pachadi Recipe - Raw Mango & Dal Chutney,"Mango, Yellow Moong Dal, Dry Red Chilli, Cumin Seeds, Jaggery, Salt, Mustard Seeds, Curry Leaves, Dry Red Chilli, Asafoetida, Sunflower Oil",11,5,20,25,4,Andhra,Side Dish,Vegetarian
Strawberry Brownie Bars Recipe,"Dark Chocolate, Butter, Cocoa Powder, Caster Sugar, Whole Wheat Flour, Baking Powder, Vanilla Extract, Whole Eggs, Strawberries",9,20,45,65,4,Continental,Dessert,Eggetarian
Goan Style Sana Recipe (Soft Steamed Rice Cakes),"Red Matta Rice, Basmati Rice, White Urad Dal, Coconut Milk Toddy, Sugar, Active Dry Yeast, Salt",7,480,15,495,4,Goan Recipes,South Indian Breakfast,Diabetic Friendly
Zucchini Oatmeal Omelette Recipe,"Whole Eggs, Green Zucchini, Onion, Coriander, Green Chilli, Instant Oats, Black Pepper Powder, Salt, Sunflower Oil",9,10,15,25,3,French,World Breakfast,Eggetarian
Pretzel Salad Recipe,"Pretzels, English Cucumber, Cherry Tomato, Yellow Bell Pepper, Iceberg Lettuce, Pecans, Mustard Sauce Homemade Kasundi, Honey, Lemon Juice, Extra Virgin Olive Oil, Black Pepper Powder, Salt",12,10,10,20,2,European,Dinner,Vegetarian
Rajgira Ki Kheer Recipe,"Amaranth Seeds, Milk, Sugar, Badam, Cashew Nuts, Raisins, Saffron Strands, Milk, Cardamom Powder, Rose Petals Garnish, Pistachios",11,20,30,50,4,North Indian Recipes,Dessert,No Onion No Garlic (Sattvic)
Attukal Soup Recipe | Paya Soup,"Mutton Legs   Into   Pieces, Garlic, Onion, Cumin Seeds, Black Pepper Powder, Curry Leaves, Salt, Turmeric Powder, Gingelly Oil",9,30,30,60,4,Mughlai,Appetizer,Non Vegeterian
Spicy Mixed Vegetable Lollipop Recipe,"Potato, Carrot, Cabbage, Onion, Red Chilli Powder, Turmeric Powder, Coriander Powder, Garam Masala Powder, Salt, Sunflower Oil",10,20,25,45,4,Continental,Snack,Vegetarian
Khatti Arbi Ki Sabzi Recipe - Colocasia In Yoghurt Curry,"Colocasia Root, Curd, Mustard Seeds, Turmeric Powder, Dry Red Chilli, Curry Leaves, Salt, Sunflower Oil, Black Pepper Powder, Cumin Seeds, Methi Seeds, Fresh Coconut",12,10,30,40,4,North Indian Recipes,Side Dish,Vegetarian
Shandong  Style Sweet Potato In Spicy  Caramel Sauce Recipe,"Sweet Potato, Sugar, Sesame Seeds, Red Chilli Sauce, Corn Flour, Salt, Sunflower Oil",7,10,20,30,4,Shandong,No Onion No Garlic (Sattvic),Vegetarian
Sarson Saag Pulao Recipe-Spinach Mustard Greens Pulao,"Basmati Rice, Onion, Green Chilli, Ginger, Garlic, Bay Leaf, Cloves, Cinnamon Stick, Ajwain, Cardamom, Garam Masala Powder, Mustard Greens, Spinach Leaves, Methi Leaves, Bathua Leaves, Coriander, Mint Leaves, Lemon Juice, Salt, Water, Ghee",21,20,30,50,8,Indian,Lunch,Vegetarian
Carrot Peanut Chutney Recipe,"Carrot, Roasted Peanuts, Mint Leaves, Fresh Coconut, Onion, Garlic, Green Chilli, Salt, Gingelly Oil, Mustard Seeds, Curry Leaves",11,15,15,30,5,South Indian Recipes,Side Dish,Vegetarian
Milagu Rasam Recipe - Village Style Pepper Rasam,"Tamarind Water, Tomato, Salt, Curry Leaves, Garlic, Whole Black Peppercorns, Cumin Seeds, Dry Red Chilli, Arhar Dal, Ghee, Mustard Seeds, Asafoetida",12,10,55,65,4,South Indian Recipes,Lunch,Vegetarian
Korean Style Kim chi Udon Stir Fry with Scallions Recipe,"Kimchi, Udon Noodles, Onion, Spring Onion Greens  White And Palegreen Parts Only, Sesame Seeds, Gochujang, Soy Sauce, Honey, Vinegar, Garlic, Red Chilli Flakes",11,20,30,50,4,Korean,Lunch,Vegetarian
Jhinga Gawar Recipe -Shrimps & Cluster Beans Sabzi,"Gawar Phali, Shrimps, Onion, Tomato, Green Chilli, Sunflower Oil, Cumin Powder, Ginger Garlic Paste, Cumin Seeds, Red Chilli Powder, Lemon",11,20,30,50,5,Indian,Side Dish,Non Vegeterian
Mirchi Bajji Recipe - Mirapakaya Bajji/Green Chilli Fritters,"Green Chilli, Gram Flour, Baking Soda, Salt, Sunflower Oil, Ajwain, Sesame Seeds, Salt, Onion, Red Chilli Powder, Lemon Juice",11,5,30,35,4,North Indian Recipes,Snack,Vegetarian
Mushroom 65 Recipe (Indian Style Spicy Mushrooms with Chillies),"Button Mushrooms, Corn Flour, All Purpose Flour, Black Pepper Powder, Tandoori Masala, Ginger, Garlic, Curry Leaves, Green Chilli, Coriander, Salt, Sunflower Oil",12,10,30,40,4,Chinese,Appetizer,Vegetarian
Whole Wheat Zucchini Cake Recipe,"Whole Wheat Flour, Baking Powder, Salt, Baking Soda, Cinnamon Powder, Sugar, Whole Eggs, Sunflower Oil, Curd, Green Zucchini, Vanilla Extract, Walnuts",12,20,35,55,8,Continental,Snack,Vegetarian
Spicy Thai Pasta Recipe With Roasted Vegetables,"Spirali Pasta, Carrots, Green Bell Pepper, Green Beans, Thai Green Curry Paste, Fresh Cream, Lemon Juice, Brown Sugar, Red Chilli Flakes, Salt, Sunflower Oil, Garlic, Ginger",13,10,20,30,3,Fusion,Appetizer,Vegetarian
Garfield's Lasagna Recipe With Minced Meat And Italian Spices,"Lasagna Sheets, Chicken, Whole Eggs, Onion, Tomato, Homemade Pizza And Pasta Sauce, Garlic, Dried Oregano, Mixed Herbs, Black Pepper Powder, Basil Leaves, Extra Virgin Olive Oil, Parmesan Cheese, Mozzarella Cheese, Brinjal, Button Mushrooms, Salt",17,10,120,130,3,Italian Recipes,Dinner,Non Vegeterian
Chilli Paneer Quesadilla Recipe,"Tortillas, Cheese, Butter, Paneer, Green Bell Pepper, Spring Onion, Garlic, Ginger, Green Chilli, Corn Flour, Soy Sauce, Tomato Ketchup, Sweet And Spicy Red Chilli Sauce, Sunflower Oil, Salt",15,20,20,40,4,Fusion,Appetizer,Vegetarian
Breakfast Enchiladas With Mushroom Sauce Recipe,"Tortillas, Extra Virgin Olive Oil, Whole Eggs, Mixed Vegetables, Red Yellowgreen Bell Pepper, Onion, Garlic, Cumin Powder, Dried Oregano, Red Chilli Flakes, Salt, Cheddar Cheese, Fresh Oregano, Butter Olive Oil, Onion, Garlic, All Purpose Flour, Button Mushrooms, Vegetable Stock, Black Pepper Powder, Salt",21,10,45,55,2,Mexican,World Breakfast,Vegetarian
Caramel Apple Trifle Recipe,"Apples, Milk, Custard Powder, Sugar, Sponge Cake Slice, Butter",6,10,15,25,4,British,Dessert,Vegetarian
Saoji Methi Pulao Recipe - Maharashtrian Style Fenugreek Leaves Pulao,"Rice, Ginger, Garlic, Onion, Tomato, Green Peas, Methi Leaves, Red Chilli Powder, Cumin Seeds, Saoji Masala, Sunflower Oil, Water, Salt, Whole Black Peppercorns, Bay Leaves, Cinnamon Stick, Black Cardamom, Cardamom, Star Anise, Cumin Seeds, Fennel Seeds, Poppy Seeds, Dessicated Coconut, Red Chilli Powder",24,15,30,45,4,Indian,Lunch,Vegetarian
Chicken Sweet Potato & Dill Curry Recipe,"Chicken, Sweet Potato, Bay Leaf, Salt, Sunflower Oil, Coriander, Cumin Seeds, Cinnamon Stick, Onion, Ginger, Garlic, Dill Leaves",12,10,30,40,4,North Indian Recipes,Lunch,Non Vegeterian
Parsi Style Sekta Ni Sing Recipe-Sweet & Spicy Drumsticks Cooked In Coconut Water/Toddy Recipe),"Drumstick, Tender Coconut Water Toddy, Green Chilli, Coriander, Ginger, Cloves, Fresh Coconut, Turmeric Powder, Salt, Ghee",10,20,30,50,4,Parsi Recipes,Lunch,Vegetarian
Karwar Style Varan Kadhi Recipe - Toor Dal in Coconut Milk Curry,"Arhar Dal, Turmeric Powder, Asafoetida, Salt, Fresh Coconut, Green Chilli, Jaggery, Kokum, Salt",9,5,20,25,4,Karnataka,Side Dish,Vegetarian
Maharashtrian Style Kothimbir Oats Vadi Recipe,"Gram Flour, Oats Flour, Coriander, Salt, Red Chilli Powder, Water, Mustard Seeds, Sesame Seeds, Curry Leaves, Asafoetida",10,10,25,35,4,Maharashtrian Recipes,Appetizer,High Protein Vegetarian
Dairy Free Chocolate Pudding Recipe,"Sugar, Cocoa Powder, Corn Flour, Salt, Almond Milk, Vanilla Extract",6,15,20,35,4,Continental,Dessert,Vegan
Carrot and Ginger Spiced Dosa Recipe,"Idli Dosa Batter, Carrots, Ginger, Sunflower Oil, Salt",5,5,10,15,4,South Indian Recipes,South Indian Breakfast,Vegetarian
Mughlai Keema Paratha Recipe,"Whole Eggs, All Purpose Flour, Whole Wheat Flour, Rice Flour Make It Crisp, Ghee Oil, Salt, Water, Mutton, Onion, Garlic, Ginger, Green Chilli, Mint Leaves, Coriander, Curd, Sunflower Oil, Coriander Powder, Turmeric Powder, Cardamom, Cloves, Whole Black Peppercorns, Dry Red Chilli, Cinnamon Stick, Black Cardamom, Mace Powder, Ajwain",26,20,15,35,4,Mughlai,Main Course,Non Vegeterian
Strawberry Banana Sorbet Recipe,"Ripe Bananas, Strawberries, Fresh Orange Juice, Lemon Juice, Sugar",5,20,600,620,4,Continental,Dessert,Vegan
Grilled Chicken With Vegetables Recipe,"Extra Virgin Olive Oil, Chicken Breasts, Salt, Whole Black Peppercorns, Dried Basil Leaves, Ginger Garlic Paste, Red Chilli Flakes, Extra Virgin Olive Oil, Red Bell Pepper, Green Bell Pepper, Broccoli, Cherry Tomato, Onion, Garlic, Baby Corn, Mixed Herbs, Whole Black Peppercorns, Salt",18,10,15,25,3,Indian,Dinner,High Protein Non Vegetarian
Fruit Sandwich Recipe,"Whole Wheat Brown Bread, Ripe Bananas, Pineapple, Apple Chickoo, Jam",5,10,15,25,2,Continental,Snack,Vegetarian
Leek Mushroom & Lemon Risotto Recipe,"Butter, Extra Virgin Olive Oil, Garlic, Leek, Button Mushrooms, White Wine, Vegetable Stock, Lemon Zest, Lemon Juice, Risotto Rice, Cheddar Cheese, Salt And Pepper",12,20,40,60,2,Italian Recipes,Dinner,Vegetarian
Ukadpendi Recipe - Maharashtrian Style Spiced Rice Flour Porridge,"Water, Buttermilk, Rice Flour, Sunflower Oil, Green Chilli, Cumin Seeds, Mustard Seeds, Asafoetida, Curry Leaves, Sugar, Salt, Roasted Peanuts, Peanut Oil Garnish",13,10,20,30,4,Maharashtrian Recipes,North Indian Breakfast,Vegetarian
Andhra Style Uppu Pindi Recipe (Rice Rava and Moong Dal Pudding Recipe),"Rice Rava, Yellow Moong Dal, Sweet Corn, Onion, Mustard Seeds, White Urad Dal, Dry Red Chilli, Curry Leaves, Ginger, Asafoetida, Salt, Sunflower Oil",12,10,30,40,4,Andhra,South Indian Breakfast,Vegetarian
Chana Dal Khichdi Recipe,"Rice, Chana Dal, Asafoetida, Cumin Seeds, Green Chilli, Ginger, Turmeric Powder, Salt",8,10,30,40,4,North Indian Recipes,Dinner,High Protein Vegetarian
Foxtail Millet Uppu Kozhukattai Recipe,"Foxtail Millet, Water, Dry Red Chilli, Gingelly Oil, Mustard Seeds, White Urad Dal, Curry Leaves, Coriander, Onion, Green Chilli, Salt",11,10,20,30,2,South Indian Recipes,Snack,Vegetarian
Ambur Star Chicken Biryani Recipe,"Seeraga, Ghee, Bay Leaf, Star Anise, Cinnamon Stick, Cardamom, Clove Cloves, Chicken, Sunflower Oil, Ginger, Garlic, Onion, Tomato, Red Chilli Powder, Salt, Coriander Powder, Curd, Mint Leaves",18,30,25,55,2,Tamil Nadu,Main Course,Non Vegeterian
Punjabi Style Boondi Kadhi Recipe,"Curd, Gram Flour, Green Chilli Paste, Ginger Garlic Paste, Red Chilli Powder, Turmeric Powder, Salt, Ghee, Cloves, Whole Black Peppercorns, Cumin Seeds, Methi Seeds, Asafoetida, Boondi, Cloves, Whole Black Peppercorns, Cumin Seeds, Methi Seeds, Asafoetida, Boondi",20,10,30,40,5,Punjabi,Side Dish,Vegetarian
Boti Masala Chaat Recipe - Fryums Chaat  Recipe,"Botis, Onion, Carrot, Lemon Juice, Green Chutney, Red Chilli Powder Sprinkle, Sweet Chutney, Salt Sprinkle, Puffed Rice Garnish, Sev Garnish",10,15,0,15,2,South Indian Recipes,Appetizer,Vegetarian
Matar Ki Tehri Recipe - Fragrant rice cooked with spices and fresh peas,"Basmati Rice, Cloves, Cinnamon Stick, Whole Black Peppercorns, Black Cardamom, Dry Red Chilli, Ghee, Onion, Tomato, Ginger, Green Peas, Coriander, Bay Leaf, Salt",14,20,30,50,4,Awadhi,One Pot Dish,Vegetarian
Mushroom Ghee Roast Recipe,"Button Mushrooms, Curd, Turmeric Powder, Lemon Juice, Dry Red Chilli, Whole Black Peppercorns, Cloves, Methi Seeds, Cumin Seeds, Coriander, Garlic, Tamarind Paste, Ghee, Curry Leaves, Jaggery, Salt",16,10,25,35,5,Fusion,Appetizer,Vegetarian
Mullangi Mor Pachadi Recipe (Radish in spicy tempered Yogurt Gravy Recipe),"Mooli Mullangi, Hung Curd, Salt, Sunflower Oil, Green Chilli, Mustard Seeds, White Urad Dal, Curry Leaves, Asafoetida",9,5,10,15,4,Tamil Nadu,Lunch,Vegetarian
Mangalorean Style Bafat Pito Recipe-Bafat/Bafad Spice Mix Powder,"Byadagi Dried Chilli, Dry Red Chilli, Coriander, Whole Black Peppercorns, Cumin Seeds, Turmeric Powder",6,10,0,10,15,Mangalorean,Lunch,Vegetarian
Pineapple Rasam Recipe,"Arhar Dal, Turmeric Powder, Tomato, Pineapple, Green Chilli, Cumin Powder, Coriander Powder, Red Chilli Powder, Lemon Juice, Salt, Coriander, Ghee, Mustard Seeds, Cumin Seeds, Garlic, Asafoetida, Curry Leaves",17,15,30,45,4,Tamil Nadu,Side Dish,Vegetarian
Chocolate Cheese Gujiya Recipe,"All Purpose Flour, Salt, Ghee, Water, Britannia Cheese Block, Dessicated Coconut, Chocolate Chips, Red Chilli Powder, Sunflower Oil Deep Fry",9,15,30,45,10,North Indian Recipes,Dessert,Vegetarian
Mediterranean Orzo Pasta Salad With Feta Vinaigrette Recipe,"Orzo Pasta, Cherry Tomato, Yellow Bell Pepper, Black Olives, Baby Spinach, Basil Leaves, Feta Cheese, Red Wine Vinaigrette, Lemon Juice, Whole Black Peppercorns, Extra Virgin Olive Oil, Garlic, Salt",13,10,15,25,2,Mediterranean,Dinner,Vegetarian
Andhra Style Vegetarian Biryani with Soya Chunks Recipe,"Basmati Rice, Soy Chunks, Onion, Tomato, Green Chilli, Ginger Garlic Paste, Turmeric Powder, Sunflower Oil Ghee For Cooking, Bay Leaf, Cardamom, Cloves, Cinnamon Stick, Star Anise, Mace, Cardamom, Whole Black Peppercorns, Cloves, Cinnamon Stick, Fennel Seeds",19,30,45,75,4,Andhra,Lunch,Vegetarian
Kerala Style Vendakka Uppadan Recipe,"Bhindi, Tamarind, Turmeric Powder, Coconut Oil, Mustard Seeds, Asafoetida, Curry Leaves, Salt, Methi Seeds, Rice, Dry Red Chilli",11,15,20,35,4,Kerala Recipes,Dinner,Vegetarian
Pudina Pyaz Kachumber Salad Recipe - Mint & Onion Salad,"Onion, Coriander, Mint Leaves, Lemon Juice, Cumin Powder, Black Salt",6,10,0,10,4,Indian,Side Dish,Vegetarian
Sweet & Spicy Ripe Mango Curry Recipe,"Mango, Cumin Seeds, Mustard Seeds, Methi Seeds, Fennel Seeds, Sunflower Oil, Dry Red Chilli, Asafoetida, Turmeric Powder, Red Chilli Powder, Coriander Powder, Garam Masala Powder, Salt, Tamarind Paste",14,20,35,55,6,Indian,Lunch,Vegetarian
Poondu Milagu Kuzhambu Recipe - Tamilnadu Style Garlic and Black Pepper Curry,"Garlic, Turmeric Powder, Jaggery, Mustard Seeds, Tamarind, Methi Seeds, Curry Leaves, Sesame, Garlic, Pearl Onion, Tomato, Whole Black Peppercorns, Cumin Seeds, Dry Red Chilli, Curry Leaves, Sesame",16,10,20,30,4,Tamil Nadu,Lunch,Vegetarian
Aloo Masala Puri Recipe,"Potato, Whole Wheat Flour, Asafoetida, Ajwain, Coriander Powder, Turmeric Powder, Red Chilli Powder, Fennel Seeds, Sesame Seeds, Sunflower Oil, Salt, Coriander, Sunflower Oil",13,20,20,40,4,North Indian Recipes,North Indian Breakfast,Vegetarian
Goan Style Brinjal Bharta Recipe,"Brinjal, Onion, Green Chilli, Coriander, Tamarind Paste, Fresh Coconut, Tamarind, Salt, Sunflower Oil",9,10,45,55,2,Goan Recipes,Lunch,Vegetarian
Dahi Sabudana Recipe (Savory Tapioca Pearls Seasoned with Yogurt),"Sabudana, Groundnut Powder  Roasted, Curd, Ghee, Cumin Seeds, Green Chilli, Sugar, Salt",8,135,20,155,2,Indian,North Indian Breakfast,Vegetarian
Horsegram And Foxtail Millet Idli Recipe,"Foxtail Millet, White Urad Dal, Horse Gram Dal, Poha, Methi Seeds, Salt, Sunflower Oil",7,15,15,30,2,South Indian Recipes,South Indian Breakfast,Diabetic Friendly
Karnataka Style Ranjaka Recipe,"Dry Red Chilli, Of Fenugreek Seeds, Lemon Juice, Mustard Oil, Mustard Oil, Curry Leaves, Asafetida",7,5,20,25,4,Karnataka,Side Dish,Vegetarian
Grilled Tomato And Cheese Sandwich Recipe,"Whole Wheat Brown Bread, Butter, Tomato, Cheese, Salt, Black Pepper Powder, Dried Oregano",7,15,0,15,2,Continental,Snack,Vegetarian
Odia Chatu Besara Recipe (Mushrooms in Spicy Mustard Curry),"Button Mushrooms, Potato, Sunflower Oil, Tomato, Turmeric Powder, Salt, Coriander, Mustard Seeds, Cumin Seeds, Coriander, Dry Red Chilli",11,10,40,50,4,Oriya Recipes,Dinner,Vegetarian
Veg Lebanese Mihshi Malfuf Recipe (Stuffed Cabbage Leaves),"Cabbage, Basmati Rice, White Garbanzo, Tomato, Onion, Garlic, Lemons, All Spice Powder, Parsley Leaves, Black Pepper Powder, Salt, Garlic, Black Pepper Powder, Homemade Tomato Puree, Water, Extra Virgin Olive Oil, Parsley Leaves",17,15,45,60,4,Middle Eastern,Appetizer,Vegetarian
Baked Paneer Corn Kebab Recipe,"Paneer, Dry Corn Kernals, Green Chilli, Chaat Masala Powder, Coriander, Raisins, Cashew Nuts, Whole Wheat Bread Crumbs, Turmeric Powder, Red Chilli Powder, Kasuri Methi, Salt, Sunflower Oil",13,10,45,55,4,North Indian Recipes,Snack,Vegetarian
Apple Roses Recipe With Homemade Puff Pastry Sheets (Eggless),"All Purpose Flour, Butter, Saffron Strands, Cinnamon Powder, Caster Sugar, Water, Apple, Lemon Juice, Water, Butter Brush, Caster Sugar Garnsih, Cinnamon Powder",12,15,60,75,4,Continental,Snack,Vegetarian
Thai Pumpkin Soup With Red Curry Paste Recipe,"Kaddu, Thai Red Curry Paste, Coconut Milk, Vegetable Stock, Black Pepper Powder, Coconut Milk Garnish, Extra Virgin Olive Oil, Salt, Thai Red Chilli, Coriander, Onion, Lemongrass, Fresh Red Chilli, Garlic, Ginger Galangal, Cumin Seeds, White Pepper Powder, Salt, Lemon Juice",19,15,30,45,4,Thai,Appetizer,Vegetarian
Cheese And Olive Spaghetti Recipe,"Black Olives, Green Olives, Capers, Del Monte Spaghetti Pasta, Red Chilli Flakes, Garlic, Salt, Black Pepper Powder, Extra Virgin Olive Oil Cook, Feta Cheese, Parmesan Cheese, Basil Leaves",12,10,25,35,4,Italian Recipes,Dinner,Vegetarian
Mirchi Pakodi Recipe,"Green Chilli, Tamarind Paste, Jaggery, Ajwain, Fennel Seeds, Gram Flour, Red Chilli Powder, Salt, Gram Flour, Baking Soda, Turmeric Powder, Ajwain, Water, Onion, Peanuts, Coriander, Lemon, Chaat Masala Powder",18,10,30,40,4,Indian,Snack,Vegetarian
Assamese Style Ghila Pitha Recipe (Sweetened Rice Fritters Recipe),"Rice, Cooked Rice Help Bind, Jaggery, Cardamom Powder, Lemon Zest, Baking Powder, Sunflower Oil",7,10,30,40,4,Assamese,Snack,Vegetarian
Corn And Peas Curry Recipe,"Corn Cob, Salt, Water, Cumin Seeds, Coriander Seeds, Dry Red Chilli, Sunflower Oil, Garlic, Ginger, Onion, Fresh Coconut, Sunflower Oil, Mustard Seeds, Curry Leaves, Homemade Tomato Puree, Salt, Turmeric Powder, Garam Masala Powder, Kashmiri Red Chilli Powder, Green Peas",20,15,40,55,4,Indian,Main Course,Vegetarian
Kala Vatana Amti ,"Black, Onion, Tomato, Cumin Powder, Black Pepper Powder, Cardamom Powder, Ginger Garlic Paste, Tamarind Paste, Mustard, Spoon Curry Leaves, Asafetida, S Of Coriander, Oil, Salt, Dry Red Chilli, , Lentil Sugar, Star Anise, Coriander Seeds, Fennel, Poppy Seeds, Cumin Seeds, Dry Coconut",23,10,30,40,4,Maharashtrian Recipes,Lunch,High Protein Vegetarian
Sprouted Moong Dal Recipe - Spicy Sprouted Lentil Curry,"Green Moong Sprouts, Onion, Garlic, Ghee Oil, Mustard Seeds, Cumin Seeds, Turmeric Powder, Asafoetida, Maharashtrian Goda Masala, Red Chilli Powder, Kokum, Jaggery, Groundnut Powder, Water As Required, Salt, Coriander",16,10,15,25,4,North Indian Recipes,Lunch,High Protein Vegetarian
Kerala Chicken Roast Recipe,"Chicken, Turmeric Powder, Kashmiri Red Chilli Powder, Lemon Juice, Salt, Onion, Ginger, Garlic, Coriander Powder, Kashmiri Red Chilli Powder, Garam Masala Powder, Fennel Powder, Tomato, Curry Leaves, Salt, Coconut Oil",16,10,80,90,4,Kerala Recipes,Lunch,High Protein Non Vegetarian
Kerala Style Taroo Root Curry Recipe (Colacasia),"Colocasia Root, Tamarind, Salt, Fresh Coconut, Red Chilli Powder, Onion, Coconut Oil, Onion, Mustard Seeds, Cumin Seeds, Dry Red Chilli, Curry Leaves",12,15,25,40,3,Kerala Recipes,Lunch,Vegetarian
Pavakka Pachadi Recipe - Bitter Gourd Pachadi,"Karela, Onion, Curd, Turmeric Powder, Salt, Fresh Coconut, Mustard Seeds, Green Chilli, Coconut Oil, Mustard Seeds, Dry Red Chilli, Curry Leaves",12,10,15,25,4,Kerala Recipes,Side Dish,Vegetarian
Dry Fruits Spongy Cake Recipe,"All Purpose Flour, Caster Sugar, Baking Powder, Baking Soda, Salt, Mixed Dry Fruits, Water, Sunflower Oil, Vinegar, Vanilla Extract, Sunflower Oil Grease The Cake Tin",11,20,40,60,6,Continental,Snack,Vegetarian
Broccoli Egg Bhurji ,"Eggs, Broccoli, Onion, Tomato, Garlic, Turmeric Powder, Red Chili Powder, Green Coriander, Salt, As Per",10,10,20,30,4,Indian,World Breakfast,Eggetarian
Chutney Podi Sadam Recipe - Rice Flavoured With Chutney Podi,"Cooked Rice, Mustard Seeds, White Urad Dal, Chana Dal, Raw Peanuts, Curry Leaves, Green Chilli, Turmeric Powder, Onion, Salt, Ghee, Lemon Juice, Idli Dosa Podi, Coriander",14,15,15,30,3,Tamil Nadu,Main Course,Vegetarian
Lemon Coconut Chia Energy Balls Recipe,"Dates, Almonds, Coconut, Chia Seeds, Lemon Juice, Lemon Zest",6,10,10,20,4,Indian,Snack,Vegetarian
Whole Wheat Spinach And Tofu Paratha Recipe,"Whole Wheat Flour, Spinach Leaves, Tofu, Curd, Kasuri Methi, Dill Leaves, Red Chilli Powder, Cumin Powder, Green Chilli Paste, Ajwain, Sesame Seeds, Garam Masala Powder, Lemon, Sunflower Oil Smear, Salt",15,25,25,50,4,North Indian Recipes,Indian Breakfast,Diabetic Friendly
Eggless Tutti Frutti Cake Recipe,"All Purpose Flour, Whole Wheat Flour, Sooji, Milk Powder, Corn Flour, Sugar, Butter, Milk, Curd, Condensed Milk, Baking Powder, Baking Soda, Tutti Frutti, Raisins, Food Color, Vanilla Extract, Cardamom, White Vinegar, Salt, All Purpose Flour",20,15,50,65,8,Continental,Dessert,Vegetarian
Kiwi Basil Lemonade Recipe,"Kiwi, Sugar Syrup, Lemon Juice, Water, Black Salt, Basil Leaves, Ice Cubes",7,10,5,15,2,Continental,Appetizer,Vegetarian
Vegetable Dal Pakora Recipe - Dal Bhajiya,"Chana Dal, Yellow Moong Dal, Carrot, Onion, Green Chilli, Ginger, Enos Fruit Salt, Red Chilli Powder, Turmeric Powder, Fennel Seeds, Coriander, Salt, Sunflower Oil",13,10,40,50,4,North Indian Recipes,Snack,High Protein Vegetarian
Bhel Puri Recipe,"Puffed Rice, Sev, Papdi Puri, Onion, Tomato, Green Chilli, Cucumber, Potato, Pomegranate Powder, Raw Mango, Peanuts, Green Chutney, Tamarind Chutney, Chaat Masala Powder, Salt, Coriander",16,30,10,40,4,North Indian Recipes,Snack,Vegetarian
Strawberry Raita Recipe,"Curd, Strawberries, Onion, Green Chilli, Sugar, Cumin Powder, Black Pepper Powder, Salt, Coriander, Strawberries",10,15,15,30,4,Indian,Side Dish,Vegetarian
Chironji And Makhane Ki Kheer Recipe,"Phool Makhana, Ghee, Milk, Jaggery, Cardamom Powder, Cinnamon Stick, Saffron Strands, Badam, Raisins, Chironji, Ghee",11,5,40,45,4,North Indian Recipes,Dessert,Vegetarian
Black Cherry Glazed Thandai Burfi Recipe,"Thandai Masala, Bottle Gourd, Khoya, Sugar, Ghee, Cashew Nuts, Badam, Cardamom Powder, Green Food Colour, Cherry Preserve Jam",10,10,45,55,4,Indian,Dessert,Vegetarian
Eggless Nutella Crepes With Strawberries Recipe,"All Purpose Flour, Milk, Water, Sugar, Vanilla Extract, Butter, Nutella Spread, Strawberries",8,5,30,35,4,French,World Breakfast,Vegetarian
Chatpata Baby Potato ,"Small Potato, Coriander Seeds, Cumin Seeds, Fennel Seeds, Whole Pepper, Dry Red Chilli, Oil, , , Sugar, Water, Salt, Coriander Leaves",13,10,15,25,4,North Indian Recipes,Lunch,Vegetarian
Rase Wale Aloo Recipe (Boiled Potato in Tangy Tomato Sauce),"Potato, Tomato, Sunflower Oil, Cumin Seeds, Asafoetida, Salt, Red Chilli Powder, Sugar, Turmeric Powder, Cumin Powder, Garam Masala Powder, Coriander Powder",12,20,30,50,4,North Indian Recipes,Lunch,No Onion No Garlic (Sattvic)
Stuffed Mango Pickle Recipe - Gujarati Dabla Keri Nu Athanu,"Mango, Methi Seeds, Red Chilli Powder, Salt, Peanut Oil, Asafoetida, Peanut Oil",7,5,30,35,4,Gujarati Recipesï»¿,Side Dish,Vegetarian
Biryani Chammanthi Recipe (Green Chutney Recipe),"Fresh Coconut, Coriander, Mint Leaves, Green Chilli, Garlic, Ginger, Cumin Seeds, Lemon Juice, Salt",9,25,0,25,4,Kerala Recipes,Side Dish,Vegetarian
Easy Gajar Halwa Recipe With Khoya Made In A Pressure Cooker,"Carrots, Ghee, Milk, Khoya, Sugar, Cardamom Powder, Ghee, Mixed Dry Fruits",8,15,20,35,4,North Indian Recipes,Dessert,Vegetarian
Garlic Red Chicken Gravy Recipe,"Chicken, Sunflower Oil, Butter, Onion, Dry Red Chilli, Garlic, Curd, Turmeric Powder, Salt, Cumin Powder",10,5,15,20,5,North Indian Recipes,Dinner,High Protein Non Vegetarian
Vepampoo Kara Kuzhambu Recipe,"Small Onion, Garlic, Turmeric Powder, Sambar Powder, Coriander Powder, Tamarind, As Much As Water, As Per, Sesame Oil, Asafoetida, Rye, Fenugreek Seeds, Chickpea Lentils, Dried Red Chilli, Sesame Oil, Neem Leaves",16,20,35,55,4,South Indian Recipes,Lunch,Vegetarian
Bell Pepper Sabji Recipe-No Onion No Garlic,"Yellow Bell Pepper, Red Bell Pepper, Groundnut Powder, Sesame Powder, Maharashtrian Goda Masala, Red Chilli Powder, Turmeric Powder, Asafoetida, Tamarind Paste, Jaggery  Grated, Sunflower Oil, Mustard Seeds, Cumin Seeds, Coriander",14,10,10,20,4,Maharashtrian Recipes,Lunch,Vegetarian
Dim Posto Recipe - Bengali Egg Curry With Poppy Seeds,"Whole Eggs, Potato, Poppy Seeds, Homemade Tomato Puree, Panch Phoran Masala, Turmeric Powder, Onion, Ginger, Garlic, Green Chilli, Mustard Oil, Dry Red Chilli, Bay Leaf, Sugar, Salt",15,30,35,65,4,Bengali Recipes,Dinner,Eggetarian
Patishapta Recipe (Rice Crepe),"All Purpose Flour, Sooji, Rice Flour, Milk, Cardamom Powder, Fresh Coconut, Jaggery, Ghee Refined Sunflower Oilroast The Crepes, Mixed Dry Fruits, Condensed Milk  Optional",10,10,25,35,3,Bengali Recipes,Dessert,Vegetarian
Omakka Curry Recipe - Kerala Style Papaya Curry,"Raw Papaya, Green Chilli, Fresh Coconut, Pearl Onion, Curry Leaves, Red Chilli Powder, Turmeric Powder, Cumin Seeds, Mustard Seeds, Dry Red Chilli, Tamarind, Sunflower Oil, Salt",13,20,10,30,3,Kerala Recipes,Lunch,Vegetarian
Buckwheat Apple Cinnamon Loaf Cake Recipe,"Buckwheat Flour, Corn Flour, Brown Sugar, Apple, Baking Powder, Cinnamon Powder, Vanilla Extract, Butter, Icing Sugar, Milk",10,15,25,40,4,Continental,Dessert,Vegetarian
Foxtail Millet Paruppu Adai With Keerai Recipe - Foxtail Millet and Lentil Crepes with Spinach,"Foxtail Millet, Arhar Dal, Yellow Moong Dal, Chana Dal, Dry Red Chilli, Spinach, Green Chilli, Fennel Seeds, Sunflower Oil Make Adai, Salt",10,240,10,250,4,South Indian Recipes,South Indian Breakfast,Vegetarian
Pasta Payasam Recipe - Fusion Payasam With Pasta,"Linguine Pasta  Boiled, Milk, Sugar, Cardamom Powder, Ghee, Cashew Nuts, Raisins, Saffron Strands, Fresh Coconut, Cashew Nuts",10,10,40,50,4,Indian,Dessert,Vegetarian
Penne Pasta In White Sauce Recipe,"Penne Pasta, Sunflower Oil, Salt, Butter, Whole Wheat Flour Maida, Milk  Boiled & Cooled, Cheddar Cheese, Black Pepper Powder, Italian Seasoning, Red Chilli Flakes, Salt, Sweet Corn, Broccoli, Red Bell Pepper, Yellow Bell Pepper, Butter, Red Chilli Flakes, Salt",18,10,20,30,4,Italian Recipes,Dinner,Vegetarian
Dal Tadka Recipe Flavored with Lemon and Coriander,"Yellow Moong Dal, Butter, Ghee, Ginger, Cumin Seeds, Turmeric Powder, Bay Leaf, Green Chilli, Coriander, Lemon Juice, Salt",11,10,30,40,3,North Indian Recipes,Lunch,High Protein Vegetarian
Tandoori Chicken Momo Recipe,"All Purpose Flour, Water Knead, Chicken Breasts, Fresh Cream, Tandoori Masala, Garam Masala Powder, Cumin Powder, Red Chilli Powder, Chaat Masala Powder, Salt, Lemon Juice, Tandoori Masala, Red Chilli Sauce",13,25,25,50,4,Indo Chinese,Appetizer,Non Vegeterian
Chettinad Beans & Cauliflower Poriyal Recipe (South Indian Stir Fry),"Cauliflower, Green Beans, Mustard Seeds, White Urad Dal, Curry Leaves, Red Chilli Powder, Turmeric Powder, Salt, Sesame",9,10,30,40,4,Chettinad,Lunch,Vegetarian
Strawberry & Chocolate Rolls Recipe With Vanilla Glaze,"Strawberries, Caster Sugar, Corn Flour, Dark Chocolate, All Purpose Flour, Butter, Sugar, Whole Egg, Salt, Milk, Active Dry Yeast, Icing Sugar, Milk, Vanilla Extract",14,110,25,135,8,Continental,Snack,Eggetarian
Healthy Fulkopir Paturi Recipe (Bengali Style Cauliflower Dumplings),"Cauliflower, Turmeric Powder, Red Chilli Powder, Cumin Seeds, Sugar, Mustard Oil, Salt, Mustard Seeds, Poppy Seeds, Green Chilli, Fresh Coconut, Garlic, Banana Leaf Line The Steamer, Banana Leaf, Toothpicks, Sunflower Oil",16,10,75,85,2,Bengali Recipes,Lunch,Vegetarian
French Toast Recipe With Oven Roasted Streaky Bacon,"Whole Wheat Brown Bread, Whole Eggs, Fresh Cream, Milk, Sugar, Butter, Salt, Maple Syrup Honey, Bacon Strips, Ripe Bananas",10,5,15,20,1,French,World Breakfast,Non Vegeterian
Tamatar Chaat Banarasi Style ,"Potato, Red Chili Powder, Tomato, Black Saltrock Salt, Cumin Powder, Pepper Powder, Tomato Ketchup, Sugar, Teaspoon Garam Masala Powder, Onion, Green Chilli, Coriander, Puffed Rice Salted, Oil",14,10,25,35,2,Uttar Pradesh,Snack,Vegetarian
Baked Modak and Karanji/Gujiya Recipe,"All Purpose Flour, Ghee, Salt, Water, Dessicated Coconut, Sugar, Sooji, Cashew Nuts, Ghee, Cardamom Powder",10,10,35,45,2,Indian,Dessert,Vegetarian
Dal Banjara Recipe - Langar Wali Dal,"Black Urad Dal, Chana Dal, Ginger, Green Chilli, Tomato, Bay Leaf, Cinnamon Stick, Turmeric Powder, Garam Masala Powder, Coriander, Ghee, Cumin Seeds, Dry Red Chilli",13,10,40,50,4,North Indian Recipes,Lunch,High Protein Vegetarian
Zucchini Keerai Thogayal Recipe - South Indian Tangy Spinach and Zucchini Chutney,"Green Zucchini, Spinach Leaves, Whole Black Peppercorns, Tamarind, Methi Seeds, Cumin Seeds, White Urad Dal, Sesame, Mustard Seeds, White Urad Dal, Curry Leaves",11,15,15,30,4,South Indian Recipes,Lunch,No Onion No Garlic (Sattvic)
Chicken Lasagna Recipe,"Boneless Chicken, Black Pepper Powder, Paprika Powder, Lemon Juice, Salt, Lasagna Sheets  Ones That Need No Precooking, Mozzarella Cheese, Parmesan Cheese, Tomato Basil Pasta Sauce, Parsley Leaves",10,10,45,55,4,Italian Recipes,Lunch,Non Vegeterian
Egg Scramble With Drumstick Leaves Recipe,"Whole Eggs, Drumstick Leaves, Onion, Green Chilli, Sunflower Oil, Black Pepper Powder, Salt",7,15,5,20,2,Indian,Indian Breakfast,Eggetarian
Sweet and Spicy Tomato Chutney Recipe With Garlic,"Tomato, Garlic, Whole Black Peppercorns, Cinnamon Stick, Green Chilli, Cashew Nuts, Jaggery, Red Chilli Powder, Lemon Juice, Salt",10,15,15,30,6,Indian,Side Dish,Vegetarian
Veppam Poo Rasam Recipe (Neem flower Rasam),"Neem Flowers, Tamarind, Rasam Powder, Tomato, Jaggery, Ghee, Salt, Ghee, Asafoetida, Mustard Seeds, Dry Red Chilli, Curry Leaves",12,10,35,45,2,South Indian Recipes,Lunch,Vegetarian
Broccoli Almond Soup Recipe,"Broccoli, Onion, Garlic, Milk, Almonds, Salt, Grind  Whole Pepper",7,10,20,30,4,Continental,Appetizer,High Protein Vegetarian
Odia Style Chuin Aloo Besara Recipe-Potato & Drumsticks Fry In Mustard Paste,"Potato, Drumstick, Mustard Seeds, Cumin Seeds, Dry Red Chilli, Garlic, Turmeric Powder, Panch Phoran Masala, Mustard Oil, Salt",10,15,65,80,4,Oriya Recipes,Lunch,Vegetarian
Konkani Style Solkadhi Recipe - Kokum Drink,"Kokum, Fresh Coconut, Green Chilli, Garlic, Coriander, Cumin Powder, Salt, Mint Leaves",8,30,15,45,3,Konkan,Side Dish,Vegetarian
Goan Masoorchi Usali ,"Lentils, Onion, Tomato, Coconut, Oil, Salt, Green Chili, Rye, Cumin Seeds, Asafoetida, Turmeric Powder, Sprig Curry Leaf, Coriander",13,10,35,45,2,Goan Recipes,Lunch,High Protein Vegetarian
Spinach Potato Frittata Bites Recipe,"Spinach Leaves, Potato, Garlic, Onion, Whole Eggs, Milk, Cheddar Cheese, Red Chilli Flakes, Extra Virgin Olive Oil, Salt And Pepper",10,20,30,50,4,Continental,Appetizer,Eggetarian
Creamy Mushroom Risotto Recipe,"Arborio Rice, Butter, Onion, Garlic, Vegetable Stock, Green Bell Pepper, Button Mushrooms, Fresh Cream, Cheese, Salt, Black Pepper Powder, Dried Oregano",12,15,35,50,4,Italian Recipes,Dinner,High Protein Vegetarian
Tawa Mushroom Recipe,"Button Mushrooms, Onion, Tomato, Ginger, Garlic, Green Chilli, Red Chilli Powder, Turmeric Powder, Coriander Powder, Cumin Powder, Garam Masala Powder, Pav Bhaji Masala, Amchur, Salt, Sunflower Oil, Coriander",16,10,30,40,4,North Indian Recipes,Lunch,Vegetarian
Soft and Crispy Cheese Stuffed Puff Sticks Recipe,"Cheddar Cheese, Mozzarella Cheese, Extra Virgin Olive Oil, S Basil Leaves, Puff Pastry Sheet, All Purpose Flour",6,15,20,35,4,Continental,Appetizer,Vegetarian
Tomato Jam Recipe,"Tomato, Sugar, Salt, Lemon Juice, Cinnamon Stick, Cloves",6,5,45,50,10,Indian,World Breakfast,Vegetarian
Besan Aur Mirch Ki Sabzi Recipe,"Gram Flour, Green Chilli, Sunflower Oil, Asafoetida, Water, Red Chilli Powder, Turmeric Powder, Lemon Juice, Salt, Coriander",10,15,30,45,4,Rajasthani,Lunch,Vegetarian
Watermelon Cucumber Gazpacho Recipe,"Tomato, Watermelon, Cucumbers, Serrano Pepper, Red Wine Vinaigrette, Extra Virgin Olive Oil, Salt And Pepper, Basil Leaves",8,15,30,45,2,European,Side Dish,Vegetarian
Shakshuka With Oats Recipe-A High Protein Breakfast,"Rajma, Extra Virgin Olive Oil, Onion, Garlic, Tomato, Honey More, Cumin Powder, Dried Oregano, Red Chilli Powder Cayenne Pepper, Salt, Black Pepper Powder, Baked Beans, Instant Oats, Whole Eggs, Coriander",15,10,30,40,4,Middle Eastern,World Breakfast,Eggetarian
Kerala Special Mambazha Puliserry Recipe,"Mango, Green Chilli, Curd, Salt, Fresh Coconut, Cumin Seeds, Turmeric Powder, Red Chilli Powder, Coconut Oil, Mustard Seeds, Methi Seeds, Dry Red Chilli, Curry Leaves",13,20,30,50,6,Kerala Recipes,Lunch,Vegetarian
Broad Bean And Courgette Zucchini Pilaf Recipe,"Basmati Rice, Green Zucchini, Green Chilli, Garlic, Green Peas, White Broad Beans, Mint Leaves, Salt, Extra Virgin Olive Oil",9,20,30,50,3,Continental,Main Course,Vegetarian
Patiala Aloo Recipe,"Potato, Mustard Oil Cooking Oil, Cumin Seeds, Asafoetida, Methi Seeds, Green Chilli, Red Chilli Powder, Cumin Powder, Bay Leaf, Coriander Powder, Amchur, Chaat Masala Powder, Garam Masala Powder, Turmeric Powder, Kasuri Methi, Homemade Tomato Puree, Tamarind Paste, Coriander",18,10,25,35,4,North Indian Recipes,Main Course,No Onion No Garlic (Sattvic)
Muesli Oats Cupcake Filled with Yogurt and Strawberries Recipe,"Oats Flour, Muesli, Ragi Flour, Egg White, Sunflower Oil, Milk, Curd, Baking Powder, Hung Curd, Strawberries",10,15,30,45,4,Continental,World Breakfast,Eggetarian
KFC Style Crispy Chicken Popcorn Recipe,"Chicken Breasts, Garlic, Lemon Juice, Dried Oregano, Dried Thyme Leaves, Rosemary, Red Chilli Flakes, Salt, Cumin Powder, Garam Masala Powder, Whole Wheat Brown Bread, Whole Egg, Milk, All Purpose Flour",14,20,15,35,2,American,Appetizer,Non Vegeterian
Corn And Capsicum Sandwich Recipe,"Sweet Corn, Capsicum, Black Pepper Powder, Red Chilli Flakes, Green Coriander, Cheese, Bread, Butter, Salt",9,10,10,20,4,American,Appetizer,Non Vegeterian
Natillas de Leche Recipe-Spanish Custard,"Milk, Sugar, Cinnamon Stick, Lemon Zest, Corn Flour, Whole Egg, Vanilla Extract",7,120,30,150,2,Mexican,Dessert,Eggetarian
Sesame Bread Patties Recipe (Bread Cutlets),"Crusty Bread Log, Hung Curd, Onion, Green Chilli, Black Sesame Seeds, Sesame Seeds, Sugar, Red Chilli Powder, Corn Flour, Salt, Sunflower Oil",11,20,30,50,6,Indian,Snack,Vegetarian
Kongunadu Style Vetrilai Sadam Recipe - Betel Leaves Rice,"Betel Leaves, Cooked Rice, Garlic, Sunflower Oil, Mustard Seeds, Chana Dal, White Urad Dal, Curry Leaves, Roasted Peanuts, Cashew Nuts, Fresh Red Chilli, Salt, Cumin Seeds, Fennel Seeds, Whole Black Peppercorns, Sesame Seeds, Curry Leaves",17,5,20,25,4,Kongunadu,Lunch,Vegetarian
Lauki Bharta ,"Gourd, Onion, Tomato, Ginger Garlic Paste, Cumin Seeds, Red Chili Powder, Turmeric Powder, Garam Masala Powder, Salt, Oil, Sugar, Coriander Garnish",12,15,30,45,4,Indian,Dinner,Diabetic Friendly
Chettinad Muttai Masala Recipe - Chettinad Style Egg Curry,"Whole Eggs, Onion, Tomato, Coriander Powder, Garam Masala Powder, Red Chilli Powder, Cinnamon Stick, Cloves, Sunflower Oil, Salt, Coriander, Garlic, Ginger, Fresh Coconut, Fennel Seeds, Whole Black Peppercorns, Poppy Seeds, Cumin Seeds, Dry Red Chilli",19,20,30,50,4,Chettinad,Lunch,Eggetarian
Goan Kaju Curry Recipe,"Cashews, Tomato, Capsicum, Turmeric Powder, Oil, Green Coriander, Salt, Coconut, Onion, Garlic, Coriander Seeds, Red Chilli, Whole Black Pepper, Cumin, , Tamarind",16,10,45,55,3,Goan Recipes,Lunch,Vegetarian
Bihari Suran Chutney Recipe,"G Suran, Lemon Juice, Ginger, Green Chilli, Turmeric Powder, Red Chilli Powder, Rye, Celery, Asafoetida, Mustard Oil, Salt, Onion, Coriander",13,20,20,40,4,Bihari,Side Dish,Diabetic Friendly
Lahori Aloo ,"Small Potato, Oil, Ginger Garlic Paste, Salt, Milk, Coriander Leaves, Onion, Bay Leaves, Tomato, Oil, Dry Red Chilli, Coriander Seeds, Cumin Seeds, , Poppy Seeds, Fennel, Lentil Sugar, Dry Red Chilies, Dry Coconut",19,20,45,65,4,Pakistani,Lunch,Vegetarian
Beetroot Chicken Cutlets Recipe,"Boneless Chicken, Potato, Beetroot, Coriander, Curry Leaves, Green Chilli, Ginger Garlic Paste, Cumin Seeds, Garam Masala Powder, Red Chilli Powder, Salt, Whole Black Peppercorns, Sunflower Oil Shallow Fry, Whole Wheat Bread Crumbs",14,30,20,50,4,Indian,Appetizer,High Protein Non Vegetarian
Cheesy Baked Ziti Pasta Recipe,"Pasta, Olive Oil, Button Mushrooms, Sweet Corn, Salt, Olive Oil, Basil, Garlic, Onion, Red Chilli Flakes, Salt, Sugar, Black Pepper Powder, Rosemary, Tomato Puree, Mozzarella Cheese",16,10,40,50,4,Italian Recipes,Main Course,Vegetarian
Thai Style Khao Tom Recipe (Black Rice Clear Soup Recipe),"Black Rice, Stalk Lemon Grass, Soy Sauce, Onion, Garlic, Ginger, Lemon Juice, Fresh Red Chilli, Tofu, Salt And Pepper, Whole Eggs, Onion, S Coriander, S Spring Onion Greens",14,10,45,55,2,Thai,World Breakfast,Eggetarian
Dahi Batata Puri Chaat Recipe - Classic Indian Tea Time Snack,"Pani Puris, Potato, Mango, Chaat Masala Powder, Lemon Juice, Onion, Curd, Black Salt, Sugar, Red Chilli Powder, Chaat Masala Powder, Green Chutney, Sweet Chutney, Sev",14,45,0,45,2,North Indian Recipes,Snack,Vegetarian
Quick Vegetable Noodles Recipe,"Pasta, Garlic, Ginger, Mixed Herbs, Onion, Tomato, Carrot, Green Beans, Green Bell Pepper, Rajma, Extra Virgin Olive Oil, Butter, Black Pepper Powder, Red Chilli Flakes Red Chili Powder, Salt, Coriander",16,10,20,30,2,Italian Recipes,Dinner,Vegetarian
Thai Yellow Curry Recipe,"Mixed Vegetables, Coconut Milk, Chilled Water, Thai Basil Leaves, Stalks Lemongrass, Galangal, Onion, Dry Red Chilli, Kaffir Lime Leaves, Garlic, Coriander, Cumin Seeds, Turmeric Powder, Thai Red Curry Paste, Salt",15,10,50,60,4,Thai,Lunch,Vegetarian
Creamy Mixed Vegetable Risotto Recipe,"Arborio Rice, Butter, Onion, Garlic, Vegetable Stock, Red Yellow And Green Bell Peppers, Button Mushrooms, Fresh Cream, Cheese, Salt, Black Pepper Powder, Dried Oregano",12,15,35,50,3,Italian Recipes,Dinner,Vegetarian
Thandai Flavoured Rice Kheer Recipe,"Thandai Powder, Saffron Strands, Basmati Rice, Milk, Sugar, Condensed Milk, Badam, Pistachios, Cashew Nuts, Rose Petals, Cardamom Powder, Mixed Nuts, Milk, Badam, Cashew Nuts, Pistachios, Poppy Seeds, Cardamom, Cinnamon Stick, Whole Black Peppercorns",20,10,50,60,4,North Indian Recipes,Dessert,Vegetarian
Lemongrass Coconut Rice Recipe,"Rice, Green Beans, Carrot, Broccoli, Green Peas, Coconut Milk, Water, Ginger, Whole Black Peppercorns, Stock Lemongrass   Into  Pieces, Sunflower Oil, Salt",12,15,25,40,4,Indian,Lunch,Vegetarian
Cheese And Black Beans Quesadillas Recipe,"Black Beans, Onion, Tomato, Cheddar Cheese, Cumin Powder, Black Pepper Powder, Salt, Extra Virgin Olive Oil, Tortillas",9,10,20,30,3,Mexican,Lunch,Vegetarian
Tawa Amritsari Kulcha Recipe,"Whole Wheat Flour, Curd, Salt, Sunflower Oil, Potato, Red Chilli Powder, Turmeric Powder, Garam Masala Powder, Amchur, Cumin Powder, Green Chilli, Salt",12,30,30,60,4,Punjabi,Side Dish,Vegetarian
Paneer Bhurji Recipe With Capsicum ,"Paneer, Capsicum, Onion, Ginger, Green Chilli, Tomato, Small Spoon Cumin Seeds, Turmeric Powder, Red Chilli Powder, Coriander, Salt, Butter",12,10,30,40,4,North Indian Recipes,Lunch,High Protein Vegetarian
One Pot Spinach Macaroni Pasta Recipe,"Macaroni Pasta, Spinach  Tightly Packed, Sunflower Oil, Parmesan Cheese, Milk, Butter, Black Pepper Powder, Salt",8,10,15,25,2,Italian Recipes,Dinner,Vegetarian
Chilli Baby Corn (Manchurian) Recipe,"Baby Corn, Corn Flour, Green Bell Peppers, Spring Onion, Green Chilli, Garlic, Ginger, Red Chilli Sauce, Sweet And Spicy Red Chilli Sauce, Dark Soy Sauce, Salt And Pepper, Spring Onion Greens",12,15,20,35,4,Indo Chinese,Appetizer,Vegetarian
Sri Lankan Pumpkin Curry Recipe - No Oil,"Kaddu, Shallots, Green Chilli, Cinnamon Stick, Methi Seeds, Turmeric Powder, Black Pepper Powder, Red Chilli Powder, Sugar, Coconut Milk, Salt, Garlic, Mustard Seeds",13,10,15,25,4,Sri Lankan,Dinner,Vegetarian
Asian Black Pepper Basa Fish Recipe,"Basa Fish, Vinegar, Dark Soy Sauce, Black Pepper Powder, Sesame, Garlic, Ginger, Spring Onion, Dry Red Chilli, Whole Black Peppercorns, Dark Soy Sauce, Vinegar, Corn Flour",13,20,25,45,2,Asian,Main Course,Non Vegeterian
Goan Chana Ros ,"White Peas, Onion, Coconut, Dry Red Chilli, , , Tamarind, Turmeric Powder, Salt",9,500,30,530,3,Goan Recipes,Lunch,Vegetarian
Nutty Oats and Berry Truffle Recipe,"Instant Oats, Brown Sugar, Blueberries, Badam, Ghee Butter, All Spice Powder",6,10,40,50,2,Continental,Snack,Vegetarian
Nepali Beans Soup ,"Rajma, Green Moong Dal, Black Gram, Arhar Dal, Dried Peas, Cumin Seeds, Mustard, Celery, Fennel, Coriander Powder, Cumin Powder, Red Chilli, Oil, Salt, Tomato, Onion   Garlic, Ginger",17,1440,30,1470,4,Nepalese,Dinner,High Protein Vegetarian
Baked Masala Namak Para Recipe - Carom Seeds Spiced Biscuits,"All Purpose Flour, Whole Wheat Flour, Ajwain, Black Pepper Corns, Asafoetida, Turmeric Powder, Salt, Ghee, Sunflower Oil, Water, Chaat Masala Powder",11,10,20,30,4,Indian,Snack,Vegetarian
Chili Coriander and Capsicum Rusk Chutney Recipe,"Coriander, Green Bell Pepper, Rusk, Garlic, Green Chilli, Raw Peanuts, Sugar, Lemon Juice, Salt",9,10,20,30,4,Indian,Side Dish,Diabetic Friendly
Millet and Jowar Paniyaram Recipe,"Foxtail Millet, Jowar Seeds, White Urad Dal, Methi Seeds, Onion, Green Chilli, Ginger, Garlic, Mustard Seeds, White Urad Dal, Curry Leaves, Coriander, Fresh Coconut, Salt",14,20,30,50,4,Tamil Nadu,South Indian Breakfast,Diabetic Friendly
Double Ka Meetha Recipe With Mixed Nuts Rabri,"Milk, Whole Wheat Brown Bread, Sugar, Water, Cardamom Powder, Cashew Nuts, Badam, Pistachios, Saffron Strands, Rose Water, Ghee",11,10,40,50,4,Hyderabadi,Dessert,Vegetarian
Thalipeeth Bhajani Recipe -Typical Maharashtrian Multigrain Flour Mix,"Jowar Seeds, Ragi Seeds, Rice, Wheat Germ, Bajra, Green Moong Dal, Masoor Dal, Kala Chana, Moth Dal, Soybeans, Coriander, Cumin Seeds",12,10,90,100,500,Maharashtrian Recipes,Vegetarian,Vegetarian
Noodle Sizzler With Garlic Pepper Sauce And Baked Vegetables Recipe,"Hakka Noodles, Extra Virgin Olive Oil, Cabbage, Garlic, Ginger, Soy Sauce, Red Chilli Sauce, Black Pepper Powder, Salt, Extra Virgin Olive Oil, Garlic, Red Bell Pepper, Fresh Red Chilli, Onion, Salt, Mixed Vegetables, Green Bell Pepper, Button Mushrooms, Sunflower Oil, Salt, Black Pepper Powder",21,25,40,65,2,Asian,Dinner,Vegetarian
Egg Muffin With Vegetables Recipe,"Whole Eggs, Spinach, Red Bell Pepper, Green Bell Pepper, Green Chilli, Spring Onion Greens, Black Pepper Powder, Chaat Masala Powder, Salt, Cheese, Sunflower Oil",11,10,30,40,4,Continental,World Breakfast,Eggetarian
Sweet & Spicy Totapuri Mango Chutney Recipe,"Mango, Jaggery, Kashmiri Red Chilli Powder, Cumin Seeds, Salt",5,20,20,40,10,Indian,Side Dish,Vegetarian
"Healthy Vegetable Fries Recipe (Oven roasted Potato, Zucchini and Carrot Fries)","Green Zucchini, Yellow Zucchini, Carrots, Potato, Whole Wheat Bread Crumbs, Italian Seasoning, Garlic Powder, Egg White, Black Pepper Powder, Red Chilli Flakes, Salt",11,10,30,40,4,Continental,Side Dish,Vegetarian
Avarekaalu Usli (Broad Bean In Gravy) Recipe,"Avarekai, Onion, Green Chilli, Ginger, Garlic, Lemon Juice, Asafoetida, Turmeric Powder, Salt, Mustard Seeds, White Urad Dal, Curry Leaves",12,10,30,40,4,South Indian Recipes,Dinner,Vegetarian
Andhra Style Pappulo Undrallu Recipe,"Rice Flour, Jaggery, Water, Yellow Moong Dal, Milk, Jaggery, Cardamom Powder, Coconut Milk, Ghee, Cashew Nuts",10,15,20,35,4,Andhra,Dessert,Vegetarian
Shakkarpara Recipe (Shankarpali),"Water, Sugar, Vivatta Maida Use Whole Wheat Flour, Salt, Ghee, Sunflower Oil, Sugar, Cinnamon Powder",8,10,90,100,2,North Indian Recipes,Snack,Vegetarian
Munthiri Kothu Recipe,"Green Moong Dal, Jaggery, Water, Fresh Coconut, Cardamom Powder, Sunflower Oil, Corn Flour, Rice Flour, Turmeric Powder, Salt, Water",11,10,20,30,5,Tamil Nadu,Dessert,Vegetarian
7 Cups Burfi Recipe,"Gram Flour, Milk, Fresh Coconut, Ghee, Sugar, Water, Cardamom Powder",7,10,15,25,2,Indian,Dessert,Vegetarian
Punjabi Mooli Ki Bhurji Recipe,"Mooli Mullangi, Mooli Ke Patte, Mustard Oil, Ajwain, Asafoetida, Ginger, Green Chilli, Turmeric Powder, Red Chilli Powder, Salt",10,10,25,35,3,Punjabi,Side Dish,Vegetarian
Andhra Cheese & Vegetables Pesarattu Recipe,"Green Moong Dal, Broken Raw Rice, Instant Oats, Methi Seeds, Green Chilli, Ginger, Coriander, Salt, Ghee Make The Pesarattu, Yellow Bell Pepper, Red Bell Pepper, Green Bell Pepper, Onion, Paneer, Tomato Ketchup Pizza Sauce, Red Chilli Sauce, Coriander, Mixed Herbs, Salt, Mozzarella Cheese Cheddar",20,30,25,55,3,Fusion,South Indian Breakfast,Vegetarian
Broccoli Salad Recipe with Roasted Onion & Peppers,"Broccoli, Onion, Red Bell Pepper, Yellow Bell Pepper, Veeba Harissa Sauce, Brown Sugar, Vinegar, Extra Virgin Olive Oil, Salt",9,10,10,20,2,Continental,Appetizer,High Protein Vegetarian
Bihari Green Peas Bharbhara ,"Green Peas, Flour, Onion, Green Chili, Ginger, Garam Masala Powder, Black Pepper Powder, Cumin Powder, Coriander Powder, Red Chili Powder, Salt, Oil",12,10,30,40,4,Bihari,Snack,Vegetarian
Punjabi Wadi Choliya Ki Sabzi Recipe,"Badi, Fresh Green Chickpeas, Homemade Tomato Puree, Ginger, Curd, Asafoetida, Coriander Powder, Turmeric Powder, Red Chilli Powder, Salt, Sunflower Oil Cook, Coriander",12,20,20,40,4,Punjabi,Side Dish,High Protein Vegetarian
Mooli Raita Recipe,"Hung Curd, Radish, Red Chilli Powder, Cumin Powder, Green Chilli, Green Coriander, Salt",7,15,20,35,4,Indian,Side Dish,Vegetarian
Mexican Style Scrambled Egg Enchiladas Recipe,"Makki Ka Atta, Whole Wheat Flour, Salt, Whole Eggs, Onion, Garlic, Salt, Black Pepper Powder, Onion, Red Bell Pepper, Green Bell Peppers, Red Chilli Powder, Cumin Powder, Garlic, Dried Oregano, Salt, Tomato, Onion, Garlic, Sugar, Red Chilli Flakes, Dried Oregano, Salt, Hung Curd, Lemon Juice",25,30,45,75,4,Mexican,Lunch,Eggetarian
"Spinach, Apple and Walnut Salad Recipe","Baby Spinach, Walnuts, Raisins, Apple, Sunflower Seeds, Sunflower Oil, Lemon Juice, Salt, Black Pepper Powder, Dijon Mustard, Honey",11,10,0,10,2,Continental,Side Dish,Vegetarian
Bhindi With Cashews & Coconut Sabzi Recipe,"Bhindi, Garlic, Cashew Nuts, Fresh Coconut  Grated, Curry Leaves, Red Chilli Powder, Mustard Seeds, Cumin Seeds, Chana Dal, Dry Red Chilli, Sunflower Oil",11,10,25,35,4,South Indian Recipes,Lunch,Vegetarian
Zucchini Lasagna Recipe,"Green Zucchini, Homemade Pizza And Pasta Sauce, Onion, Basil Leaves, Extra Virgin Olive Oil, Dried Oregano, Mozzarella Cheese, Paneer, Garlic, Salt, Black Pepper Powder",11,10,90,100,4,Italian Recipes,Dinner,Vegetarian
Mutton Shami Kebab Recipe,"Mutton, Chana Dal, Turmeric Powder, Garlic, Ginger, Green Chilli, Onion, Mint Leaves, Salt, Ghee, Dry Red Chilli, Black Pepper Powder, Cloves, Cinnamon Stick, Cardamom, Fennel Seeds, Ajwain",17,25,120,145,4,North Indian Recipes,Appetizer,Non Vegeterian
Konkan Style Vali Bhajji Ambat Recipe-Spiced Malabar Spinach Dal,"Spinach Leaves, Arhar Dal, Onion, Tomato, Tamarind, Turmeric Powder, Jaggery, Salt, Fresh Coconut, Coriander, Dry Red Chilli, Mustard Seeds, Garlic, Sunflower Oil",14,10,45,55,4,Konkan,Dinner,High Protein Vegetarian
Kambu Murukku ,"Millet Flour, Wheat Flour, Of Kalonji Seeds, Green Chilli, Garlic, Butter, Salt, Curd, Water, Oil",10,10,20,30,4,South Indian Recipes,Snack,Vegetarian
Garlic Naan Without Yeast Recipe,"Whole Wheat Flour, All Purpose Flour, Garlic  Groundpaste, Butter, Curd, Milk, Baking Powder, Baking Soda, Coriander, Salt",10,40,20,60,4,North Indian Recipes,Dinner,Vegetarian
Coconut Ladoo Stuffed With Pistachios Recipe,"Condensed Milk, Dessicated Coconut, Rose Water, Pistachios, Ghee Grease Palms When Rolling Ladoos",5,10,30,40,10,Indian,Snack,Vegetarian
Whole Wheat Buttermilk Vanilla Waffles Recipe,"Whole Wheat Flour, Baking Powder, Salt, Whole Eggs, Vanilla Extract, Curd, Sunflower Oil, Maple Syrup, Fresh Fruits Apples For Serving",9,10,30,40,4,Continental,World Breakfast,Eggetarian
Avocado Parsley Pasta Salad Recipe,"Conchiglie Pasta, Avocados, Parsley Leaves, Garlic, Lemon Juice, Salt, Whole Black Peppercorns, Extra Virgin Olive Oil, Tomato, Del Monte Whole Corn Kernels",10,10,20,30,3,Italian Recipes,Side Dish,Vegetarian
Coleslaw Salad on Sliced Apple Recipe,"Apple, Purple Cabbage, Potato, Walnuts, Dried Oregano, Red Chilli Flakes, Honey, Tabasco Original, Hung Curd, Stalks Spring Onion, Lemon, Salt",12,20,0,20,4,Continental,Appetizer,Vegetarian
Arbi Ka Saag Recipe,"Colocasia Root, Sunflower Oil, Mustard Seeds, Asafoetida, Green Chilli, Ginger Garlic Paste, Onion, Curd, Red Chilli Powder, Turmeric Powder, Coriander Powder, Salt, Water, Coriander",14,10,10,20,2,North Indian Recipes,Lunch,Vegetarian
Waffled Falafels and Vegetables Recipe,"Kabuli Chana, Kabuli Chana, Onion, Garlic, Parsley Leaves, Coriander, Cumin Powder, Coriander Powder, Lemon Juice, Dry Red Chilli, Whole Black Peppercorns, Sun Dried Tomato, Salt, Cauliflower, Kaddu, Red Onion, Green Olives, Beetroot, Mooli Mullangi, Lettuce Leaves, Extra Virgin Olive Oil, Lemon Juice, Black Pepper Powder, Salt, Tahini, Garlic, Lemon Juice, Black Pepper Powder, Salt",29,10,45,55,3,Mediterranean,Dinner,High Protein Vegetarian
Rajasthani Hare Chane Ka Halwa ,"Make  Green, Sugar, Ghee, Cardamom, Ghee, Pistachios, ",7,5,45,50,4,Rajasthani,Dessert,Vegetarian
Butter Garlic Naan Recipe - Garlic Flavoured Flatbread,"All Purpose Flour, Active Dry Yeast, Curd, Salt, Sugar, Garlic, Butter, Lukewarm Water, Garlic, Coriander, Mint Leaves, Butter",12,240,30,270,12,North Indian Recipes,Lunch,Vegetarian
Garlic Dal ,"Arhar Dal Moong Dal, Tamarind Paste, Green Chilli, Garlic, Salt, Oil, Mustard, Curry Leaves, Green Coriander",9,10,30,40,2,North Indian Recipes,Lunch,High Protein Vegetarian
Tamter Wangun Recipe,"Brinjal, Tomato, Sunflower Oil, Cumin Seeds, Asafoetida, Turmeric Powder, Dry Ginger Powder, Kashmiri Red Chilli Powder, Water, Salt",10,20,60,80,4,Indian,Lunch,Vegetarian
Baingan Methi Ka Bharta Recipe with Pomegranates,"Methi Leaves, Brinjal, Ginger, Onion, Tomato, Green Chilli, Turmeric Powder, Garam Masala Powder, Coriander Powder, Butter, Red Chilli Powder, Salt, Sunflower Oil, Anardana Powder",14,10,40,50,4,Punjabi,Lunch,Vegetarian
Spicy Neer Dosa Recipe,"Broken Raw Rice, Fresh Coconut, Salt, Sunflower Oil Grease The Pan, Coriander, Methi Seeds, Cumin Seeds, Dry Red Chilli",8,60,35,95,4,Mangalorean,South Indian Breakfast,Vegetarian
Spaghetti Pasta In Green Olive Pesto Sauce Recipe,"Spaghetti Pasta, Green Olive Pesto, Whole Black Peppercorns, Parmesan Cheese, Lemon Zest, Green Olives, Extra Virgin Olive Oil, Lemon Juice",8,15,15,30,2,Italian Recipes,Dinner,Vegetarian
Tamatar Pyaz Ki Sabzi Recipe -Tomato Onion Sabzi,"Tomato, Onion, Green Chilli, Garlic, Turmeric Powder, Red Chilli Powder, Salt, Mustard Seeds, Curry Leaves, Mustard Oil, Bay Leaves, Cloves, Cinnamon Stick",13,10,30,40,4,North Indian Recipes,Side Dish,Vegetarian
Rajasthani Style Oliya Recipe (Sweetened Rice Yogurt Pudding Recipe),"Cooked Rice, Curd, Sugar, Milk, Cardamom Powder, Cashew Nuts, Saffron Strands",7,10,25,35,4,Rajasthani,Dessert,Vegetarian
Mexican Style Vegetarian Chimichanga Recipe-Deep Fried Burrito,"Carrot, Green Bell Peppers, Onion, Green Chilli, Roasted Tomato Pasta Sauce, Garlic, Brown Rice, Pickled Jalapenos, Red Chilli Flakes, Red Chilli Powder, Dry Ginger Powder, Black Pepper Powder, Salt, Whole Wheat Flour, Salt, Baking Powder, Butter",17,15,30,45,4,Mexican,Lunch,Vegetarian
Surti Obbattu Recipe - Fruit & Nut Pooris In Saffron Milk,"Sooji, All Purpose Flour, Ghee, Sunflower Oil, Rose Petals, Badam, Cashew Nuts, Sultanas, Gulkand, Cardamom Powder, Fresh Coconut  Grated, Sugar, Milk, Sugar, Saffron Strands, Milk, Sugar, Saffron Strands, Badam",19,10,60,70,4,Karnataka,Dessert,Vegetarian
Togarikalu Akki Recipe - Karnataka Style Rice Rava Upma with Fresh Pigeon Peas,"Rice Rava, Fresh Green Toor Dal, Fresh Coconut, Mustard Seeds, White Urad Dal, Chana Dal, Asafoetida, Dry Red Chilli, Curry Leaves, Sunflower Oil, Salt, Arhar Dal, Cumin Seeds, Whole Black Peppercorns",14,5,15,20,4,Karnataka,South Indian Breakfast,Vegetarian
Easy Potato Kurma Recipe,"Potato, Onion, Tomato, Bay Leaf, Cinnamon Stick, Ginger Garlic Paste, Turmeric Powder, Red Chilli Powder, Coriander Powder, Garam Masala Powder, Sunflower Oil, Salt, Fennel Seeds, Cumin Seeds, Fresh Coconut",15,10,35,45,4,South Indian Recipes,Lunch,Vegetarian
Suva Methi Baingan Sabzi Recipe ( Eggplant in Dill and Methi leaves Curry Recipe),"Small Brinjal, Kasuri Methi, Dill Leaves, Garlic, Green Chilli, Ginger, Tomato, Mustard Oil, Mustard Seeds, Fennel Seeds, Cumin Seeds, Asafoetida, Salt",13,10,25,35,4,North Indian Recipes,Lunch,Vegetarian
Matki Chi Rassa Bhaji Recipe (Maharashtrian Style Moth Beans Cooked with Goda Masala),"Moth Dal, Onion, Tomato, Garlic, Ginger, Red Chilli Powder, Turmeric Powder, Maharashtrian Goda Masala, Mustard Seeds, Cumin Seeds, Curry Leaves, Coriander, Sunflower Oil, Salt",14,10,20,30,4,Maharashtrian Recipes,Side Dish,High Protein Vegetarian
Cream Cheese Swirl Brownies Recipes,"Britannia Cheese Spread  Classic  At Room Temperature, Caster Sugar, Vanilla Extract, Whole Egg, Butter, Dark Chocolate, Caster Sugar, Vanilla Extract, Large Whole Eggs, All Purpose Flour, Salt",11,15,35,50,16,Continental,Dessert,Vegetarian
Aloo Amritsari ,"Potato, Celery, Onion, , Garlic, Tomato, Turmeric Powder, Small Spoon Garam Masala Powder, Coriander Powder, Kashmiri Red Chilli Powder, Coriander, Salt, Oil",13,15,30,45,4,Punjabi,Lunch,Vegetarian
Karela Aur Baingan Ki Sabzi Recipe - Bitter Gourd Brinjal Sabzi,"Karela, Brinjal, Onion, Mustard Seeds, Cumin Seeds, Methi Seeds, Turmeric Powder, Red Chilli Powder, Amchur, Salt, Sunflower Oil",11,10,15,25,3,North Indian Recipes,Lunch,Vegetarian
Greek Style Briami Recipe (Simple Vegetable Stew Recipe),"Green Zucchini, Brinjal, Potato, Carrots, Onion, Cauliflower, White Broad Beans, Tomato, Garlic, Stalks Celery, Parsley Leaves, Black Pepper Powder, Salt, Extra Virgin Olive Oil",14,15,45,60,4,Greek,Main Course,Vegetarian
South Indian Style Sorakkai Kootu Recipe - Bottle Gourd Cooked with Lentils,"Bottle Gourd, Yellow Moong Dal, Turmeric Powder, Fresh Coconut, Cumin Seeds, Red Chilli Powder, Sunflower Oil, Mustard Seeds, White Urad Dal, Dry Red Chilli, Asafoetida, Curry Leaves",12,10,30,40,4,South Indian Recipes,Side Dish,Diabetic Friendly
Thatta Payaru Sambar Recipe - Black Eyed Beans Sambar,"Black Eyed Beans, Arhar Dal, Onion, Tomato, Sambar Powder, Red Chilli Powder, Turmeric Powder, Salt, Garlic, Coriander, Sunflower Oil, Asafoetida, Dry Red Chilli, Methi Seeds, Mustard Seeds, White Urad Dal",16,10,40,50,4,South Indian Recipes,Lunch,High Protein Vegetarian
Wheat Rava Halwa Recipe,"Broken Wheat, Brown Sugar, Jaggery, Ghee, Cardamom Powder",5,10,20,30,3,North Indian Recipes,Dessert,Vegetarian
Kerala Style Vendakkai Pachadi ,"Okra, Green Chilli, Curd, Curry Leaves, Coconut, Cumin Seeds, Mustard, Dry Red Chili, Oil, Salt",10,25,40,65,4,Kerala Recipes,Dinner,Vegetarian
Jaggery Sweetened Apple Oatmeal Recipe,"Apple, Instant Oats, Jaggery, Cinnamon Powder, Ginger, Nutmeg Powder, Vanilla Extract, Water, Milk, Hazelnut, Raisins, Sesame Seeds, Apple",13,5,25,30,3,Indian,World Breakfast,Vegetarian
Sobji Diye Bhaja Muger Dal Recipe - Bengali Style Moong Dal with Winter Vegetables,"Yellow Moong Dal, Turmeric Powder, Cauliflower, Green Peas, Green Beans, Kaddu, Ginger, Cumin Seeds, Bay Leaf, Cinnamon Stick, Cloves, Cardamom, Dry Red Chilli, Sugar, Ghee, Salt",16,10,40,50,4,Bengali Recipes,Lunch,Vegetarian
Healthy Pumpkin Carrot Idli Recipe,"Idli Dosa Batter, Kaddu, Carrots",3,10,20,30,6,South Indian Recipes,South Indian Breakfast,Vegetarian
Breakfast Bar Recipe With Berries Quinoa & Oats,"Quinoa, Instant Oats, Oat Bran, Wheat Bran, Peanut Butter, Honey, Cranberries Raisins, Badam",8,10,10,20,6,Continental,World Breakfast,Vegetarian
Rajasthani Ghasela Recipe (Besan Ka Pitta),"Sunflower Oil, Cumin Seeds, Asafoetida, Onion, Green Chilli, Spring Onion Greens, Gram Flour, Coriander, Red Chilli Powder, Turmeric Powder, Salt",11,10,20,30,4,Rajasthani,Lunch,Vegetarian
Zucchini And Bell Pepper Stir Fry Recipe,"Green Zucchini, Red Bell Pepper, Onion, Garlic, Fresh Thyme Leaves, Dried Oregano, Red Chilli Flakes, Extra Virgin Olive Oil, Salt",9,5,10,15,4,Continental,Side Dish,Vegetarian
Haldi Ki Sabzi Recipe,"Turmeric, Flour, Curd, Ginger, Green Chilli, Coriander Powder, Garam Masala Powder, Coriander, Salt, Black Pepper Powder, Curry Leaves, Mustard",12,25,30,55,5,Rajasthani,Side Dish,Vegetarian
Erode Pallipalayam Chicken Fry Recipe,"Chicken Breasts, Pearl Onion, Garlic, Dry Red Chilli, Red Chilli Powder, Turmeric Powder, Curry Leaves, Coriander, Salt, Coconut Oil",10,10,45,55,4,Tamil Nadu,Side Dish,High Protein Non Vegetarian
Cauliflower Coconut Milk Stew ,"Cabbage, Garlic, Bay Leaf, Cardamom, Whole Black Pepper, Red Chilli Powder, Turmeric Powder, Tomato Puree, Coconut Milk, Salt, S Of Coriander, Oil",12,10,40,50,4,South Indian Recipes,Lunch,Vegetarian
Oven Baked Sweet Potato Fries Recipe,"Sweet Potato, Extra Virgin Olive Oil, Garlic, Paprika Powder, Fresh Herbs, Corn Flour, Rock Salt",7,10,40,50,4,Continental,Snack,Vegetarian
Raw Mango Cucumber Salad Recipe,"Raw Mango, Cucumber, Peanut, Salt",4,20,0,20,4,Indian,Side Dish,Vegetarian
Kesar Shahi Tukda With Rabdi Recipe (Saffron Bread Pudding With Spiced Milk Custard),"Whole Wheat Brown Bread, Ghee, Rabri, Mixed Nuts, Sugar, Water, Cardamom Powder, Saffron Strands",8,10,75,85,3,North Indian Recipes,Dessert,Vegetarian
Urulaikizhangu Podi Poriyal Recipe (Spicy Potato Sabzi from Tamil Nadu),"Potato, Sesame, Sesame, Dry Red Chilli, Chana Dal, White Urad Dal, Arhar Dal, Asafoetida, Salt",9,10,25,35,4,Tamil Nadu,Lunch,Vegetarian
"Mango, Avocado And Chickpea Salad Recipe","Mango, Avocado, Kabuli Chana, Red Romaine Lettuce, Lemon Juice, Extra Virgin Olive Oil, Dry Red Chilli, Salt And Pepper",8,15,10,25,3,Continental,Appetizer,Vegetarian
"Mung Bean & Tofu Salad Recipe With Sweet Potatoes, Cucumbers & Tomatoes","Green Moong Sprouts, Tofu, Sweet Potato, Onion, Cucumber, Cherry Tomato, Coriander, Green Chilli, Lemon Juice, Green Chutney, Sweet Chutney, Salt, Lemon Juice, Chaat Masala Powder, Cumin Powder, Coriander Powder, Red Chilli Powder, Fresh Pomegranate Fruit Kernels, Sev, Lettuce Leaves Serve",20,15,10,25,4,Continental,Dinner,High Protein Vegetarian
Begun Basanti Recipe - Eggplant In Mustard Yogurt Curry,"Brinjal, Poppy Seeds, Yellow Mustard Seeds, Curd, Green Chilli, Ginger, Turmeric Powder, Cumin Powder, Red Chilli Powder, Sugar, Salt, Mustard Oil",12,10,30,40,4,Bengali Recipes,Side Dish,Vegetarian
Badshahi Chicken Recipe,"Chicken, Onion, Onion, Ginger, Garlic, Curd, Cashew Nuts, Turmeric Powder, Cumin Powder, Red Chilli Powder, Kashmiri Red Chilli Powder, Green Chilli, Salt, Sugar, Sunflower Oil Cook, Ghee, Milk, Rose Water, Cloves, Cardamom, Cinnamon Stick, Nutmeg, Cardamom, Mace, Black Cardamom",25,10,45,55,3,Indian,Side Dish,Non Vegeterian
Vegetarian Pot Pie Recipe,"Whole Wheat Flour, All Purpose Flour, Butter, Salt, Chilled Water, Fresh Thyme Leaves, Parsley Leaves, Carrots, Green Beans, Green Peas, Corn Kernels, Button Mushrooms, Onion, Garlic, Broccoli Cauliflower Florets, Red Bell Pepper, Yellow Bell Pepper, Potato, Whole Wheat Flour, Vegetable Stock, Bay Leaves, Worcestershire Sauce, Tabasco Original  Hot Sauce   Red Chilli Powder, Fresh Cream, Butter, Sunflower Oil, Fresh Thyme Leaves, Parsley Leaves, Salt, Whole Egg",30,20,90,110,4,Continental,Dinner,Vegetarian
Sweet Potato And Broccoli Sabzi Recipe,"Broccoli, Sweet Potato, Cumin Powder, Turmeric Powder, Salt, Kalonji, Sunflower Oil, Red Chilli Powder, Salt",9,10,30,40,4,North Indian Recipes,Lunch,Vegetarian
Alfredo Spaghetti with Roasted Mushroom & Broccoli Recipe,"Classic Alfredo Pasta Sauce, Garlic, Button Mushrooms, Broccoli, Dried Oregano, Red Chilli Flakes, Salt And Pepper",7,15,45,60,4,Italian Recipes,Main Course,Vegetarian
Andhra Style Mirapakaya Bajji Recipe - Stuffed Chilli Recipe,"Badi Hari Mirch, Roasted Gram Dal, Red Chilli Powder, Cumin Powder, Ajwain, Chaat Masala Powder, Tamarind, Asafoetida, Salt, Gram Flour, Rice Flour, Red Chilli Powder, Enos Fruit Salt, Asafoetida, Salt, Sunflower Oil, Onion, Coriander",18,10,30,40,4,Andhra,Snack,Vegetarian
Pudina Quinoa Recipe,"Quinoa, Onion, Garlic, Green Chilli, Cinnamon Stick, Cloves, Cardamom, Mint Leaves, Salt, Ghee",10,10,20,30,4,Indian,Lunch,Vegetarian
Sprouted Ragi Chicken Cutlet Recipe,"Ragi Seeds, Boneless Chicken, Potato, Carrots, Instant Oats, Onion, Garlic, Ginger, Green Chilli, Garam Masala Powder, Cumin Powder, Black Pepper Powder, Coriander, Salt",14,20,25,45,4,Indian,Snack,High Protein Non Vegetarian
Homemade Ice-Cream Cake Recipe,"Chocolate Ice Cream, Vanilla Ice Cream, Strawberry Cake  A  Strawberry Cake, Decorative Sugar, Chocolate Chips, Whole Eggs, Sunflower Oil, All Purpose Flour, Sugar, Vanilla Extract, Baking Powder, Strawberry Essense, Milk",13,20,25,45,4,Indian,Snack,High Protein Non Vegetarian
One Pot Pav Bhaji Recipe Using Preethi Electric Pressure Cooker,"Pav Buns, Onion, Coriander, Onion, Ginger, Garlic, Tomato, Green Bell Pepper, Carrots, Cabbage, Potato, Pav Bhaji Masala, Chaat Masala Powder, Green Peas, Lemon Juice, Butter, Salt",17,20,35,55,4,North Indian Recipes,One Pot Dish,High Protein Non Vegetarian
Cuban Black Bean Salad Recipe,"Canned Black Beans, Tomato, Red Yellow And Green Bell Peppers, Red Onion, Sweet Corn, Dried Oregano, Parsley Leaves, Salt, Extra Virgin Olive Oil, Fresh Orange Juice, Garlic, Orange Zest, Dried Oregano, Cumin Powder, Black Pepper Powder, Salt",16,0,20,20,4,Continental,Snack,High Protein Vegetarian
Kollu Masala Dosa Recipe - High Protein Horse Gram Dosa,"Rice, Horse Gram Dal, Methi Seeds, Water Make The Batter, Sunflower Oil, Salt, Potato, Onion, Mustard Seeds, Curry Leaves, Turmeric Powder, Red Chilli Powder, Green Chilli, Coriander, Sunflower Oil",15,930,30,960,4,Konkan,South Indian Breakfast,Vegetarian
Stir Fried Green Amaranth Leaves ,"Amaranth Leaves, Khus Khus, Peanuts, Dry Red Chilli, Buds Garlic, Ginger, Cumin Powder, Salt, Mustard Oil",9,15,30,45,2,Bengali Recipes,Lunch,Vegetarian
Kashmiri Style Haak T Thool Recipe - Greens Cooked With Eggs,"Greens, Mustard Oil, Whole Eggs, Asafoetida, Dry Red Chilli, Green Chilli, Sunflower Oil",7,30,30,60,4,Kashmiri,Lunch,Eggetarian
Savoury Baked Arbi Chips Recipe,"Colocasia Root, Extra Virgin Olive Oil Toss, Salt, Black Pepper Powder, Amchur",5,5,20,25,4,Indian,Snack,Vegetarian
Gujarati Vaghareli Mag Recipe - Whole Green Moong Dal Sabzi Recipe,"Green Moong Dal, Cumin Seeds, Curry Leaves, Ginger, Green Chilli, Turmeric Powder, Lemon, Coriander, Sunflower Oil, Salt",10,400,30,430,4,Gujarati Recipesï»¿,Lunch,High Protein Vegetarian
Gujarati Adadiya Ladwa Recipe - Urad Dal Halwa with Nuts & Spices,"Urad Dal Flour, Ghee, Milk, Sugar, Khoya, Gond, Raisins, Cashew Nuts, Badam, Pistachios, Dry Ginger Powder, Cardamom Powder, Cinnamon Powder, Cloves, Black Pepper Powder, Peepramul Powder, Badam",17,0,45,45,4,Gujarati Recipesï»¿,Dessert,Vegetarian
Mung Bean Sprouts Salad Recipe With Brussel Sprouts and Pomegranate,"Green Moong Sprouts, Fresh Pomegranate Fruit Kernels, Brussel Sprouts, Cranberries, Honey, Green Chilli, Lemon, Salt And Pepper",8,15,0,15,3,Fusion,Appetizer,High Protein Vegetarian
Badam Pottukadalai Ladoo Recipe - Almond Chana Dal Ladoo,"Roasted Gram Dal, Jaggery, Cardamom Powder, Almond Meal, Ghee",5,20,20,40,4,Indian,Dessert,Vegetarian
Konkani Style Sol Kadhi Recipe - Kokum Flavored Coconut Curry,"Kokum, Fresh Coconut, Coriander, Cumin Seeds, Mustard Seeds, Dry Red Chilli, Curry Leaves, Asafoetida, Garlic",9,10,10,20,4,Konkan,Lunch,Vegetarian
Kokum Saar Recipe - Traditional Maharashtrian Kokum Drink,"Kokum, Water, Jaggery, Ghee, Cumin Seeds, Dry Red Chilli  Broken Green Chilli, Asafoetida, Curry Leaves, Coriander, Salt",10,10,20,30,2,Maharashtrian Recipes,Side Dish,Vegetarian
Lemon Oats Recipe,"Instant Oats, Water, Onion, Curry Leaves, Green Chilli, Ginger, Lemon Juice, Sunflower Oil, Mustard Seeds, Cumin Seeds, White Urad Dal, Chana Dal, Asafoetida, Turmeric Powder, Salt, Coriander, Roasted Peanuts",17,10,20,30,2,Indian,Indian Breakfast,Vegetarian
Marrakesh Vegetable Curry Recipe,"Green Beans, Carrot, Sweet Potato, Brinjal, Green Zucchini, Red Yellowgreen Bell Pepper, Onion, Spinach, Garlic, Cinnamon Stick, Curry Powder, Turmeric Powder, Fresh Orange Juice, Badam, Raisins, Black Pepper Powder, Sunflower Oil",17,15,20,35,4,African,Main Course,Vegetarian
Chilli Cheese Paratha Recipe,"Britannia Cheese Block, Green Chilli, Onion, Mint Leaves, Cumin Powder, Whole Wheat Flour, Kalonji, Salt, Ghee Smear While Cooking",9,20,30,50,4,North Indian Recipes,Dinner,Vegetarian
Chicken Sholay Kebab Recipe,"Boneless Chicken, Curry Leaves, Ginger, Garlic, Green Chilli, Rice Flour, All Purpose Flour, Gram Flour, Kashmiri Red Chilli Powder, Salt, Sambar Powder, Cumin Powder, Coriander Powder, Sunflower Oil",14,10,20,30,4,South Indian Recipes,Appetizer,Non Vegeterian
Moolangi Tovve Recipe,"Radishes, Yellow Moong Dal, Turmeric Powder, Green Chilli, Ginger, Coconut, Ghee, Mustard, Dry Red Chilli, Asafetida, Coriander Leaves, Lemon",12,10,30,40,4,South Indian Recipes,Lunch,Vegetarian
Kongunadu Kathirikai Rasam Recipe - Spicy & Tangy Eggplant Rasam,"Small Brinjal, Tomato, Tamarind Water, Turmeric Powder, Salt, Coriander, Arhar Dal, Cumin Seeds, Dry Red Chilli, Garlic, Whole Black Peppercorns, Curry Leaves, Coriander, Ghee, Mustard Seeds, Dry Red Chilli, Curry Leaves, Asafoetida",18,10,30,40,4,South Indian Recipes,Dinner,Vegetarian
Beetroot Poriyal ,"Beetroot, Mustard, Cumin Seeds, White Urad Dal, Curry Leaves, Asafoetida, Turmeric Powder, Coconut, Oil, Salt, Small Onion, Green Chilli",12,10,30,40,4,South Indian Recipes,Lunch,Vegetarian
Tomato Onion Chutney Recipe,"Tomato, Small Onion, Green Chili, Asafoetida, Turmeric Powder, Sesame Oil Any Oil, Salt, Sesame Oil, Rye Any Oil, White Urad Dal, Curry Leaves",11,10,15,25,4,South Indian Recipes,Side Dish,Vegetarian
Kesar Peda Recipe,"Khoya, Sugar, Saffron Strands, Milk, Cardamom Powder, Pistachios, Ghee",7,15,30,45,12,Indian,Dessert,Vegetarian
Mushroom Methi Brown Rice Recipe,"Brown Rice, Button Mushrooms, Methi Leaves, Onion, Tomato, Green Chilli, Garlic, Red Chilli Powder, Coriander Powder, Turmeric Powder, Salt, Sunflower Oil",12,40,15,55,12,Indian,Lunch,Vegetarian
South Indian Onion Chutney Recipe,"Onion, Cumin Seeds, Black Urad Dal, Tamarind Paste, Dry Red Chilli, Jaggery, Sunflower Oil, Salt, Mustard Seeds, Curry Leaves, Sunflower Oil",11,20,20,40,4,South Indian Recipes,Side Dish,Vegetarian
The Paruppu Podi Recipe - South Indian Spiced Dal Chutney Powder,"Arhar Dal, Chana Dal, Dry Red Chilli, Whole Black Peppercorns, Cumin Seeds, Curry Leaves, Asafoetida, Salt",8,15,15,30,6,South Indian Recipes,Side Dish,Vegetarian
Ruote Pasta & Eggplant Gratin Recipe,"Route Pasta, Extra Virgin Olive Oil, Sweet Corn, Del Monte Black Olives  Halved, Tomato Basil Pasta Sauce, Red Bell Pepper, Onion, Garlic  Minced, Soy Granules, Brinjal, Red Chilli Flakes, Whole Black Peppercorns  Crushed, Basil Leaves, Parsley Leaves, Gouda Cheese, Whole Wheat Bread Crumbs",16,20,50,70,4,Italian Recipes,Dinner,Vegetarian
Barnyard Millet Bisi Bele Bath Recipe,"Bisi Bele Bhat Spice Powder, Pearl Onion, Green Bell Pepper, Carrots, Green Peas, Green Beans, Potato, Drumstick, Tomato, Tamarind Water, Jaggery, Salt, Barnyard Millet, Arhar Dal, Turmeric Powder, Salt, Ghee, Mustard Seeds, Cumin Seeds, Dry Red Chilli, Curry Leaves, Coriander",22,20,90,110,4,South Indian Recipes,Lunch,Vegetarian
Maharashtrain Amti Recipe,"Arhar Dal, Turmeric Powder, Water, Maharashtrian Goda Masala, Tamarind, Jaggery, Salt, Coriander, Sunflower Oil, Ghee, Mustard Seeds, Cumin Seeds, Asafoetida, Curry Leaves, Green Chilli",15,10,45,55,2,Maharashtrian Recipes,Lunch,High Protein Vegetarian
Onion Bajji Recipe -Vengaya Bajji/ South Indian Onion Pakora,"Onion, Gram Flour, Turmeric Powder, Red Chilli Powder, Ajwain, Asafoetida, Salt",7,5,10,15,4,Indian,Snack,Vegetarian
Khichdi Roti Recipe,"Khichdipongal, Rice Flour As Needed, Sunflower Oil, Onion, Salt",5,0,15,15,4,Indian,Indian Breakfast,Vegetarian
Foxtail Millet Rava Idli Recipe,"Foxtail Millet, Curd, Carrot, Green Chilli, Ginger, Enos Fruit Salt, Coriander, Water, Salt, Sunflower Oil, Mustard Seeds, White Urad Dal, Chana Dal, Cashew Nuts, Curry Leaves",15,25,15,40,4,South Indian Recipes,South Indian Breakfast,Diabetic Friendly
Besan Oats Ladoo Recipe,"Gram Flour, Instant Oats, Sugar, Cardamom Powder, Ghee, Pistachios  Coarsely Powdered",6,25,15,40,4,Indian,Dessert,Vegetarian
Ada Pradhaman Recipe With Homemade Ada- Kerala Special Payasam Recipe,"Jaggery, Coconut Milk, Cardamom, Ghee, Rice Flour, Hot Water, Salt, Banana Leaf, Sunflower Oil, Cashew Nuts, Fresh Coconut, Raisins, Ghee",13,10,35,45,3,South Indian Recipes,Dessert,Vegetarian
Spicy Pickled Paneer Gravy ,"Paneer, Ghee Oil, Pickle, Onion, Ginger Garlic Paste, Red Chili Powder, Turmeric Powder, Cumin Powder, Garam Masala Powder, Celery, Fennel, Water, Capsicum, Tomato Puree, Teaspoon Kasuri Methi, Salt, Few Branch Green Coriander",17,30,30,60,4,North Indian Recipes,Lunch,High Protein Vegetarian
Grilled Herring With Kasundi Mustard And Wild Celery Recipe,"Herring Fish Steaks, Ginger Garlic Paste, Apple Cider Vinegar, Extra Virgin Olive Oil, Celery, Kasundi Mustard Sauce, Lemon Juice, Salt, Red Chilli Flakes",9,10,10,20,4,Continental,Dinner,High Protein Non Vegetarian
Creamy Coconut Poached Pears Recipe,"Coconut Milk, Coconut Sugar, Pears, Cinnamon Stick, Cardamom, Slivered Almonds",6,20,30,50,4,Continental,Dessert,Vegan
Mutton Dak Bungalow Curry Recipe,"Mutton, Curd, Ginger Garlic Paste, Red Chilli Powder, Kashmiri Red Chilli Powder, Turmeric Powder, Mustard Oil, Whole Eggs, Potato, Mustard Oil, Ghee, Radhuni, Methi Leaves, Bay Leaf, Onion, Tomato, Ginger, Garlic  Paste, Salt, Cinnamon Stick, Cardamom, Black Cardamom, Mace, Nutmeg Powder, Cumin Seeds, Coriander, Green Chilli, Dry Red Chilli, Whole Black Peppercorns",29,480,60,540,2,Indian,Dinner,Non Vegeterian
French Brioche Recipe (Savoury Version),"All Purpose Flour, Salt, Active Dry Yeast, Sugar, Whole Eggs, Butter, Milk, Homemade Pizza And Pasta Sauce, Milk, Sunflower Oil",10,180,70,250,2,French,Snack,Eggetarian
Karnataka Style Avarekalu Huli Saru Recipe (Field Beans in a Coconut based Gravy Recipe),"Avarekalu  Lilva Beans, Potato, Brinjal, Garlic, Pearl Onion, Tomato, Salt, Tamarind, Fresh Coconut, Red Chilli Powder, Coriander, Turmeric Powder, Coriander, Mustard Seeds, Cumin Seeds, White Urad Dal, Curry Leaves, Sunflower Oil",18,15,20,35,4,Karnataka,Lunch,Vegetarian
Spicy Mexican Salsa Verde Recipe - Green Tomato Salsa,"Tomatillo Green Raw Tomato, Green Chilli, Coriander, Lemon Juice, Sugar, Extra Virgin Olive Oil, Salt",7,15,20,35,4,Mexican,Dinner,Vegetarian
Gobi Ke Kofte ,"Ginger Garlic Paste, Curd, Onion, Bay Leaves, Big Cardamom, Lentil Sugar, Red Chilli Powder, Turmeric Powder, Coriander Powder, Salt, Oil, Water, Of Green Coriander, Cabbage, Flour, Red Chilli Powder, Green Chilli, Salt, Water, Oil",20,15,60,75,4,North Indian Recipes,Lunch,Vegetarian
Jerk Chicken With Rice And Peas Pilaf Recipe,"Chicken, Sunflower Oil, Barbeque Sauce Bottle Jerk Barbecue Sauce, Spring Onion, Lemon Juice, Basmati Rice, Green Peas, Coconut Milk, Spring Onion, Fresh Thyme Leaves, Garlic, Bay Leaf, All Spice Powder",13,20,45,65,2,Caribbean,Main Course,High Protein Non Vegetarian
Tomato Basil Pasta And Pizza Sauce Recipe,"Blanched Tomato, Extra Virgin Olive Oil, Garlic, Onion, Basil Leaves, Salt, Whole Black Peppercorns, Sugar",8,10,30,40,2,Italian Recipes,Vegetarian,High Protein Non Vegetarian
Matar Keema ,"Green Peas, Potato, Cheese, Tomato, Asafoetida, Onion, Ginger Garlic Paste, Red Chilli Powder, Turmeric Powder, Coriander Leaves, Coriander Powder, Garam Masala Powder, Oil, Water, Salt",15,35,30,65,4,North Indian Recipes,Lunch,Vegetarian
Foxtail Millet Pilaf Recipe,"Foxtail Millet, Button Mushrooms, Cinnamon Stick, Cardamom, Onion, Garlic, Dried Oregano, Rosemary, Black Pepper Powder, Turmeric Powder, Prunes, Raisins, Salt",13,10,30,40,4,Middle Eastern,Lunch,Diabetic Friendly
Sindhi Kadhi ,"Arhar Dal, Tomato, Okra, Oil, Fenugreek Seeds, Mustard, Dry Red Chilli, Curry Leaves, Asafetida, Gram Flour, Red Chilli Powder, Tamarind Paste, Turmeric Powder, Jaggery, Salt",15,10,60,70,2,Sindhi,Lunch,High Protein Vegetarian
Togarikaayi Usli Recipe,"Green Tur Dal, Oil, Green Chilies, Garlic, Green Coriander, Salt, Butter, Mustard",8,10,30,40,4,North Karnataka,Lunch,High Protein Vegetarian
Kothavarangai Poriyal Recipe - South Indian Style Cluster Beans Sabzi,"Gawar Phali, Onion, Mustard Seeds, Dry Red Chilli, Curry Leaves, Asafoetida, Fresh Coconut, Green Chilli, Sunflower Oil, Salt",10,10,15,25,4,South Indian Recipes,Lunch,Vegetarian
Kachcha Kela Masala Sabzi Recipe (Raw Banana with Tomatoes & Spices),"Raw Banana, Tomato, Ginger, Bay Leaves, Turmeric Powder, Asafoetida, Coriander Powder, Garam Masala Powder, Red Chilli Powder, Salt",10,10,40,50,4,Indian,Lunch,Vegetarian
Goan Moolyacho Ross,"Radishes, Pigeonpea, Onion, Coconut, Green Chilli, Dry Red Chilli, Coriander Seeds, Tamarind, Jaggery, Salt",10,20,30,50,4,Goan Recipes,Lunch,Vegetarian
Coconut Chia Pudding Recipe,"Chia Seeds, Tender Coconut Water, Coconut Milk, Orange, Blueberries, Pistachios, Honey, Mint Leaves",8,20,30,50,4,Goan Recipes,Lunch,Vegetarian
Paneer Frankie Recipe - Delicious Kid Friendly Snack,"Whole Wheat Tawa Paratha, Lettuce Leaves, Paneer, Red Bell Pepper, Onion, Del Monte Tandoori Mayo",6,10,30,40,4,Indian,Snack,High Protein Vegetarian
 Beetroot Paneer Curry Recipe In Coconut Milk,"Paneer, Chakundar, Onion, Green Chilli, Ginger, Bud Garlic, Coriander Powder, Turmeric, Garam Masala Powder, Coconut Milk, Oil, Salt, Red Chili Powder",13,15,40,55,4,Indian,Side Dish,High Protein Vegetarian
Rajasthani Gatte Ka Pulao Recipe,"Gram Flour, Ajwain, Red Chilli Powder, Curd, Sunflower Oil, Salt, Cooked Rice, Ghee, Garlic, Onion, Turmeric Powder, Red Chilli Powder, Bay Leaf, Cloves, Cinnamon Stick, Salt, Coriander",17,10,60,70,4,Rajasthani,Lunch,Vegetarian
Paneer Kofta Curry Recipe,"G Paneer, All Purpose Flour, Salt, Coriander, Cumin Powder, Ginger, Honey, Tomato Puree, Coriander Powder, Garam Masala Powder, Turmeric Powder, Hung Yogurt Cream, Fenugreek Seeds, Salt, Oil",15,20,40,60,4,North Indian Recipes,Side Dish,Vegetarian
Chia Seeds Shikanji Recipe,"Chia Seeds, Chilled Water, Ice Cubes, Lemon, Sugar, Black Salt, Cumin Powder, Black Pepper Powder, Mint Leaves",9,30,0,30,4,Indian,Snack,Vegetarian
Spiced Coconut Oatmeal With Assorted Fruits Recipe,"Instant Oats, Lukewarm Water, Coconut Milk, Honey, Cinnamon Powder, Dry Ginger Powder, Ripe Bananas, Dates, Anardana Powder, Walnuts, Salt",11,5,10,15,4,Continental,World Breakfast,Vegetarian
Carrot And Capsicum Rice Recipe,"Cooked Rice, Cumin Seeds, Curry Leaves, Green Chilli, Carrot, Green Bell Pepper, Onion, Red Chilli Powder, Black Pepper Powder, Ghee, Coriander, Salt",12,20,45,65,2,Indian,Lunch,Vegetarian
South Indian One Pot Sambar Rice Recipe,"Ghee, Chana Dal, White Urad Dal, Coriander, Methi Seeds, Mustard Seeds, Dry Red Chilli, Fresh Coconut, Rice, Pink Masoor Dal, Potato, Green Beans, Bottle Gourd, Onion, Ghee, Sunflower Oil, Mustard Seeds, Cumin Seeds, Dry Red Chilli, Green Chilli, Asafoetida, Turmeric Powder, Tamarind Water, Jaggery, Water, Salt, Coriander",27,20,45,65,4,South Indian Recipes,Main Course,Vegetarian
Pineapple and Dill Granita Recipe,"Pineapple, Dill Leaves, Sugar, Water, Ice Cubes",5,10,260,270,2,Italian Recipes,Dessert,Vegetarian
Spicy Lemon Chilli Paneer Tart With Curry Leaves Recipe,"All Purpose Flour, Butter, Icing Sugar, Whole Egg, Salt, Paneer, Green Bell Pepper, Onion, Garlic, Green Chilli, Spring Onion Greens, Salt, Black Pepper Powder, Turmeric Powder, Green Chilli Sauce, Curry Leaves, Mustard Seeds, Corn Flour, Lemon",19,20,20,40,4,Fusion,Appetizer,Eggetarian
Bajri Ki Roti Recipe,"Bajra Flour, Whole Wheat Flour, Salt, Ghee, Lukewarm Water Bind The Dough",5,15,30,45,5,Indian,Dinner,Diabetic Friendly
Chinese style Black Sesame Nai Huang Bao Recipe (Steamed Custard Buns),"Milk Powder, Coconut Milk, Condensed Milk, Whole Eggs, Sunflower Oil, All Purpose Flour, Black Sesame Seeds, Active Dry Yeast, Lukewarm Water, Sugar, Sunflower Oil",11,10,90,100,4,Chinese,Appetizer,Vegetarian
Kesar Shrikhand Recipe - Greek Yogurt Pudding With Saffron,"Hung Curd, Caster Sugar, Cardamom Powder, Saffron Strands, Pistachios, Fresh Fruits",6,360,30,390,4,Gujarati Recipesï»¿,Dessert,Vegetarian
Matki Chi Usal Recipe - Spicy Moth Sprouted Salad,"Moth Sprouts, Horse Gram Dal, Ajwain, Mustard Seeds, Asafoetida, Red Chilli Powder, Fresh Coconut, Lemon Juice, Salt, Water, Curry Leaves, Dry Red Chilli",12,10,20,30,4,Maharashtrian Recipes,Snack,Vegetarian
Egg Korma Recipe,"Whole Eggs, Sunflower Oil, Cumin Seeds, Onion, Green Chilli, Tomato, Ginger Garlic Paste, Red Chilli Powder, Turmeric Powder, Coriander Powder, Garam Masala Powder, Coconut Milk, Salt, Coriander",14,10,20,30,4,Indian,Side Dish,Eggetarian
Raw Tomato Chutney ,"Tomato, Green Chilli, Garlic, Fenugreek Seeds, Salt, Jaggery, Curry Leaves, Onion, Mustard, Oil",10,20,20,40,4,South Indian Recipes,Side Dish,Vegetarian
Broccoli Rava Idli Recipe,"Polenta, Sooji, Broccoli, Cashew Nuts, Curd, Water, Green Chilli, Ginger, Asafoetida, Curry Leaves, Mustard Seeds, White Urad Dal, Sunflower Oil, Enos Fruit Salt, Salt",15,20,10,30,4,South Indian Recipes,South Indian Breakfast,Vegetarian
Mushroom & Goat Cheese Omelette with Spinach Recipe,"Whole Eggs, Milk, Button Mushrooms, Dried Oregano, Black Pepper Powder, Salt, Spinach Leaves, Goat Cheese, Butter, Sunflower Oil",10,10,20,30,1,Continental,World Breakfast,Eggetarian
Caramel Folded Plum Cake Recipe,"Mixed Dry Fruits  I Used Apricot, Rum, Sugar, Hot Water, Vivatta Maida, Baking Powder, Baking Soda, Cloves, Cardamom, Cinnamon Powder, Nutmeg Powder, Butter, Sugar, Whole Eggs, Mixed Nuts  I Used Almond, Tutti Frutti, Salt",17,40,60,100,1,Kerala Recipes,Snack,Eggetarian
Chole Capsicum Masala Recipe,"Kabuli Chana, Green Bell Pepper, Onion, Ginger Garlic Paste, Coriander Powder, Red Chilli Powder, Cumin Powder, Turmeric Powder, Kasuri Methi, Cashew Nuts, Homemade Tomato Puree, Sunflower Oil, Salt",13,30,40,70,4,North Indian Recipes,Dinner,Vegetarian
Chocolate Ganache Tart Recipe,"All Purpose Pie Crust, Heavy Whipping Cream, Dark Chocolate, Rock Salt, Fresh Cherries",5,60,60,120,4,Continental,Dessert,Vegetarian
Konkani Style Mooga Ghushi Recipe-Sprouted Whole Green Gram In Tangy Coconut Gravy,"Green Moong Dal, Fresh Coconut, Dry Red Chilli, Tamarind Paste, Coconut Oil, Mustard Seeds, Curry Leaves, Salt",8,10,20,30,2,Konkan,Lunch,Vegetarian
Thai Flavoured Vegetable Noodles In Coconut Curry Recipe,"Egg Noodles, Broccoli, Carrots, Purple Cabbage, Button Mushrooms, Green Peas, Garlic, Fresh Red Chilli, Salt, Sunflower Oil, Coconut Milk, Raw Peanuts, Garlic, Lemon Juice, Thai Red Curry Paste",15,10,20,30,4,Thai,Main Course,Vegetarian
Mambazha Pulissery Recipe - Mango Mor Kuzhambu Recipe,"Mango, Green Chilli, Fresh Coconut, Cumin Seeds, Jaggery, Turmeric Powder, Curd, Coconut Oil, Dry Red Chilli, Curry Leaves, Mustard Seeds, Salt",12,15,45,60,3,Kerala Recipes,Lunch,Vegetarian
Mangalorean Style Sonay Sukka Recipe - Dry Chickpea Stir Fry,"Kabuli Chana, Mustard Seeds, Curry Leaves, Cloves, Onion, Fresh Coconut, Tamarind Water, Sunflower Oil, Salt, Byadagi Dried Chilli, Coriander, Cumin Seeds, Whole Black Peppercorns, Turmeric Powder",14,10,45,55,4,Mangalorean,Lunch,Vegetarian
Masala Mixed Sprouts Sandwich Recipe,"Whole Wheat Brown Bread, Green Moong Sprouts, Masoor Dal, Rajma, Kala Chana, Onion, Onion, Tomato, Garlic, Red Chilli Powder, Chaat Masala Powder, Turmeric Powder, Coriander, Sunflower Oil, Salt",15,10,30,40,4,Indian,Lunch,High Protein Vegetarian
Sindhi Kuneh Ja Bhee Recipe (Lotus Stem Chaat),"Lotus Stem, Red Chilli Powder, Cumin Powder, Chaat Masala Powder, Black Pepper Powder, Amchur, Salt, Onion, Coriander, Green Chutney, Sweet Chutney",11,10,55,65,2,Sindhi,Snack,Vegetarian
Eggless Whole wheat And Orange Almond Cake Recipe,"Whole Wheat Flour, Almond Meal, Condensed Milk, Fresh Orange Juice, Butter, Sunflower Oil, Baking Soda, Baking Powder, Salt, Cinnamon Powder, Vanilla Extract, Buttermilk, Badam, Pistachios, Walnuts",15,0,45,45,6,Continental,Dessert,Vegetarian
"Beetroot, Sweet Potato And Oatmeal Cutlet Recipe","Beetroots, Sweet Potato, Instant Oats, Sweet Corn, Green Chilli, Red Chilli Powder, Amchur, Cumin Powder, Black Salt, Coriander, Ginger, Whole Wheat Bread Crumbs, Sunflower Oil, Salt",14,15,20,35,4,Indian,Appetizer,Vegetarian
Punjabi Lobia Masala Recipe (Punjabi Style Black Eyed Beans Curry),"Black Eyed Beans, Onion, Tomato, Green Chilli, Ginger, Garlic, Cumin Seeds, Cinnamon Stick, Bay Leaves, Cloves, Red Chilli Powder, Turmeric Powder, Cumin Powder, Coriander Powder, Garam Masala Powder, Kasuri Methi, Ginger, Ghee, Salt",19,10,30,40,4,Indian,Dinner,Vegetarian
Delmonte Beetballs Pasta Recipe,"Masoor Dal, Beetroot, Onion, Garlic, Cumin Powder, Coriander Powder, Salt, Whole Wheat Bread Crumbs, Sunflower Oil, Del Monte Spaghetti Pasta, Extra Virgin Olive Oil, Garlic, Dried Oregano, Parsley Leaves, Red Chilli Flakes, Basil Leaves, Parmesan Cheese",17,15,45,60,4,Italian Recipes,Lunch,Vegetarian
Chicken Teriyaki Rice Bowl Recipe,"Chicken Breasts, Sprig Ginger Teriyaki Sauce, Fresh Orange Juice, Corn Flour, Garlic, Spring Onion Greens, Broccoli, Cooked Rice, Garlic, Spring Onion Greens, Black Pepper Powder, Salt, Sunflower Oil",13,60,30,90,2,Japanese,Lunch,High Protein Non Vegetarian
Strawberry Smoothie Bowl with chia seeds and Muesli Recipe,"Instant Oats, Prunes, Badam, Honey, Curd, Water, Muesli, Strawberries, Chia Seeds",9,10,15,25,1,Continental,World Breakfast,Vegetarian
Oven Roasted Peaches And Cream Recipe,"Peaches, Butter, Sugar, Cinnamon Powder, Walnuts, Mint Leaves, Heavy Whipping Cream, Icing Sugar, Vanilla Extract",9,20,30,50,4,Continental,Dessert,Vegetarian
Karnataka Style Sorakkai Palya Recipe - Karnataka Style Bottle Gourd Sabzi,"Bottle Gourd, Tomato, Cumin Seeds, Turmeric Powder, Red Chilli Powder, Sambar Powder, Curry Leaves, Salt, Sunflower Oil",9,10,30,40,3,Karnataka,Lunch,Vegetarian
Andhra Style Multi Lentil Garelu (Vada Recipe),"Chana Dal, Yellow Moong Dal, White Urad Dal, Rice Flour, Whole Wheat Flour, Green Chilli, Coriander, Curry Leaves, Ginger, Water, Salt, Sunflower Oil",12,300,30,330,10,Andhra,South Indian Breakfast,Vegetarian
Grilled Vegetable and Oat Salad Recipe with Feta Cheese,"Iceberg Lettuce, Button Mushrooms, Carrots, Rolled Oats Or Instant Oats, Lemon Juice, Mustard Sauce, Sunflower Oil, Feta Cheese, Parsley Leaves, Salt, Black Pepper Powder",11,10,30,40,3,Italian Recipes,Side Dish,Vegetarian
Sweet Potato & Peas Cutlet Recipe,"Sweet Potato, Green Peas, Ginger Garlic Paste, Green Chilli, Coriander, Chaat Masala Powder, Red Chilli Powder, Salt, Amchur, Cumin Powder, Lemon Juice, Garam Masala Powder, Corn Flour, Water, Whole Wheat Bread Crumbs, Sunflower Oil Shallow Fry",16,30,25,55,4,Indian,Snack,Vegetarian
Instant Khaman Dhokla Recipe,"Green Chilli, Ginger, Water, Gram Flour, Water More If Required, Salt, Cooking Soda, Enos Fruit Salt, Sugar, Turmeric Powder, Sunflower Oil, Lemon Juice, Sunflower Oil, Mustard Seeds, Cumin, Green Chilli, Curry Leaves, Sugar, Salt, Water, Lemon Juice, Fresh Coconut, Coriander",23,10,20,30,4,Gujarati Recipesï»¿,Snack,Vegetarian
Amritsari Fish Gravy Recipe,"Fish, Ajwain, Gram Flour, Kashmiri Red Chilli Powder, Turmeric Powder, Ginger Garlic Paste, Lemon Juice, Salt, Sunflower Oil, Curd, Water, Ajwain, Cinnamon Stick, Green Chilli, Fresh Red Chilli, Turmeric Powder, Cashew Nuts, Homemade Tomato Puree, Onion, Coriander, Ghee, Salt",22,20,25,45,2,North Indian Recipes,Dinner,Non Vegeterian
Kachumber Salad Recipe,"Cucumber, Onion, Green Chili, Tomato, Carrot, Salt, Pomegranate, Black Pepper Powder, Cumin Powder, , Coriander Leaves, Mint",12,10,5,15,4,Indian,Side Dish,Diabetic Friendly
Homemade Nachos Recipe,"Corn Flour, Whole Wheat Flour, Sunflower Oil, Water Knead The Flour, Salt, Barbeque Masala Garnish",6,10,25,35,3,Mexican,Snack,Vegetarian
Moong Dal Palak Cheela ,"Yellow Moong Dal, Curd, Spinach, Onion, Coriander, Green Chilli, Ginger, Cumin Seeds, Turmeric Powder, Red Chili Powder, Lemon Juice, Salt, Oil",13,20,30,50,4,Indian,North Indian Breakfast,High Protein Vegetarian
Dhaba Style Egg Curry Recipe in Electric Pressure Cooker,"Whole Eggs, Ghee, Cumin Seeds, Mustard Seeds, Asafoetida, Cloves, Bay Leaf, Black Cardamom, Cardamom, Dry Red Chilli, Ginger, Garlic, Onion, Homemade Tomato Puree, Curd, Kashmiri Red Chilli Powder, Turmeric Powder, Coriander Powder, Salt, Water, Coriander",21,30,60,90,4,North Indian Recipes,Dinner,Eggetarian
Rumali Roti Recipe,"All Purpose Flour, Curd, Sunflower Oil, Salt, Lukewarm Water Knead",5,10,25,35,4,Punjabi,Side Dish,Vegetarian
Sabudana Sandige Recipe - Sabudana Vadam Recipe,"Sabudana, Water, Green Chilli, Cumin Seeds, Sesame Seeds, Salt",6,120,40,160,10,South Karnataka,Snack,Vegetarian
Vendakkai-Vazhakkai Mor Kuzhambu Recipe (Tamil Nadu Style Lady's Finger & Raw Banana Curry),"Buttermilk, Bhindi, Raw Banana, Turmeric Powder, Broken Raw Rice, Arhar Dal, Coriander, Ginger, Green Chilli, Fresh Coconut, Mustard Seeds, Dry Red Chilli, Asafoetida, Curry Leaves, Sunflower Oil",15,10,20,30,4,Tamil Nadu,Side Dish,Vegetarian
Pepper Mushroom Stir Fry Recipe,"Button Mushrooms, Green Chilli, Red Yellowgreen Bell Pepper, Ginger, Black Pepper Powder, Turmeric Powder, Garam Masala Powder, Salt, Whole Black Peppercorns, Coriander, Sunflower Oil",11,15,20,35,4,South Indian Recipes,Lunch,Vegetarian
Garlic Crust Vegetable Pizza Recipe,"All Purpose Flour, Active Dry Yeast, Lukewarm Water, Sugar, Garlic, Extra Virgin Olive Oil, Butter, Salt, Dried Oregano, Red Chilli Flakes, Homemade Pizza And Pasta Sauce, Mozzarella Cheese, Onion, Red Yellow And Green Bell Peppers, Baby Corn, Black Olives, Button Mushrooms, Dried Oregano, Red Chilli Flakes",19,10,420,430,3,Italian Recipes,Dinner,Vegetarian
Kashmiri Phool Rogan Josh Recipe - Cauliflower in Red Curry,"Cauliflower, Hung Curd, Fennel Seeds, Cardamom, Black Cardamom, Cloves, Whole Black Peppercorns, Kashmiri Red Chilli Powder, Cinnamon Stick, Salt, Mustard Oil, Cloves, Cardamom, Black Cardamom, Cinnamon Stick, Whole Black Peppercorns, Fennel Seeds, Asafoetida, Dry Ginger Powder, Red Chilli Powder, Salt, Ratan Jot",22,20,60,80,3,Kashmiri,Dinner,Vegetarian
Arugula Watermelon and Feta Salad Recipe,"Arugula Leaves, Watermelon, Feta Cheese, Extra Virgin Olive Oil, Red Wine Vinaigrette, Honey, Salt, Black Pepper Powder, Tabasco Original",9,15,0,15,4,Continental,Appetizer,Vegetarian
Roasted Walnut Zucchini Carrot Salad in Red Wine Vinaigrette Recipe,"Green Zucchini, Carrot, Red Bell Pepper, Walnuts, Extra Virgin Olive Oil, Red Wine Vinaigrette, Extra Virgin Olive Oil, Black Pepper Powder, Salt",9,10,15,25,4,Continental,Side Dish,Vegetarian
Tamil Nadu Style Chicken Salna Recipe,"Chicken, Onion, Tomato, Ginger, Garlic, Curry Leaves, Garam Masala Powder, Red Chilli Powder, Turmeric Powder, Salt, Sunflower Oil, Fennel Seeds, Whole Black Peppercorns, Cinnamon Stick, Cloves, Star Anise, Fresh Coconut",17,10,45,55,4,Tamil Nadu,Lunch,Non Vegeterian
Bengali Style Labra Recipe - Mix Vegetable Sabzi,"Potato, Kaddu, Carrot, Cauliflower, Brinjal, Drumstick, Green Peas, Turmeric Powder, Fresh Coconut, Salt, Sugar, Mustard Oil, Panch Phoran Masala, Bay Leaf, Coriander",15,15,25,40,4,Bengali Recipes,Dinner,Vegetarian
Dal Banjara ,"Black Urad Dal, Chana Dal, Ginger, Green Chili, Tomato, Bay Leaf, Lentil Sugar, Small Spoon Turmeric Powder, Garam Masala Powder, S Of Coriander, Ghee, Cumin Seeds, Dry Red Chilli",13,10,40,50,4,North Indian Recipes,Lunch,High Protein Vegetarian
Prawn Balchao Recipe,"Prawns  Deveined, Onion, Tomato, Curry Leaves, Ginger Garlic Paste, Dry Red Chilli, Whole Black Peppercorns, Cumin Seeds, Turmeric Powder, Mustard Seeds, Cinnamon Stick, Cloves, Sugar, Vinegar, Salt, Sunflower Oil",16,15,30,45,8,Goan Recipes,Lunch,Non Vegeterian
Prawn Masala Rice Recipe,"Basmati Rice, Bay Leaves, Onion, Garlic, Ginger, Soy Sauce, Carrot, Green Chilli Sauce, Red Yellowgreen Bell Pepper, Roasted Tomato Pasta Sauce, Prawns, Butter, Sunflower Oil Fry, Cloves, Whole Black Peppercorns, Cinnamon Powder, Black Pepper Powder, Coriander, Salt, Red Chilli Powder, Turmeric Powder, Salt",22,0,40,40,4,Indian,Lunch,High Protein Non Vegetarian
Chicken Keema Paratha Recipe - Minced Chicken Flat Bread,"Sunflower Oil, Garlic, Onion, Tomato, Green Chilli, Turmeric Powder, Red Chilli Powder, Coriander Powder, Garam Masala Powder, Amchur, Salt, Chicken Breasts, Mint Leaves, Whole Wheat Flour, Salt, Sunflower Oil, Ghee",17,20,30,50,4,Mughlai,Lunch,High Protein Non Vegetarian
Sweet Potato & Neem Leaves Vegetable Curry Recipe,"Sweet Potato, Neem Leaves, Asafoetida, Mustard Seeds, White Urad Dal, Dry Red Chilli, Chana Dal, Sunflower Oil, Salt, Roasted Peanuts",10,20,30,50,4,Indian,Lunch,Vegetarian
Kashmiri Style Chokh Vangun Recipe - Baingan Masala,"Small Brinjal, Onion, Tomato, Cinnamon Stick, Cardamom, Cumin Seeds, Asafoetida, Turmeric Powder, Kashmiri Red Chilli Powder, Coriander Powder, Dry Ginger Powder, Fennel Powder, Tamarind Paste, Coriander, Mustard Oil, Salt",16,15,30,45,4,Kashmiri,Lunch,Vegetarian
South Indian Egg Curry Recipe,"Eggs, Onion, Garlic, Tomato, Coriander Powder, Red Chilli Powder, Turmeric Powder, Garam Masala Powder, Salt, Coriander, Mustard, Cumin Seeds, Oil",13,5,20,25,4,South Indian Recipes,Dinner,Eggetarian
No-Bake Tangy Lemon Pie Recipe,"Digestive Biscuit, Butter, Can Condensed Milk, Butter, Lemon, Lemon Zest, Sugar, Gelatin",8,180,0,180,6,Continental,Dinner,Non Vegeterian
Toffee Banana Recipe (Classic Chinese Dessert),"Ripe Bananas, Sesame Seeds, Sesame Seeds, Sunflower Oil, Chilled Water, All Purpose Flour, Corn Flour, Sunflower Oil, Baking Powder, Sugar, Water",11,10,60,70,6,Chinese,Dessert,Vegetarian
Instant Gor Kairi Lonche Recipe - Sweet Raw Mango Pickle,"Mango, Jaggery, Mustard Seeds, Salt, Mustard Oil, Mustard Seeds, Cumin Seeds, Asafoetida, Turmeric Powder, Red Chilli Powder",10,10,10,20,4,Maharashtrian Recipes,Side Dish,Vegetarian
15 Minutes Mexican Fried Rice Recipe,"Basmati Rice, Onion, Tomato, Whole Black Peppercorns, Clove Garlic, Green Chilli, Cumin Powder, Red Chilli Powder, Paprika Powder, Black Pepper Powder, Extra Virgin Olive Oil",11,5,10,15,2,Mexican,Dinner,Vegetarian
Bottle Gourd Ice Cream Recipe - Lauki Ice Cream,"Bottle Gourd, Milk, Fresh Cream, Ghee, Cardamom Powder, Slivered Almonds",6,600,10,610,3,Indian,Dessert,Vegetarian
Vazhakkai Varuval Recipe- Raw Banana Roast Recipe,"Raw Banana, Red Chilli Powder, Coriander Powder, Turmeric Powder, Sunflower Oil, Mustard Seeds, Asafoetida, Curry Leaves, Dry Red Chilli, Salt",10,10,30,40,4,South Indian Recipes,Lunch,Diabetic Friendly
Peshawari Kala Chana ,"Black, Onion, Tomato, Ginger, Green Chilli, Cinnamon, Large Cardamom, Tablespoon Coriander Powder, Red Chilli Powder, Chickpeas Spices, Pomegranate, Green Coriander, Ghee, Salt",14,30,30,60,4,Pakistani,Lunch,Vegetarian
Karwar Style Kairichi Udid Methi Recipe (Raw Mango Methi Curry),"Mango, Fresh Coconut, White Urad Dal, Methi Seeds, Basmati Rice, Dry Red Chilli, Turmeric Powder, Curry Leaves, Mustard Seeds, Asafoetida, Jaggery, Salt, Coconut Oil",13,10,20,30,4,Karnataka,Dinner,Vegetarian
Pepper Murukku Recipe - South Indian Style Chakli,"Rice Flour, Urad Dal Flour, Butter, Sesame Seeds, Whole Black Peppercorns, Sunflower Oil, Asafoetida, Salt, Sunflower Oil",9,40,20,60,10,South Indian Recipes,Snack,Vegetarian
Orange Mocktail Recipe,"Fresh Orange Juice, Lemon Juice, Sprite, Sugar, Mint Leaves, Ice Cubes, Salt",7,10,10,20,2,Continental,Snack,Vegetarian
Raw Mango Carrot Cucumber Salad Recipe With Peanuts,"Raw Mango, Carrots, Cucumber, Tomato, Peanuts  Compress Take   Coriander Leaves  Finely, Mintfinely, Salt, Black Pepper Powder, Chaat Masala Powder, Cumin Seeds Powder",10,15,0,15,4,Indian,Appetizer,Vegan
Chicken And Shrimp BÃ¡nh XÃ¨o Recipe  -Vietnamese Stuffed Crepe,"Rice Flour, Sugar, Salt, Turmeric Powder, Coconut Milk, Chilled Water, Shrimps, Salt, Black Pepper Powder, Lemon Juice, Extra Virgin Olive Oil, Chicken Breasts, Ginger Garlic Paste, Turmeric Powder, Red Chilli Powder, Cumin Powder, Garam Masala Powder, Sunflower Oil, Roasted Tomato Pasta Sauce, Salt, Sugar, Coriander, Green Bell Pepper, Carrots, Cucumber, Onion, Lemon Juice, Extra Virgin Olive Oil, Salt",29,10,55,65,4,Vietnamese,Main Course,Non Vegeterian
Kashmiri Chhir Chot Recipe- Rice Pancakes,"Rice Flour, Salt, Ajwain, Water, Sunflower Oil",5,10,20,30,4,Kashmiri,Snack,Vegetarian
Chow Chow Sambar Recipe (Chayote Squash Sambar),"Arhar Dal, Chow Chow, Tamarind, Onion, Tomato, Sambar Powder, Turmeric Powder, Coriander, Sunflower Oil, Salt, Sesame, Mustard Seeds, Asafoetida, Dry Red Chilli, Curry Leaves",15,10,30,40,4,South Indian Recipes,Lunch,High Protein Vegetarian
Muttaikose Poriyal Recipe -  Purple Cabbage Poriyal | Red Cabbage Sabzi,"Purple Cabbage, Salt, Water, Coconut Oil, Mustard Seeds, White Urad Dal, Curry Leaves, Asafoetida, Green Chilli, Fresh Coconut",10,15,30,45,3,South Indian Recipes,Side Dish,No Onion No Garlic (Sattvic)
Basil Pesto Grilled Chicken Recipe,"Chicken Breasts, Fresh Cream, Lemon Juice, Garlic Butter, Basil Leaves, Walnuts, Garlic, Salt, Whole Black Peppercorns, Extra Virgin Olive Oil, Parmesan Cheese",11,70,20,90,1,Continental,Main Course,High Protein Non Vegetarian
Menthya Matvadi Palya Recipe - Madhwa Brahmin Style Methi-Chana Dal Sabzi,"Methi Leaves, Sunflower Oil, Mustard Seeds, Curry Leaves, Dry Red Chilli, Salt, Chana Dal, Fresh Coconut, Dry Red Chilli, Coriander, Curry Leaves, Cumin Seeds, Turmeric Powder, Asafoetida",14,120,15,135,4,Karnataka,Side Dish,Diabetic Friendly
Goan Sorak Curry Recipe,"Fresh Coconut, Kashmiri Dry Red Chilli, Garlic, Onion, Coriander, Cumin Seeds, Turmeric Powder, Water, Sunflower Oil, Kokum, Green Chilli, Jaggery, Salt, Coriander",14,15,15,30,4,Goan Recipes,Dinner,Vegetarian
Stir Fried Tofu and Celery Recipe,"Tofu, Corn Flour, Black Pepper Powder, Soy Sauce, Salt, Onion, Celery, Ginger Garlic Paste, Green Chilli Sauce, Soy Sauce, Sugar, Black Pepper Powder",12,10,15,25,4,Asian,Lunch,Vegan
Ice Wine Panna Cotta Recipe,"Heavy Whipping Cream, Sugar, Lemon Juice, Ice Wine, Blackberries Any Berries For Garnish",5,10,10,20,6,Italian Recipes,Dessert,Vegetarian
Danyachi Amti Recipe (Maharashtrian Style Groundnut Curry),"Raw Peanuts, Water, Sugar, Buttermilk  Pieces Amsul, Cumin Seeds, Ghee, Green Chilli  Finely, Salt, Coriander",9,0,15,15,2,Maharashtrian Recipes,Lunch,Vegetarian
Pacha Payir Kulambu Recipe (South Indian Style Green Gram Curry),"Green Moong Dal, Onion, Tomato, Green Chilli, Dry Red Chilli, Asafoetida, Turmeric Powder, Red Chilli Powder, Coriander Powder, Sambar Powder, Salt, Mustard Seeds, Cumin Seeds, Sunflower Oil",14,140,20,160,4,South Indian Recipes,Lunch,High Protein Vegetarian
Whole Wheat And Ragi Crepe With Muesli And Strawberry Recipe,"Whole Wheat Flour, Ragi Flour, Whole Egg, Vanilla Extract, Baking Powder, Nutmeg Powder, Salt, Strawberries, Muesli, Almond Butter",10,10,10,20,4,Continental,World Breakfast,Sugar Free Diet
Palak Bhajia Recipe - Spinach Pakoras,"Spinach Leaves, Gram Flour, Rice Flour, Baking Soda, Asafoetida, Turmeric Powder, Red Chilli Powder, Cumin Powder, Salt, Ajwain",10,10,25,35,4,Indian,Snack,Vegetarian
Chinese Bhel Recipe - No Onion No Garlic,"Wheat Noodles, Carrots, Green Bell Pepper, Green Beans, Soy Sauce, Red Chilli Sauce, Tomato Ketchup, Salt, Whole Black Peppercorns, Coriander",10,30,0,30,2,Fusion,Snack,Vegetarian
Corn Halwa Recipe - Makki Ka Halwa,"Sweet Corn, Milk, Sugar, Ghee, Saffron Strands, Cardamom, Whole Cashews",7,5,20,25,4,Indian,Dessert,Vegetarian
Thandu Keerai Poriyal Recipe - Amaranth Leaves Stir Fry,"Green Amaranth Leaves, Mustard Seeds, Cumin Seeds, White Urad Dal, Curry Leaves, Ssp Asafoetida, Salt, Fresh Coconut",8,20,15,35,4,South Indian Recipes,Lunch,Diabetic Friendly
Kovakka Thoran (Poriyal) Recipe,"Tindora, Fresh Coconut, Green Chilli, Curry Leaves, Cumin Seeds, Mustard Seeds, Turmeric Powder, Salt",8,10,15,25,4,Tamil Nadu,Lunch,Vegetarian
Chicken Tikki Recipe,"Chicken, Onion, Green Coriander, Ginger Garlic Paste, Rice Flour, Salt, Egg, Bread Crumbs, Oil, Garam Masala Powder, Red Chilli Powder, Turmeric Powder, Coriander Powder, Cumin Powder",14,15,10,25,7,Indian,Appetizer,High Protein Non Vegetarian
Red Velvet Cake Recipe,"Butter, Caster Sugar, Vanilla Extract, Whole Eggs, All Purpose Flour, Corn Flour, Baking Powder, Cocoa Powder, Buttermilk, Red Food Color, White Vinegar, Baking Soda, Britannia Cream Cheese, Heavy Whipping Cream, Icing Sugar",15,20,100,120,6,Continental,Dessert,Eggetarian
Karatyacho Fodi Recipe - Pan Fried Bitter Gourd,"Karela, Red Chilli Powder, Turmeric Powder, Tablespoons Sooji, Salt, Tablespoons Extra Virgin Olive Oil Any Cooking Oil",6,20,15,35,4,Goan Recipes,Side Dish,Vegetarian
Jowar Atta Roti Recipe - Sorghum Wheat Phulka Recipe,"Jowar Flour, Whole Wheat Flour, Salt, Black Pepper Powder, Sunflower Oil, Water Knead",6,10,20,30,4,Indian,Lunch,Vegetarian
Cream Cheese Scrambled Eggs Recipe,"Whole Eggs, Onion, Green Chilli, Green Bell Pepper, Cheese Spread, Salt, Black Pepper Powder, Sunflower Oil",8,10,10,20,2,Continental,World Breakfast,Eggetarian
Pavakkai Poriyal Recipe - Karela Ki Sabzi,"Karela, Turmeric Powder, Mustard Seeds, White Urad Dal, Ssp Asafoetida, Curry Leaves, Sambar Powder, Red Chilli Powder, Amchur, Jaggery Moresuit Your, Roasted Peanuts, Sunflower Oil, Coriander, Salt",14,10,40,50,4,South Indian Recipes,Lunch,Vegetarian
Manga Ogre Recipe,"Rice  Cooked, Salt, Raw Mango, Coconut, Rye, Green Chilli, Turmeric Powder, Green Coriander, Jaggery, Oil, Spoon Curry Leaves, Cumin Seeds, Rye, , Asafoetida",15,20,60,80,4,Indian,Lunch,Vegetarian
Lobia Masala Recipe,"Cowpea, Tomato Puree, Onion, Cumin Seeds, Ginger, Tighten   Garlic, Green Chilli, Cinnamon, Turmeric Powder, Coriander Powder, Red Chilli Powder, Garam Masala Powder, Jaggery, Lemon Juice, Salt, Olive Oil, Green Coriander",17,10,35,45,4,North Indian Recipes,Dinner,High Protein Vegetarian
Vietnamese Rice Pocket Recipe With Caramelised Onions & Chillies,"Rice, Onion, Dry Red Chilli, Sunflower Oil",4,5,25,30,2,Vietnamese,Lunch,Vegetarian
Mixed Vegetable Samosa Recipe,"All Purpose Flour, Sunflower Oil, Ajwain, Lemon Juice, Potato, Green Peas, Carrot, Mustard Seeds, Coriander, Onion, Curry Leaves, Green Chilli, Ginger, Red Chilli Powder, Coriander Powder, Turmeric Powder, Garam Masala Powder, Salt, Sunflower Oil Fry, Salt, Sunflower Oil Fry",21,10,45,55,2,North Indian Recipes,Snack,Vegetarian
Lugai Gosht Recipe - Mutton In Spicy Tomato Onion Gravy,"Mutton, Onion, Tomato, Sunflower Oil, Ghee, Cardamom, Green Chilli, Ginger Garlic Paste, Ginger, Cinnamon Stick, Cumin Seeds, Whole Black Peppercorns, Cumin Powder, Red Chilli Powder, Dry Red Chilli, Salt",16,15,30,45,4,North Indian Recipes,Dinner,Non Vegeterian
Kalkandu (Kallusakkare) Pongal Recipe | Rice Pudding with Rock Candy,"Rice, Milk, Candy Sugar, Ghee, Mixed Dry Fruits  I Used Raisins And Cashews, Saffron Strands, Edible Camphor",7,20,20,40,2,South Indian Recipes,Dessert,Vegetarian
Shakkarkandi ke Laddu | Sweet Potato Laddu Recipe,"Sweet Potato, Sugar, Fresh Coconut, Cardamom Powder, Badam, Cashew Nuts, Raisins, Ghee",8,10,60,70,4,Indian,Dessert,Vegetarian
Carrot Chutney ,"Carrots, Mustard, Good, Dry Red Chilli, Salt, Oil, Mustard, Curry Leaves",8,75,15,90,6,Indian,Side Dish,Vegetarian
Dal Palak Recipe With Moong & Masoor Dal,"Yellow Moong Dal, Masoor Dal, Spinach Leaves, Tomato, Ginger, Turmeric Powder, Cumin Powder, Garam Masala Powder, Salt, Ghee, Cumin Seeds, Dry Red Chilli",12,15,40,55,4,North Indian Recipes,Side Dish,High Protein Vegetarian
Mumbai Style Pani Puri Recipe,"Pani Puris, Green Chutney, Sweet Chutney, Green Moong Dal, Boondi",5,15,15,30,2,North Indian Recipes,Snack,Vegetarian
Spicy Moroccan Eggs Recipe,"Extra Virgin Olive Oil, Onion, Garlic, Harissa Paste, Coriander Powder, Vegetable Stock, Kala Chana, Tomato, Yellow Bell Pepper, Spinach Leaves, Coriander, Whole Eggs, Salt And Pepper",13,15,25,40,2,African,World Breakfast,Eggetarian
Zoodles Salad Recipe - Zucchini Noodles,"Green Zucchini, Extra Virgin Olive Oil, Salt, Black Pepper Powder, Lemon Juice, Basil Leaves, Cherry Tomato",7,15,5,20,2,Continental,Appetizer,Vegetarian
Paneer Makhana Gulgule Chaat Recipe - No Onion No Garlic,"Paneer, Potato, Phool Makhana, Gram Flour, Salt, Cumin Powder, Black Pepper Powder, Green Chilli, Red Chilli Powder, Coriander, Cucumber, Salt, Lemon Juice, Green Chutney, Sweet Chutney",15,10,20,30,4,North Indian Recipes,Appetizer,No Onion No Garlic (Sattvic)
Cheesy Pasta Casserole With Broccoli And Cheese Recipe,"Penne Pasta Any Other Small Pasta, Broccoli, Garlic, Britannia Cream Cheese, Fresh Cream, Milk, Dijon Mustard, Salt And Pepper, Parmesan Cheese, Dill Leaves Basil Herb For Flavour, Extra Virgin Olive Oil",11,20,40,60,4,Italian Recipes,Dinner,Vegetarian
Insalata Caprese Salad Recipe,"Tomato, Mozzarella Cheese, Basil Leaves, Red Wine Vinaigrette, Extra Virgin Olive Oil, Salt, Black Pepper Powder",7,20,0,20,4,Italian Recipes,Appetizer,Vegetarian
Mutton Matar Keema Recipe -Minced Mutton With Green Peas,"Mutton, Curd, Onion, Garlic, Ginger, Potato, Green Peas, Green Chilli, Turmeric Powder, Coriander Powder, Red Chilli Powder, Salt, Sunflower Oil, Coriander, Dry Red Chilli, Bay Leaf, Black Pepper Powder, Cloves, Cinnamon Stick, Cardamom, Black Cardamom, Ajwain",22,10,60,70,5,North Indian Recipes,Lunch,Non Vegeterian
Rajma Wrap Recipe With Carrot Cucumber Sandwich Spread,"Whole Wheat Flour Tortilla Large Roti, Veeba Carrot Cucumber Sandwich Spread, Onion, Mint Leaves, Rajma, Garlic, Eggless Mayonnaise, Veeba Pizza & Pasta Sauce, Sunflower Oil, Salt, Red Bell Pepper",11,20,40,60,2,Indian,Snack,Vegetarian
Palak Chana Dal Recipe,"Chana Dal, Spinach, Water, Turmeric Powder, Salt, Ghee, Asafoetida, Cumin, Dry Red Chilli, Ginger Garlic Paste, Onion, Green Chilli, Tomato, Turmeric Powder, Red Chili Powder, Cumin Powder, Salt",17,20,30,50,2,North Indian Recipes,Lunch,High Protein Vegetarian
Apple Pancake Mess Recipe,"Apple, Tablespoon Butter, Tablespoon Cinnamon Powder, Tablespoon Brown Sugar, Tablespoon Curd, Tablespoon Chia Seeds, Tablespoon Fresh Coconut, Fresh Pomegranate Fruit Kernels, Cup All Purpose Flour, Sugar, Baking Powder, Cup Milk, Salt, Butter, Whole Egg",15,15,20,35,2,Continental,World Breakfast,Vegetarian
French Onion Tart Recipe,"Red Onion, Balsamic Vinegar, Sugar, Salt, Fresh Thyme Leaves, Lemon, Butter, All Purpose Flour, Chilled Butter, Salt, Sugar, Chilled Water",12,30,70,100,2,Continental,Appetizer,Vegetarian
Rajasthani Makki Ka Chatpata Dhokla Recipe,"Garlic, Green Chilli, Coriander, Makki Ka Atta, Baking Soda, Salt, Water",7,10,30,40,6,Rajasthani,Snack,Diabetic Friendly
Garlic And Mushroom Soup Recipe,"Button Mushrooms, Garlic, Leek, Vegetable Stock, Fresh Thyme Leaves, Extra Virgin Olive Oil, Whole Wheat Brown Bread, Button Mushrooms, Tomato, Onion, Salt And Pepper, Extra Virgin Olive Oil, Parsley Leaves, Lemon Wedges",14,15,30,45,4,Continental,Dinner,Vegetarian
Arbi Ke Meethe Chande Recipe,"Colocasia Root, Ghee Deep Fry, Sugar, Water",4,130,20,150,4,Indian,Snack,Vegetarian
"Millet Cottage Cheese Fritters Recipe-Flavored With  Za'atar,","Whole Wheat Brown Bread, Butter, Paneer, Foxtail Millet, Coriander, Za'Atar, Salt, Sesame Seeds",8,10,40,50,4,Continental,Appetizer,Vegetarian
Spicy Whole Wheat Roti Taco Bowls Recipe,"Phulka, Butter Olive Oil For Brushing The Rotis, Cheddar Cheese, Sour Cream, Tomato Salsa Mexican Salsa, Refried Beans",6,10,45,55,2,Fusion,Snack,Vegetarian
Egyptian Koshari Recipe,"Whole Black Peppercorns, Cardamom Powder, Paprika Powder, Cumin Seeds, Coriander, Cloves, Cinnamon Stick, Nutmeg, Rice, Masoor Dal, Macaroni Pasta Vermicelli, Onion, Garlic, Vegetable Stock Watercook, Cumin Seeds, Bay Leaves, Salt, Extra Virgin Olive Oil, Onion, Garlic  Minced, Tomato, Red Wine Vinaigrette, Red Chilli Flakes, Salt And Pepper, Extra Virgin Olive Oil, Onion, Kabuli Chana",27,40,30,70,4,Mediterranean,Dinner,Vegetarian
Shakarkandi Ke Gulab Jamun Recipe (Sweet Potato Gulab Jamun),"Sweet Potato, All Purpose Flour, Cardamom Powder, Salt, Sugar, Ghee Oil, Water, Sugar, Drops Rose Water, Saffron Strands",10,10,40,50,12,North Indian Recipes,Dessert,Vegetarian
Kadai Chicken Recipe - Chicken Cooked With Onion And Capsicum,"Chicken Breasts, Onion, Onion, Green Bell Pepper, Cumin Seeds, Dry Red Chilli, Ginger, Garlic, Homemade Tomato Puree, Red Chilli Powder, Turmeric Powder, Garam Masala Powder, Fresh Cream, Salt, Coriander, Sunflower Oil",16,10,35,45,4,North Indian Recipes,Side Dish,Non Vegeterian
Hayagreeva Recipe,"Chana Dal, Jaggery, Poppy Seeds, Dry Coconut, Cardamom Powder",5,25,20,45,4,Karnataka,Dessert,Vegetarian
Burnt Garlic Pasta with Mushroom Recipe,"Pasta, Salt, Extra Virgin Olive Oil, Water, Onion, Garlic, Button Mushrooms, Cauliflower, Milk, Salt, Black Pepper Powder, Dried Oregano, Parmesan Cheese, Butter, Extra Virgin Olive Oil, Reserved Water",16,10,40,50,3,Italian Recipes,Dinner,Vegetarian
Tomato Garlic Chutney Recipe,"Tomato, Garlic, Green Chilli, Red Chilli Powder, Salt, Mustard Seeds, Sunflower Oil",7,20,10,30,6,Indian,Side Dish,Vegetarian
Neymeen Vatti Pattichathu Recipe - Seer Fish In Spicy Masala,"Seer Fish, Curry Leaves, Tamarind Water, Turmeric Powder, Coconut Milk, Lemon Juice, Salt, Coconut Oil, Onion, Dry Red Chilli, Garlic, Ginger, Green Chilli",13,10,35,45,4,Kerala Recipes,Lunch,High Protein Non Vegetarian
Moroccan Chickpeas Curry with Quinoa and Coriander Curd Recipe,"Quinoa, Water, Sunflower Oil, Kabuli Chana, Mixed Vegetables, Tomato, Salt, Cumin Powder, Coriander Powder, Paprika Powder, Ginger, Black Pepper Powder, Hung Curd, Coriander, Mint Leaves, Lemon Juice, Salt, White Pepper Powder, Lemon Wedges",19,10,45,55,2,African,Dinner,High Protein Vegetarian
Mutton Khurdi Recipe - Bohra Style White Mutton Stock Soup,"Mutton, Onion, Bay Leaves, Green Chilli, Ginger, Garlic, Salt, Water, Sunflower Oil, Cumin Seeds, Whole Black Pepper Corns, Cloves, Cinnamon Stick, Whole Wheat Flour, Milk, Salt, Black Pepper Powder, Mint Leaves, Lemon",19,10,20,30,4,Gujarati Recipesï»¿,Appetizer,Non Vegeterian
Iyengar Style Masala Toast Recipe,"Crusty Bread Log, Nutralite Classic Spread, Carrots, Cabbage, Onion, Tomato, Ginger, Cloves, Green Chilli, Mustard Seeds, Asafoetida, Garam Masala Powder, Achari Mayo, Salt",14,10,30,40,4,Karnataka,Snack,Vegetarian
Andhra Style Mutton Curry Recipe,"Mutton, Turmeric Powder, Red Chilli Powder, Salt, Dry Coconut, Onion, Water, Onion, Red Chilli Powder, Ginger Garlic Paste, Coriander Powder, Garam Masala Powder, Tomato, Sunflower Oil, Kasuri Methi, Salt, Water, Coriander",18,30,30,60,4,Andhra,Dinner,Non Vegeterian
Delicious Arabic Sweet Kunafa Recipe (Knafeh),"Kunafa Dough, Butter, Pistachios, Milk, Corn Flour, Rose Water, Ricotta Cheese, Sugar, Water, Lemon Juice, Rose Water",11,25,45,70,4,Arab,Dessert,Vegetarian
Pineapple Carpaccio Recipe - Spiced Pineapple Salad with Ginger & Mint,"Pineapple, Sea Salt Regular Salt, Mint Leaves, Fresh Fruits, Extra Virgin Olive Oil, Fresh Orange Juice, Lemon Juice, Honey, Dry Red Chilli, Ginger",10,190,15,205,4,Continental,Dinner,Vegetarian
Churros Recipe With Cinnamon & Sugar | Eggless Recipe,"Milk, Water, Butter, Salt, Sugar, All Purpose Flour, Baking Powder, Caster Sugar, Cinnamon Powder",9,10,20,30,40,Mexican,Snack,Vegetarian
Buttered Potato Cubes Recipe - Finger Food For Babies Above 9 Months,"Potato, Butter, Salt, Cumin Powder, Black Pepper Powder",5,15,5,20,2,Indian,Snack,Vegetarian
Sweet Potato & Green Bean Salad Recipe,"Sweet Potato, Cherry Tomato, Green Beans, Red Onion, Green Chilli, Extra Virgin Olive Oil, Lemon Juice, Salt And Pepper",8,15,20,35,3,Continental,Appetizer,Vegetarian
Shikampuri Kebab Recipe - Kebabs made with Brown Chickpeas,"Kala Chana, Potato, Ginger, Garlic, Green Chilli, Red Chilli Powder, Amchur, Coriander Powder, Garam Masala Powder, Black Pepper Powder, Salt, Coriander, Lemon Juice, Gram Flour, Sunflower Oil, Hung Curd",16,10,45,55,4,North Indian Recipes,Appetizer,Vegetarian
Dum Ke Baingan Recipe,"Small Green Brinjal, Turmeric Powder, Salt, Lemon Juice, Sunflower Oil, Cardamom, Cinnamon Stick, Black Pepper Powder, Cloves, Bay Leaf, Cumin Seeds, Dry Red Chilli, Onion, Ginger, Garlic",15,10,30,40,4,Hyderabadi,Lunch,Vegetarian
Healthy Black Bean Burger Recipe Without Bun,"Black Beans  Cookedcanned, Brown Rice, Onion, Coriander, Whole Wheat Bread Crumbs, Walnuts, Cumin Powder, Jaggery Coconut Sugar, Red Chilli Powder, Pickled Jalapenos  Pickled And, Tomato Ketchup, Red Chilli Sauce Sriracha, Maple Syrup Honey, Apple Cider Vinegar Any Vinegar, Black Pepper Powder, Salt, Extra Virgin Olive Oil, Pineapple, Beetroot, Onion, Tomato, Black Olives, Iceberg Lettuce, Avocado, Lemon Juice",25,20,60,80,4,Continental,Lunch,Vegetarian
Chettinad Poondu Rasam Recipe | Spicy Garlic Rasam,"Arhar Dal, Tamarind, Tomato, Ghee, Mustard Seeds, Cumin Seeds, Asafoetida, Garlic, Curry Leaves, Turmeric Powder, Black Pepper Powder, Cumin Powder, Coriander, Red Chilli Powder, Salt, Sugar, Coriander",17,10,30,40,4,South Indian Recipes,Lunch,Vegetarian
Bonda Mor Kuzhambu Recipe,"Curd, Arhar Dal, Coriander, Fresh Coconut, Ginger, Dry Red Chilli, Curry Leaves, Asafoetida, Mustard Seeds, Chana Dal, Sunflower Oil, Salt, White Urad Dal, Ginger, Green Chilli, Salt, Sunflower Oil",17,20,30,50,4,South Indian Recipes,Lunch,Vegetarian
Chana Turai/Nenua Chana Sabzi Recipe (Ridge Gourd with Black Chana Recipe),"Kala Chana, Ridge Gourd, Mustard Seeds, Methi Seeds, Asafoetida, Onion, Garlic, Green Chilli, Cumin Seeds, Red Chilli Powder, Coriander Powder, Turmeric Powder, Amchur, Mustard Oil",14,500,45,545,4,Bihari,Lunch,Diabetic Friendly
Coorg Style Bollari Barthad Recipe - Mangalore Cucumber Stir Fry,"Mangalorean Cucumber, Garlic, Onion, Coriander, Cumin Seeds, Dry Red Chilli, Fresh Coconut, Sunflower Oil, Mustard Seeds, White Urad Dal, Cumin Seeds, Dry Red Chilli, Curry Leaves",13,10,20,30,4,Coorg,Side Dish,Vegetarian
Spinach Cottage Cheese Cannelloni in Roasted Pepper Sauce Recipe,"Garlic, Onion, Green Bell Pepper, Sunflower Oil, Butter, Tomato, Few Basil Leaves, Red Chilli Flakes, Salt, Fresh Cream, Button Mushrooms, Garlic, Onion, Spinach, Paneer, Red Chilli Flakes, Salt And Pepper",17,15,45,60,4,Italian Recipes,Dinner,Vegetarian
Lahsuni Paneer Recipe - Paneer Flavoured With Garlic,"Paneer, Garlic, Dry Red Chilli, Vinegar, Sugar, Salt, Onion, Cumin Seeds, Sunflower Oil, Coriander",10,10,15,25,4,North Indian Recipes,Appetizer,Vegetarian
Kandathippili Rasam Recipe - Long Pepper Rasam,"Tomato, Garlic, Green Chilli, Curry Leaves, Coriander, Tamarind, Asafoetida, Mustard Seeds, Sunflower Oil, Salt, Long Pepper, Cumin Seeds, Curry Leaves, Garlic",14,10,15,25,2,South Indian Recipes,Lunch,Vegetarian
Mavinakayi Menasinakai Curry Recipe  - Raw Mango Coconut Curry,"Mango, Jaggery, Turmeric Powder, Tamarind Water, Salt, Fresh Coconut, White Urad Dal, Chana Dal, Methi Seeds, Cumin Seeds, Sesame Seeds, Dry Red Chilli, Coconut Oil, Ssp Asafoetida, Mustard Seeds, Curry Leaves",16,15,20,35,4,Mangalorean,Side Dish,Vegetarian
Aloo Chaat Recipe With Baked Beans - Roz Ka Khana With Figaro Olive Oil,"Whole Wheat Brown Bread, Baked Beans, Potato, Cumin Powder, Onion, Green Chilli, Chaat Masala Powder, Coriander, Sev, Green Chutney, Sweet Chutney, Anardana Powder, Salt, Extra Virgin Olive Oil",14,30,25,55,4,Indian,Snack,Vegetarian
Soft Masala Dosa With Red Chutney Recipe,"Idli Dosa Batter, Sunflower Oil Shallow Fry, Chaat Masala Powder, Potato Masala, Lahsun Ki Chutney, Potato, Onion, Ginger, Green Chilli, Turmeric Powder, Curry Leaves, Coriander, Salt",13,10,45,55,4,South Indian Recipes,South Indian Breakfast,Vegetarian
"Sweet Potato, Broccoli And Tofu Curry Recipe","Broccoli, Sweet Potato, Tofu, Kala Jeera, Salt, Onion, Tomato, Ginger, Garlic, Green Chilli, Cashew Nuts, Cumin Powder, Turmeric Powder, Red Chilli Powder, Garam Masala Powder",15,10,30,40,4,Indian,Lunch,Vegetarian
Crispy Crunchy Roti Ke Papad Recipe,"Tawa Paratha Rotis Leftover, Sunflower Oil, Chaat Masala Powder, Salt, Red Chilli Powder",5,0,45,45,4,Indian,Snack,Vegetarian
Capsicum Masala Poriyal Recipe (South Indian Style Bell Pepper Stir Fry),"Sunflower Oil, Mustard Seeds, Red Yellowgreen Bell Pepper, Onion, Curry Leaves, Salt, Roasted Peanuts, Fresh Coconut, Dry Red Chilli, Garlic, Cumin Seeds, Coriander",12,38,25,63,4,South Indian Recipes,Lunch,Vegetarian
Chicken Manchurian Dry Recipe,"Chicken Breasts, Whole Egg, Corn Flour, Salt, Soy Sauce, Red Chilli Sauce, Tomato Ketchup, Sesame, Sunflower Oil, Ginger, Garlic, Onion, Green Chilli, Vinegar, Brown Sugar, Spring Onion Greens",16,10,40,50,4,Chinese,Appetizer,High Protein Non Vegetarian
Pepper Tea Recipe - Kali Mirch Chai,"Water, Whole Black Peppercorns, Honey, Lemon Juice, Ginger",5,2,5,7,2,Indian,Vegetarian,High Protein Non Vegetarian
Cumin Spiced Potato And Leek Soup Recipe,"Potato, Leek, Onion, Vegetable Stock, Water, Cumin Seeds, Red Chilli Flakes, Extra Virgin Olive Oil, Salt",9,10,60,70,4,Continental,Side Dish,Vegetarian
Lebanese Style Shish Tawook Recipe - Grilled Chicken Skewers,"Boneless Chicken, Hung Curd, Paprika Powder, Garlic, Ginger, Dried Oregano, Dried Thyme Leaves, Extra Virgin Olive Oil, Lemon Juice, Tomato Ketchup, Black Pepper Powder, Salt, Green Bell Pepper, Onion",14,360,60,420,4,Middle Eastern,Appetizer,Non Vegeterian
Bengali Bhindi Doi Posto Recipe,"Bhindi, Red Chilli Powder, Turmeric Powder, Coriander Powder, Salt, Poppy Seeds, Roasted Gram Dal, Dry Red Chilli, Curd, Mustard Oil, Bay Leaf, Panch Phoran Masala",12,5,20,25,4,Bengali Recipes,Side Dish,Vegetarian
Cajun Kidney beans Rice With Soya Chunks Recipe,"Rajma, Rice, Soy Chunks, Cumin Seeds, Onion, Ginger Garlic Paste, Dried Oregano, Dried Thyme Leaves, Red Chilli Powder, Red Chilli Sauce, Red Chilli Flakes, Sugar, Salt, Sunflower Oil, Coriander",15,60,45,105,4,Middle Eastern,Lunch,Vegetarian
Persian Chicken Kidney Bean Stew Recipe,"Chicken, Rajma, Onion, Garlic, Coriander, Parsley Leaves, Kasuri Methi, Dried Oregano, Turmeric Powder, Red Chilli Powder, Salt, Sunflower Oil",12,5,20,25,4,Greek,Lunch,Non Vegeterian
Papad er Dalna Recipe - Bengali Papad Curry,"Papad, Potato, Tomato, Ginger, Bay Leaf, Dry Red Chilli, Cumin Seeds, Cumin Powder, Turmeric Powder, Red Chilli Powder, Sugar, Garam Masala Powder, Salt, Sunflower Oil, Ghee",15,20,45,65,4,Bengali Recipes,Side Dish,Vegetarian
Cheesy Potato Peas Potli Recipe,"Vivatta Maida, Sunflower Oil Ghee, Salt, Water, Ajwain, Baking Soda, Potato, Green Peas, Onion, Cheese, Green Chilli, Ginger, Kasuri Methi, Cumin Seeds, Amchur, Turmeric Powder, Red Chilli Powder, Garam Masala Powder, Coriander Powder, Coriander, Salt, Sunflower Oil Brush",22,20,40,60,5,Indian,Snack,Vegetarian
Pudina Rice Recipe,"Rice, Mint Leaves, Green Chilli, Tamarind Paste, Onion, Sunflower Oil, Mustard Seeds, White Urad Dal, Salt",9,10,40,50,4,South Indian Recipes,Lunch,Vegetarian
Sugar Free Pineapple Dates Cake Recipe,"All Purpose Flour, Pineapple, Dates, Water, Baking Soda, Whole Eggs, Vanilla Extract, Salted Butter, Raisins",9,15,50,65,6,Continental,Dessert,Eggetarian
Kathal Masaledar Sabzi Recipe - Jackfruit Masala Sabzi,"Jackfruit Raw, Potato, Onion, Asafoetida, Bay Leaf, Garlic, Ginger, Curd, Cinnamon Stick, Black Cardamom, Coriander Powder, Cumin Powder, Garam Masala Powder, Red Chilli Powder, Homemade Tomato Puree, Mustard Oil, Salt, Coriander",18,10,40,50,4,North Indian Recipes,Main Course,Diabetic Friendly
Delicious Breakfast Anda Ghotala Recipe With Butter Pav,"Butter, Cumin Seeds, Garlic, Green Chilli, Onion, Salt, Turmeric Powder, Red Chilli Powder, Coriander Powder, Tomato, Pav Bhaji Masala, Cumin Powder, Boiled Egg, Butter, Whole Eggs, Salt Sprinkle, Pav Bhaji Masala Sprinkle, Coriander, Pav Bhaji Masala Sprinkle, Coriander",20,15,30,45,4,North Indian Recipes,Indian Breakfast,Eggetarian
Achari Aloo Sabzi Recipe - Potatoes In Spicy Pickle Masala,"Potato, Asafoetida, Cumin Seeds, Dry Red Chilli, Punjabi Style Mango Pickle, Jaggery, Mustard Oil, Onion, Garlic, Turmeric Powder, Red Chilli Powder, Garam Masala Powder, Coriander, Salt",14,15,15,30,4,North Indian Recipes,Dinner,Vegetarian
Panjiri Ladoo Recipe,"Dry Ginger Powder, Cumin Seeds, Ajwain, Coriander, Whole Black Peppercorns, Fennel Seeds, Ghee, Caster Sugar",8,15,0,15,4,Indian,Dessert,Vegetarian
Palak Paneer Bhurji Recipe -Spiced Cottage Cheese Scramble With Spinach Recipe,"Paneer, Spinach Leaves, Green Chilli, Onion, Tomato, Garlic, Cumin Seeds, Red Chilli Powder, Garam Masala Powder, Amchur, Butter, Salt, Sunflower Oil",13,15,30,45,4,North Indian Recipes,Vegetarian,Vegetarian
Fujian Style Green Vegetables Stir Fry Recipe,"Bok Choy, Cabbage, Button Mushrooms, Lotus Stem, Garlic, Dark Soy Sauce, Honey, Red Chilli Sauce, Salt, Sunflower Oil, Spring Onion",11,15,10,25,4,Chinese,Side Dish,Vegetarian
Petha Wadi Sabzi Recipe,"Badi, Kaddu, Onion, Tomato, Ginger, Garlic, Green Chilli, Cumin Seeds, Red Chilli Powder, Coriander Powder, Turmeric Powder, Sunflower Oil, Salt, Coriander",14,15,50,65,4,North Indian Recipes,Side Dish,High Protein Vegetarian
Jain Style Dal Makhani Recipe,"Black Urad Dal, Rajma, Cumin Seeds, Cinnamon Stick, Cloves, Black Cardamom, Tomato, Green Chilli, Red Chilli Powder, Garam Masala Powder, Dry Ginger Powder, Ghee, Milk, Salt, Ginger, Fresh Cream",16,10,30,40,4,North Indian Recipes,Lunch,High Protein Vegetarian
Adraki Rajma Masala Recipe - Rajma Masala Recipe,"Rajma, Onion, Garlic, Ginger, Tomato, Turmeric Powder, Coriander Powder, Red Chilli Powder, Black Pepper Powder, Dry Ginger Powder, Garam Masala Powder, Bay Leaf, Coriander, Ghee, Salt",15,300,20,320,4,Bihari,Lunch,High Protein Vegetarian
Muesli Banana Fritters Recipe,"Nendra Pazham Banana, Muesli, Cocoa Powder, Honey, Salt, Butter",6,5,15,20,4,Continental,Snack,Vegetarian
Canadian Egg Free Butter Tart Recipe (Eggless),"All Purpose Flour, Butter, Salt, Raisins, Butter, Brown Sugar, Corn Flour, Hung Curd, Vanilla Extract, Cinnamon Powder, Nutmeg Powder",11,5,90,95,4,Continental,Dessert,Vegetarian
Beet Carrot and Apple Salad in Orange Mustard Vinaigrette Recipe,"Beetroot, Carrot, Apple, Walnuts, Mint Leaves, Sesame Seeds, Fresh Orange Juice, Orange Zest, Lemon Juice, Mustard Sauce, Extra Virgin Olive Oil, Black Pepper Powder, Salt",13,15,0,15,2,Continental,Side Dish,Vegetarian
Mango Tomato Bean Salsa Recipe,"Mango, Tomato, Rajma, Green Chilli, Mint Leaves, Lemon Juice, Kosher Salt",7,10,0,10,2,Mexican,Side Dish,Vegetarian
Guacamole Soup Recipe - Spiced Avocado Soup,"Avocados, Extra Virgin Olive Oil, Garlic, Onion, Vegetable Stock, Coriander, Pickled Jalapenos  Pickled  Green Chilli, Sour Cream, Corn Flour Tortilla, Lemon Juice, Salt, Whole Black Peppercorns, Onion, White Vinegar, Sugar, Salt",16,5,20,25,4,Mexican,Appetizer,Vegetarian
High Protein Soya Idli & Dosa Batter Recipe,"Soybeans, White Urad Dal, Methi Seeds, Chana Dal, Idli Rice, Salt",6,480,0,480,1000,South Indian Recipes,South Indian Breakfast,High Protein Vegetarian
"Bread, Paneer & Potato Instant Vada Recipe","Whole Wheat Brown Bread, Curd, Rice Flour, Sooji, Paneer, Potato, Cumin Seeds, Onion, Ginger, Coriander, Green Chilli, Salt, Sunflower Oil",13,15,15,30,5,South Indian Recipes,Snack,Vegetarian
Carrot Beet Amaranth Super Salad Recipe,"Beetroot, Carrots, Amaranth Seeds, Sesame Seeds, Tahini, Basil Leaves, Dried Figs",7,15,20,35,4,Continental,Snack,Vegetarian
Paneer Kundan Kaliyan Recipe,"Paneer, Kashmiri Red Chilli Powder, Garam Masala Powder, Coriander, Onion, Tomato, Cardamom, Bay Leaf, Cloves, Cinnamon Stick, Ghee, Fresh Cream, Curd, Rose Petals, Salt, Coriander",16,10,15,25,2,Hyderabadi,Dinner,Vegetarian
Rajasthani Govind Gatta Curry Recipe,"Gram Flour, Red Chilli Powder, Turmeric Powder, Ajwain, Curd, Sunflower Oil, Khoya, Green Chilli, Cashew Nuts, Raisins, Dessicated Coconut, Salt, Khoya, Curd, Gram Flour, Red Chilli Powder, Turmeric Powder, Cumin Powder, Coriander Powder, Garam Masala Powder, Salt, Sunflower Oil, Coriander, Cumin Seeds, Mustard Seeds, Asafoetida, Dry Red Chilli, Bay Leaf",28,15,45,60,4,Rajasthani,Side Dish,High Protein Vegetarian
Maheri Recipe,"Barnyard Millet, Buttermilk, Salt, Cumin Seeds, Asafoetida, Turmeric Powder, Ghee",7,40,30,70,2,Indian,Indian Breakfast,Vegetarian
Tamatar Wali Arbi Sabzi Recipe,"Colocasia Leaves, Onion, Tomato, Garlic, Tamarind, Kashmiri Red Chilli Powder, Coriander Powder, Turmeric Powder, Garam Masala Powder, Panch Phoran Masala, Sunflower Oil, Coriander, Salt",13,10,20,30,4,North Indian Recipes,Lunch,Vegetarian
Achari Paratha Roll Recipe,"Whole Wheat Flour, Salt, Achari Masala, Potato, Kaddu, Green Peas, Turmeric Powder, Red Chilli Powder, Garam Masala Powder, Salt, Mustard Seeds, Asafoetida",12,30,40,70,4,Indian,Snack,Vegetarian
Garlic Spinach Balls Recipe,"Spinach, Garlic, Onion, Potato, All Purpose Flour, Red Chilli Powder, Dried Oregano, Salt, Sunflower Oil",9,15,15,30,4,Continental,Dinner,Vegetarian
Carrot Matar Paratha Recipe,"Whole Wheat Flour, Water, Salt, Carrots, Green Peas, Onion, Green Chilli, Coriander, Ajwain, Coriander Powder, Red Chilli Powder, Cumin Powder, Chaat Masala Powder, Salt, Ghee",15,20,30,50,4,North Indian Recipes,North Indian Breakfast,Vegetarian
Kathirikai Urulai Kizhangu Kara Kuzhambu Recipe,"Brinjal, Potato, Shallots, Tomato, Sambar Powder, Red Chilli Powder, Turmeric Powder, Salt, Water, Tamarind, Sunflower Oil, Asafoetida, Curry Leaves, Dry Red Chilli, Methi Seeds, Mustard Seeds, White Urad Dal",17,30,40,70,4,Chettinad,Lunch,Vegetarian
Steamed Sweet Corn Recipe Flavored with Chaat Masala Recipe,"Sweet Corn, Black Salt, Chaat Masala Powder, Lemon Juice, Salt",5,0,20,20,2,Indian,Snack,Vegetarian
Jalapeno Potato Cheese Balls Recipe With Four Pepper Cheese Dip,"Potato, Britannia Cheese Cubes, Garlic, Pickled Jalapenos, Parsley Leaves, Whole Eggs, Whole Wheat Bread Crumbs, Mixed Herbs, Salt, Sunflower Oil, Britannia Cheese Spread, Hung Curd, Parsley Leaves, Salt",14,60,10,70,4,Continental,Appetizer,Vegetarian
Banana-Almond Butter Bread Recipe,"Ripe Bananas, Whole Egg, Sugar, Almond Butter, Vivatta Maida, Almond Meal, Baking Powder, Baking Soda, Cinnamon Powder, Salt, Vanilla Extract Almond Extract, Slivered Almonds, Chocolate Ganache Melted Chocolate",13,15,20,35,2,Continental,Snack,Eggetarian
Masala Akki Roti Recipe - Spicy Rice Flour Flatbread,"Rice Flour, Fresh Coconut, Carrot, Green Bell Pepper, Dill Leaves, Cabbage, Onion, Ginger, Green Chilli, Cumin Seeds, Asafoetida, Salt, Sunflower Oil Cook",13,10,45,55,2,South Indian Recipes,Lunch,Vegetarian
Eggless Wholewheat And Custard Powder Coconut Cookies Recipe,"Whole Wheat Flour, Custard Powder, Sunflower Oil, Dessicated Coconut, Vanilla Extract, Brown Sugar, Salt, Baking Soda, Baking Powder, Milk",10,20,40,60,4,Continental,Snack,Vegetarian
Oats And Date Cookie Recipe,"Instant Oats, Whole Wheat Flour, Dates, Brown Sugar, Sunflower Oil Ghee, Baking Powder, Baking Soda, Vanilla Extract",8,15,30,45,5,Continental,Snack,Vegetarian
Kongunadu Special Pattani Biryani Recipe (Green Peas Biryani From Kongunadu),"Basmati Rice, Sunflower Oil, Bay Leaves, Cardamom, Cinnamon Stick, Cloves, Fennel Seeds, Pearl Onion, Garlic, Ginger, Green Chilli, Tomato, Mint Leaves, Turmeric Powder, Green Peas, Salt, Coriander",17,20,85,105,4,Kongunadu,One Pot Dish,Vegetarian
Jowar Garlic Naan Recipe- Healthy Sorghum Naan,"Jowar Flour, Whole Wheat Flour, Methi Leaves, Active Dry Yeast, Curd, Salt, Sugar, Garlic, Ghee",9,140,15,155,4,North Indian Recipes,Main Course,Diabetic Friendly
Allahabadi Tehri Recipe (UP Style Vegetable Rice),"Basmati Rice, Mixed Vegetables, Curd, Cinnamon Stick, Bay Leaf, Cardamom, Black Cardamom, Whole Black Peppercorns, Cloves, Asafoetida, Onion, Garlic, Ginger, Green Chilli, Turmeric Powder, Red Chilli Powder, Coriander Powder, Cumin Powder, Mustard Oil, Ghee, Lemon Juice, Salt",22,10,30,40,4,Uttar Pradesh,Dinner,Vegetarian
Asian Style Honey Chicken With Vegetables Recipe,"Chicken Breasts, Green Bell Peppers, Carrot, Broccoli, Garlic, Soy Sauce, Honey, Corn Flour, Salt, Sunflower Oil",10,10,15,25,4,Asian,Lunch,High Protein Non Vegetarian
Kale Chane Ki Kadhi Recipe - Black Chickpea Kadhi,"Kala Chana, Curd, Gram Flour, Turmeric Powder, Green Chilli, Curry Leaves, Water, Salt, Onion, Sunflower Oil, Dry Red Chilli, Cumin Seeds, Mustard Seeds, Asafoetida, Salt",15,10,45,55,4,North Indian Recipes,Dinner,Vegetarian
Chicken Burrito Recipe,"Chicken, Onion, Garlic, Ginger, Cumin Powder, Black Pepper Powder, Cinnamon Powder, Paprika Powder, Turmeric Powder, Salt, Rajma, Onion, Tomato, Garlic, Cumin Powder, Red Chilli Powder, Black Pepper Powder, Sugar, Salt, Cooked Rice, Dried Thyme Leaves, Paprika Powder, Salt, Green Bell Pepper, Red Bell Pepper, Yellow Bell Pepper, Onion, Cumin Powder, Paprika Powder, Salt, Tomato Salsa, Sour Cream, Cheese, Tortillas",34,10,40,50,4,Mexican,Lunch,Non Vegeterian
Healthy Fresh Vegetable Salad Bowl with Sour Yogurt Dressing Recipe,"Cherry Tomato, Onion, English Cucumber, Yellow Bell Pepper, Parsley Leaves, Tofu, Hung Curd, Lemon Juice, Salt, Tzatziki",10,15,0,15,4,Mediterranean,Appetizer,Vegetarian
Badam Nu Gosht Recipe - Parsi Style Mutton In Almond Gravy,"Mutton, Bay Leaves, Salt, Onion, Tomato, Milk, Ghee, Badam, Ginger, Garlic, Dry Red Chilli, Cinnamon Stick, Black Pepper Corns, Cloves",14,10,20,30,3,Parsi Recipes,Main Course,Non Vegeterian
Homemade Whole Wheat Pav Recipe / Ladi Pav,"Whole Wheat Flour, All Purpose Flour, Active Dry Yeast, Milk, Honey, Butter, Salt, Milk, Honey",9,60,40,100,6,Goan Recipes,Side Dish,Vegetarian
"Whole Wheat Pizza With Egg, Bell Peppers And Fresh Basil Recipe","Pizza Base, Tomato, Red Bell Pepper, Basil Leaves, Parmesan Cheese, Mozzarella Cheese, Garlic Salt, Mixed Herbs, Fresno Pepper, Extra Virgin Olive Oil, Whole Eggs, Homemade Pizza And Pasta Sauce",12,10,40,50,2,Italian Recipes,World Breakfast,Eggetarian
Gorikayi Palya Recipe - Karnataka Style Gawar Phali Sabzi,"Gawar Phali, Coconut Oil, Mustard Seeds, Curry Leaves, Dry Red Chilli, Fresh Coconut, Sesame Seeds, Garlic, Dry Red Chilli, Tamarind, Jaggery, Salt",12,15,20,35,4,Karnataka,Side Dish,Vegetarian
Zucchini Zoodles with mushroom Meatball Recipe,"Green Zucchini, Extra Virgin Olive Oil, Salt And Pepper, Lemon Juice, Extra Virgin Olive Oil, Garlic, Tomato, Basil Leaves, Dried Oregano, Cumin Powder, Honey, Red Chilli Powder, Button Mushrooms, Salt And Pepper, Button Mushrooms, Garlic, Onion, Whole Wheat Bread Crumbs, Whole Wheat Flour, Kala Chana, Salt And Pepper, Dried Oregano, Dried Thyme Leaves, Basil Leaves, Parsley Leaves, Cumin Seeds, Extra Virgin Olive Oil",27,10,45,55,4,Fusion,Main Course,Vegan
Pakistani Style Tinde Ki Tarkari Recipe - Apple Gourds Cooked With Tomatoes,"Tinda, Tomato, Garlic, Dry Red Chilli, Cumin Seeds, Red Chilli Flakes, Coriander, Green Chilli, Sunflower Oil, Salt",10,10,20,30,4,Pakistani,Side Dish,Vegetarian
Pandu Mirapakaya Pachadi  - Andhra Red Chilli Chutney Recipe,"Fresh Red Chilli, Tamarind Paste, Gingelly Oil, Mustard Seeds, Asafoetida, Methi Powder, Salt",7,10,10,20,4,Andhra,Side Dish,Vegetarian
Potato Bonda Recipe Flavoured With Sambar Powder,"Sunflower Oil Deep Fry, Gram Flour, Corn Flour, Red Chilli Powder, Garam Masala Powder, Asafoetida, Cooking Soda, Salt, Potato, Green Peas, Cumin Seeds, Mustard Seeds, Salt, Asafoetida, Sambar Powder, Coriander Powder, Red Chilli Powder, Turmeric Powder, Sunflower Oil",19,10,20,30,4,South Indian Recipes,Snack,Vegetarian
Leftover Carrot Cake Mini Trifle Recipe,"Carrot Cake, Britannia Cream Cheese, Butter, Icing Sugar, Vanilla Extract, All Purpose Flour, Instant Oats, Walnuts, Sugar, Butter",10,45,15,60,6,Continental,Dessert,Eggetarian
Vendakkai Poriyal Recipe (South Indian Style Okra Stir Fry Spiced With Sambar Powder),"Bhindi, Sambar Powder, Asafoetida, Salt, Red Chilli Powder, Mustard Seeds, Curry Leaves",7,10,40,50,4,South Indian Recipes,Lunch,Vegetarian
Raw Banana Dosa Recipe,"Idli Dosa Batter, Raw Banana, Fresh Coconut, Turmeric Powder, Salt",5,10,30,40,4,Indian,South Indian Breakfast,Vegetarian
Traditional Steamed Modak Recipe (Ukadiche Modak With Rice flour),"Rice Flour, Water, Ghee, Salt, Fresh Coconut, Jaggery, Cardamom, Rice Flour, Ghee, Nutmeg Powder, Poppy Seeds, Badam, Raisins, Chironji, Pistachios",15,15,50,65,8,Maharashtrian Recipes,Dessert,Vegetarian
Cabbage Besan Fry Recipe,"Cabbage, Gram Flour, Ginger Garlic Paste, Red Chilli Powder, Coriander, Salt, Sunflower Oil, Water",8,10,20,30,2,Indian,Dinner,Vegetarian
Indian Style Fajitas Recipe,"Phulka, Button Mushrooms, Green Zucchini, Green Bell Peppers, Onion, Sunflower Oil, Mexican Seasoning, Salt",8,10,20,30,4,Mexican,Side Dish,Vegetarian
Homemade Tagliatelle Pasta with Capers and Bell peppers Recipe,"All Purpose Flour, Whole Wheat Flour, Whole Egg, Salt, Extra Virgin Olive Oil, Garlic, Red Bell Pepper, Capers, Red Chilli Flakes, Dried Oregano, Fresh Thyme Leaves, Salt And Pepper",12,45,15,60,4,Italian Recipes,Lunch,Vegetarian
Jeera Rice Recipe - Cumin And Ghee Flavored Rice,"Rice, Cumin Seeds, Ghee, Salt",4,10,20,30,3,Indian,Lunch,Vegetarian
Broccoli With Lemon Butter Sauce Recipe,"Broccoli, Butter, Lemon Juice, Whole Black Peppercorns, Fresh Herbs, Salt",6,5,12,17,2,Continental,Side Dish,Vegetarian
Paasi Paruppu Beans Poriyal Recipe - Moong Dal & French Beans Stir Fry,"Green Beans, Yellow Moong Dal, Green Chilli, Fresh Coconut  Grated, Mustard Seeds, Dry Red Chilli, Curry Leaves, Asafoetida, Sunflower Oil, Salt",10,20,15,35,4,South Indian Recipes,Side Dish,Diabetic Friendly
Buckwheat and Oatmeal Chocochip Pancakes Recipe (Eggless),"Buckwheat Flour, Oats Flour, Cocoa Powder, Flax Seed Powder, Chocolate Chips, Salt, Vanilla Extract, Maple Syrup, Peanut Butter, Chocolate Chips, Mixed Fruits",11,10,20,30,4,Continental,World Breakfast,Vegetarian
Banana Cream Pie Recipe,"Ripe Bananas, Cocoa Powder Garnish, All Purpose Flour, Butter, Icing Sugar, Chilled Water, Milk, Egg Yolks, All Purpose Flour, Corn Flour, Caster Sugar, Salt, Vanilla Extract, Heavy Whipping Cream, Icing Sugar, Vanilla Extract",16,300,15,315,6,Continental,Dessert,Eggetarian
Raw Jackfruit Kofta Curry Recipe - Kathal Kofta Curry Recipe,"Jackfruit Raw, All Purpose Flour, Fresh Coconut, Cardamom Powder, Raisins, Green Chilli, Cumin Powder, Water, Cinnamon Stick, Salt, Sunflower Oil, Tomato, Onion, Water, Ginger, Turmeric Powder, Asafoetida, Cumin Seeds, Red Chilli Powder, Garam Masala Powder, Sunflower Oil, Fresh Cream, Coriander",23,20,40,60,6,Indian,Lunch,Vegetarian
Vegetable Biryani Recipe With Chatpata Aloo,"Basmati Rice, Water, Onion, Ginger, Green Chilli, Garlic, Sunflower Oil, Red Yellowgreen Bell Pepper, Carrot, Ghee Garnish, Star Anise, Cloves, Cinnamon Stick, Dry Red Chilli, Bay Leaves, Whole Black Peppercorns, Turmeric Powder, Black Pepper Powder, Red Chilli Powder, Cumin Seeds, Coriander, Amchur, Salt, Potato, Chaat Masala Powder, Lemon Juice, Black Pepper Powder, Salt",28,20,30,50,4,Indian,Dinner,Vegetarian
Farali Aaloo Pattice Recipe,"Sunflower Oil, Potato, Arrowroot Flour, Fresh Coconut, Roasted Peanuts, Lemon, Green Chilli, Ginger, Sugar, Red Chilli Powder, Salt",11,10,30,40,4,North Indian Recipes,Appetizer,Vegetarian
Himachali Pahadi Mutton Recipe,"Mutton, Bay Leaf, Black Cardamom, Cardamom, Cloves, Ginger, Cloves, Onion, Tomato, Curd, Green Chilli, Turmeric Powder, Garam Masala Powder, Coriander Powder, Salt, Sunflower Oil",16,10,35,45,4,Himachal,Lunch,Non Vegeterian
Lagan Ki Machli Recipe - Delicious Pomfret Curry,"Pomfret Fish, Ginger, Garlic, Salt, Lemon Juice, Red Chilli Powder, Turmeric Powder, Sunflower Oil, Cumin Seeds, Star Anise, Cinnamon Stick, Dry Red Chilli, Onion, Red Chilli Powder, Garam Masala Powder, Coriander Powder, Cumin Powder, Salt, Homemade Tomato Puree, Curd, Coriander",21,30,25,55,4,Indian,Main Course,Non Vegeterian
North Arcot Special Godumai Rava Puliyodharai Recipe - Broken Wheat/Dalia Puliogare,"Broken Wheat, Ghee Oil, Raw Peanuts, Cashew Nuts  Halved, Curry Leaves, Mustard Seeds, Puliodarai Powder, Salt",8,15,30,45,4,Indian,Lunch,Vegetarian
Chow-Chow Kothamalli Chutney Recipe - Chayote Coriander Chutney,"Chow Chow, Coriander, White Urad Dal, Chana Dal, Tamarind, Dry Red Chilli, Sunflower Oil, Salt",8,20,20,40,4,South Indian Recipes,Side Dish,Diabetic Friendly
Gujarati Style Multigrain Masala Kadak Puri Recipe - Masala Mathri,"Whole Wheat Flour Multigrain Flour, Rice Flour, Ghee, Red Chilli Powder, Cumin Seeds, Asafoetida, Coriander, Salt, Sunflower Oil",9,20,40,60,4,Gujarati Recipesï»¿,Snack,Vegetarian
Ringan Methi Nu Shaak Recipe - Gujarati Style Eggplant & Fenugreek Leaves Sabzi,"Small Brinjal, Methi Leaves, Turmeric Powder, Red Chilli Powder, Coriander Powder, Cumin Powder, Jaggery, Amchur, Mustard Seeds, Cumin Seeds, Sunflower Oil, Salt",12,10,15,25,4,Gujarati Recipesï»¿,Lunch,Vegetarian
Dahi Baingan Recipe - Brinjal In Curd Based Gravy,"Brinjal, Onion, Tomato, Curd, Gram Flour, Coriander Powder, Red Chilli Powder, Garam Masala Powder, Fennel Powder, Turmeric Powder, Salt, Dry Red Chilli, Sesame Seeds, Coriander, Sunflower Oil, Cumin Seeds, Mustard Seeds, Black Urad Dal, Cloves, Cardamom, Bay Leaf, Cinnamon Stick, Curry Leaves, Ginger Garlic Paste",24,21,30,51,3,North Indian Recipes,Side Dish,Vegetarian
Assamese Saaru Maas Diya Adar Jhol Recipe - Fish In Ginger Gravy,"Fish, Water, Turmeric Powder, Salt, Corn Flour, Ginger, Green Chilli, Bay Leaf, Dry Red Chilli, Panch Phoran Masala, Mustard Oil",11,10,20,30,2,Assamese,Dinner,High Protein Non Vegetarian
Manipuri Style Sana Thongpa Recipe-Paneer and Green Beans in Milk Gravy Recipe,"Paneer, Green Beans, Onion, Ginger Garlic Paste, Cumin Seeds, Turmeric Powder, Milk, Coriander, Salt, Mustard Oil",10,5,15,20,4,North East India Recipes,Lunch,Vegetarian
Chocolate Honeycomb Bun Recipe,"Milk, Active Dry Yeast, Sugar, All Purpose Flour, Salt, Butter, Chocolate Chips, Water, Honey, Butter, Saffron Strands",11,90,30,120,4,Continental,Snack,Vegetarian
Pomegranate And Chia Seeds Yogurt Smoothie Recipe,"Fresh Pomegranate Fruit Kernels, Curd, Chia Seeds, Honey, Fresh Pomegranate Fruit Kernels, Chia Seeds",6,5,0,5,2,Continental,Snack,Vegetarian
Creamy Potato Egg Salad Recipe with Herbs,"Potato, Whole Eggs, Onion, Dill Leaves, Gherkins, Sour Cream, Black Pepper Powder, Red Chilli Flakes, Salt, Lemon Juice",10,15,30,45,4,Continental,Dinner,Eggetarian
Brinjal Mor Kuzhambu Recipe,"Brinjal, Tamarind Water, Turmeric Powder, Salt, Chana Dal, Arhar Dal, Rice, Curd, Fresh Coconut, Sunflower Oil, Mustard Seeds, Black Urad Dal, Methi Seeds, Curry Leaves, Dry Red Chilli, Asafoetida",16,10,45,55,4,Tamil Nadu,Lunch,Vegetarian
Arbi Ke Kebab Recipe (Spicy Colocasia Kebab) Recipe,"Colocasia Root, Coriander, Almond Meal, Green Chilli, Ginger, Garlic, Whole Black Peppercorns, Cabbage, Onion, Ajwain, Chaat Masala Powder, Cumin Powder, Cinnamon Powder, Gram Flour, Whole Wheat Bread Crumbs, Salt, Sunflower Oil",17,30,40,70,4,Awadhi,Appetizer,Vegetarian
No Bake Rice Mawa Cake Recipe,"Poha, Sugar, Khoya, Cardamom Powder, Saffron Strands, Milk, Ghee, Pistachios",8,10,60,70,3,North Indian Recipes,Dessert,Vegetarian
Bajri-Til Bhakri Recipe (Sesame Crusted Bajra Flatbread),"Bajra Flour, Sesame Seeds, Salt, Lukewarm Water",4,20,20,40,4,Maharashtrian Recipes,Indian Breakfast,Diabetic Friendly
Doodanche Fov Recipe (Goan Style Milk Beaten Rice/Poha In Milk),"Poha, Milk, Water, Sugar, Cardamom Powder",5,15,20,35,2,Goan Recipes,Dessert,Vegetarian
Egg and Cheesy Garlic Mayo Sandwich,"Whole Wheat Brown Bread, Whole Eggs, Nutralite Cheesy Garlic Mayo, Mustard Sauce, Black Pepper Powder, Â½ Lemon Juice, Salt And Pepper, Green Romaine Lettuce",8,10,10,20,2,Continental,World Breakfast,Eggetarian
Ragi Wheat Phulka Recipe- Diabetic Friendly Ragi Roti,"Ragi Flour, Whole Wheat Flour, Salt, Sunflower Oil, Ghee Serve",5,10,15,25,4,Indian,Main Course,Diabetic Friendly
Grapes Muffin Recipe,"Whole Wheat Flour Brown Bread Flour, Sugar, Baking Powder, Baking Soda, Salt, Red Seedless Grapes, Red Seedless Grapes, Vanilla Extract, Vinegar, Curd, Whole Egg, Butter, Red Seedless Grapes",13,20,20,40,8,Continental,Dessert,Vegetarian
Karnataka Style Bassaru Palya Recipe - Toor Dal And Dill Leaves Stir Fry,"Arhar Dal, Dill Leaves, Onion, Garlic, Mustard Seeds, Dry Red Chilli, White Urad Dal, Chana Dal, Curry Leaves, Turmeric Powder, Salt",11,5,20,25,4,Karnataka,Side Dish,Vegetarian
Karwar Style Phodni Phov Recipe- Red Rice Poha With Cashew Nuts,"Red Poha, Fresh Coconut, Cashew Nuts, Mustard Seeds, White Urad Dal, Chana Dal, Asafoetida, Curry Leaves, Sunflower Oil, Lemon Juice, Salt",11,10,10,20,4,Karnataka,South Indian Breakfast,Vegetarian
Chinese Bhel Recipe - Crispy Noodle Salad,"Hakka Noodles, Sunflower Oil, Onion, Cabbage, Green Bell Pepper, Carrot, Tomato, Sweet Chutney, Green Chutney, Red Chilli Sauce More, Salt",11,15,30,45,2,Fusion,Snack,Vegetarian
Cauliflower And Peas Bhurji Recipe,"Cauliflower, Green Peas, Green Chilli, Turmeric Powder, Salt, Sunflower Oil, Mustard Seeds",7,10,10,20,4,Indian,Side Dish,No Onion No Garlic (Sattvic)
Murgh Ajmeri Recipe,"Chicken, Ghee Oil, Onion, Coriander Powder, Red Chilli Powder, Garam Masala Powder, Fresh Cream, Cashew Nuts, Salt, Mint Leaves, Coriander, Curd, Ginger, Garlic, Green Chilli, Mustard Oil, Salt, Lemon Juice, Bay Leaves, Whole Black Peppercorns, Cloves, Black Cardamom, Cardamom, Cinnamon Stick, Mace, Ajwain",26,60,40,100,4,Rajasthani,Dinner,High Protein Non Vegetarian
Eggless Banana Pressure Cooker Cake Recipe,"Ripe Bananas, Sugar, Sunflower Oil, Vanilla Extract, All Purpose Flour, Cinnamon Powder, Baking Powder, Baking Soda, Salt, Milk, Curd",11,10,40,50,6,Continental,Snack,Vegetarian
Waldorf Salad Recipe,"Apple, Celery, Red Grapes, Walnuts, Hung Curd, Fresh Cream, Salt And Pepper",7,30,0,30,4,Continental,Appetizer,Vegetarian
Vegan Cashew Mayonnaise Recipe,"Cashew Nuts, Lemon Juice, Apple Cider Vinegar, Clove Garlic, Mustard Sauce, Date Syrup, Salt, Extra Virgin Olive Oil, Dill Leaves",9,0,10,10,15,Continental,Side Dish,Vegetarian
Aam Ki Kheer Recipe - Mango Coconut Payasam Recipe,"Mango, Coconut Milk, Palm Sugar, Cardamom Powder, Fresh Coconut Dessicated Coconut, Badam, Ghee",7,5,15,20,4,Kerala Recipes,Dessert,Vegetarian
Budhha's Delight Recipe (Thin Rice Noodles With Vegetables),"Tofu, Salt, Black Pepper Powder, Soy Sauce, Sesame, Honey, Ginger, Garlic, Corn Flour, Canola Oil, Onion, Baby Corn, Can Bamboo Shots, Mixed Vegetables, Rice Vermicelli Noodles",15,20,15,35,2,Asian,Dinner,Vegetarian
Lemon Coconut Chia Energy Balls Recipe,"Dates, Badam, Fresh Coconut, Chia Seeds, Lemon Juice, Lemon Zest",6,10,10,20,4,Indian,Snack,Vegetarian
Bhugi Dal Paratha Recipe - Moong Dal Paratha,"Yellow Moong Dal, Salt, Red Chilli Powder, Cumin Powder, Turmeric Powder, Whole Wheat Flour, Salt, Sunflower Oil, Ghee Cook",9,15,15,30,3,Sindhi,Main Course,Vegetarian
Thai Cucumber Relish Recipe,"Lebanese Cucumber, Fresh Red Chilli, Shallots, Coriander, Vinegar, Sugar, Salt",7,15,5,20,4,Thai,Side Dish,Vegetarian
Navel Orange Marmalade Recipe,"Lb Oranges, Sugar, Lemon Juice, Tablespoons Orange Zest",4,60,30,90,2,Continental,Side Dish,Vegetarian
Kashmiri Style Gushtaba Recipe - Mutton Kofta in Curd,"Mutton Kheema, Cardamom Powder, Ginger, Curd, Milk, Bay Leaf, Cinnamon Stick, Cloves, Fennel Seeds, Cumin Seeds, Dry Ginger Powder, Turmeric Powder, Salt, Ghee",14,10,45,55,4,Kashmiri,Lunch,Non Vegeterian
Gujarati Wadi Pulao Recipe,"Basmati Rice, Badi, Green Chilli, Curry Leaves, Chana Dal, White Urad Dal, Mustard Seeds, Turmeric Powder, Lemon Juice, Asafoetida, Salt, Sunflower Oil",12,20,45,65,4,Gujarati Recipesï»¿,Lunch,Vegetarian
Tangy and Sweet Bottle Gourd Curry ,"Gourd, Turmeric Powder, Salt, Mustard Oil, Mustard Oil, Asafoetida, Fenugreek Seeds, Dali Curry Leaves, Dry Red Chilli, Onion, Tomato, Red Chilli Powder, Turmeric Powder, Mango Powder, Goodpowder Done, Lemon Juice, Coriander, Oil Cook, Sunflower Oil",19,20,30,50,4,North Indian Recipes,Dinner,Vegetarian
Raw Banana Cutlet Recipe - No Onion No Garlic Jain Cutlet,"Raw Banana, Fresh Coconut, Green Chilli, Salt, Cumin Powder, Black Pepper Powder, Chaat Masala Powder, Sunflower Oil",8,0,40,40,2,North Indian Recipes,Snack,Vegetarian
Carrot Paruppu Usili Recipe - Steamed Lentils Crumbled With Carrots,"Carrots, Mustard Seeds, Dry Red Chilli, Asafoetida, Curry Leaves, Sunflower Oil, Salt, Arhar Dal, Fennel Seeds, Dry Red Chilli, Salt",11,10,30,40,4,Tamil Nadu,Lunch,Vegetarian
Rose Buns With Stuffed Mushroom Recipe,"Vivatta Maida, Active Dry Yeast, Lukewarm Water, Sugar, Salt, Sunflower Oil, Button Mushrooms, Onion, Ginger Garlic Paste, Green Chilli, Turmeric Powder, Red Chilli Powder, Sunflower Oil, Salt, Coriander",15,12,35,47,3,Continental,Snack,Vegetarian
Scrambled Paneer Sandwich Recipe,"Paneer, Onion, Green Chilli, Ginger, Mustard Seeds, Kalonji, Turmeric Powder, Fresh Coconut, Curry Leaves, Cashew Nuts, Sunflower Oil, Salt, Whole Wheat Brown Bread",13,10,10,20,3,Fusion,Lunch,High Protein Vegetarian
Stuffed Chicken Recipe With Mixed Vegetables,"Chicken, Tandoori Masala, Curd, Lemon, Salt, Homemade Tomato Puree, Tomato Ketchup, Fresh Cream, Red Chilli Powder, Cashew Nuts, Salt, Potato, Carrot, Green Peas, Chaat Masala Powder, Black Pepper Powder, Coriander, Salt",18,15,45,60,3,Indian,Side Dish,High Protein Non Vegetarian
Black Bean Soup With Mojo Recipe,"Black Beans  Soaked In Water For  Hours, Extra Virgin Olive Oil, Garlic, Onion, Tomato, Green Bell Pepper, Carrot, Cumin Powder, Dried Oregano Fresh Leaves, Red Chilli Flakes Black Pepper Powder, Coriander, Salt, Lemon Juice, Fresh Orange Juice, Extra Virgin Olive Oil, Garlic, Cumin Powder, Dried Oregano Fresh One, Red Chilli Flakes Black Pepper Powder, Salt",20,10,15,25,2,Continental,Side Dish,Vegetarian
Eggs Benedict With Caramelised Onion And Hollandaise Sauce Recipe,"Whole Wheat Brown Bread, Butter, Onion, Salt, Black Pepper Powder, Whole Eggs, Egg Yolks, Lemon Juice, Butter, Red Chilli Powder, Salt",11,10,30,40,2,Continental,World Breakfast,Eggetarian
Guava And Papaya Mimosa Drink Recipe,"Guava Juice, Papaya Juice, Champagne Sparkling Wine, Lemon, Guava, Papaya",6,10,0,10,2,Kerala Recipes,Side Dish,High Protein Vegetarian
Crunchy Vegetables Tortilla Wrap Recipe,"Tortillas, Red Bell Pepper, Yellow Zucchini, Carrots, Cucumber, Onion, Hung Curd, Garlic, Coriander, Black Pepper Powder, Salt",11,10,15,25,4,Mexican,Lunch,Vegetarian
Veggie Pearl Millet Tart Recipe,"Whole Wheat Flour, Bajra Flour, Baking Powder, Sugar, Butter, Sunflower Oil, Chilled Water, Salt, Paneer, Spinach, Red Yellow And Green Bell Peppers, Britannia Cream Cheese, Dried Oregano, Black Pepper Powder, Mozzarella Cheese, Red Chilli Flakes",16,25,40,65,4,Indian,Snack,Vegetarian
Bharwa Baingan Aur Pyaaz Ki Sabzi Recipe - Roz Ka Khana With Figaro Olive Oil,"Small Brinjal, Onion, Figaro Pure Olive Oil, Garlic, Green Chilli, Ginger, Red Chilli Powder, Coriander Powder, Asafoetida, Turmeric Powder, Jaggery, Amchur, Salt",13,15,45,60,4,North Indian Recipes,Lunch,Vegetarian
Skillet Potato And Eggs Recipe,"Potato, Sweet Potato, Garlic, Onion, Extra Virgin Olive Oil, Spring Onion, Italian Seasoning, Whole Eggs, Parsley Leaves, Mozzarella Cheese, Salt And Pepper",11,15,25,40,4,Continental,Brunch,Eggetarian
Dahi Suran Ki Sabzi Recipe (Stir Fried Yam in Dry Yogurt Curry Recipe),"Elephant Yam, Curd, Cumin Seeds, Turmeric Powder, Red Chilli Powder, Garam Masala Powder, Amchur, Salt, Sunflower Oil, Coriander",10,10,30,40,4,North Indian Recipes,Lunch,Vegetarian
Aloo Tikki Stuffed Pita Sandwich Recipe,"Aloo Tikki, Mini Pita Breads, Iceberg Lettuce, Cherry Tomato, Onion, White Vinegar, Fresh Cream, Coriander, Mint Leaves, Extra Virgin Olive Oil, Salt And Pepper",11,15,30,45,4,Fusion,World Breakfast,Vegetarian
Delicious Spicy Chyawanprash Cookies Recipe,"Whole Wheat Flour, Flax Seed Powder, Butter, Brown Sugar, Baking Powder, Water, Dry Ginger Powder, Chyawanprash, Salt, Milk, Caster Sugar",11,20,40,60,6,Continental,Snack,Vegetarian
Goan Style Tonak Alsanyache Recipe (Black eyed beans cooked in Tonak Masala Recipe),"Black Eyed Beans, Potato, Tamarind Water, Turmeric Powder, Salt, Onion, Fresh Coconut, Green Chilli, Garlic, Coriander, Cardamom, Cinnamon Stick, Dry Red Chilli, Whole Black Peppercorns, Cloves, Cumin Seeds",16,70,35,105,4,Goan Recipes,Lunch,Vegetarian
Homemade Paneer Recipe,"Milk, Lemon Juice",2,10,60,70,200,Indian,Dinner,High Protein Vegetarian
Avarekalu Tikki Recipe,"Avarekalu  Lilva Beans, Potato, Sweet Potato, Ginger, Green Chilli, Onion, Coriander Powder, Garam Masala Powder, Cumin Powder, Turmeric Powder, Mint Leaves, Coriander, Sunflower Oil, Salt",14,10,30,40,4,Karnataka,Appetizer,Vegetarian
Egg Stuffed Paratha Recipe,"Whole Wheat Flour, Whole Eggs, Onion, Green Chilli, Coriander, Black Pepper Powder, Sunflower Oil Ghee For Making Parathas, Salt",8,10,20,30,4,Indian,North Indian Breakfast,Vegetarian
Kottambari Tambuli Recipe - Udupi Style Raw Coriander Kadhi,"Curd, Coriander, Fresh Coconut, Green Chilli, Cumin Seeds, Mustard Seeds, White Urad Dal, Dry Red Chilli, Asafoetida, Sunflower Oil, Salt",11,10,5,15,4,Udupi,Side Dish,Vegetarian
Andhra Style Pappu Charu Recipe (Lentil Soup Style Curry),"Arhar Dal, Green Chilli Red Dry Chilli, Garlic, Tomato, Onion, Tamarind Paste, Turmeric Powder, Salt, Ghee, Curry Leaves, Mustard Seeds, Asafoetida",12,16,30,46,4,Andhra,Lunch,High Protein Vegetarian
"Peas, Corn & Paneer Savory Hand Pies Recipe","Green Peas, Sweet Corn, Paneer, Ginger, Sunflower Oil, All Purpose Pie Crust, Cumin Seeds, Asafoetida, Green Chutney, Coriander Powder, Garam Masala Powder, Red Chilli Powder, Fennel Powder, Amchur, Black Pepper Powder, Salt",16,35,15,50,4,Fusion,Appetizer,Vegetarian
Coconut Banana Oatmeal Porridge Recipe,"Instant Oats, Ripe Bananas, Fresh Coconut Tender Coconut, Honey, Milk, Water",6,10,20,30,3,Continental,World Breakfast,Diabetic Friendly
Cucumber Sandwich With Yogurt Dill Spread Recipe,"Whole Wheat Brown Bread, Cucumber, Hung Curd, Dried Oregano, Red Chilli Flakes, Fresh Thyme Leaves, Salt, Dill Leaves",8,15,0,15,2,Continental,Lunch,Vegetarian
Chettinad Beetroot Kurma Recipe,"Beetroots, Green Peas, Onion, Tomato, Ginger, Garlic, Curd, Turmeric Powder, Bay Leaf, Curry Leaves, Coriander, Ghee Oil, Salt, Cloves, Cardamom, Cinnamon Stick, Star Anise, Dry Red Chilli, Cashew Nuts, Coriander, Cumin Seeds, Fennel Seeds",22,10,20,30,4,Chettinad,Lunch,Vegetarian
Palak Chole Recipe (Spinach & Chickpea Curry),"Kabuli Chana, Spinach Leaves, Onion, Tomato, Green Chilli, Ginger, Garlic, Salt, Garam Masala Powder, Turmeric Powder, Red Chilli Powder, Coriander Powder, Bay Leaves, Cardamom",14,20,40,60,4,North Indian Recipes,Lunch,High Protein Vegetarian
Spinach Stir Fry Recipe With Garlic,"Spinach Leaves, Garlic, Butter, Salt, Black Pepper Powder, Mixed Herbs",6,10,14,24,4,Continental,Side Dish,Vegetarian
Tandoori Gobi Tikka Recipe,"Cabbage, Hung Curd, Red Chilli Powder, Garam Masala Powder, Chaat Masala Powder, Turmeric Powder, Coriander Powder, Celery, Kasoori Fenugreek, Flour, Oil, As Per",12,15,60,75,4,North Indian Recipes,Side Dish,Vegetarian
Kondai Kadalai Puli Kuzhambu Recipe -Tangy South Indian Kala Chana Curry,"Kala Chana, Tamarind, Sambar Powder, Jaggery, Mustard Seeds, Methi Seeds, Sesame, Fresh Coconut, Curry Leaves, Salt, Water",11,15,30,45,3,South Indian Recipes,Lunch,High Protein Vegetarian
Karnataka Style Sabsige Soppu Akki Rotti (Dill leaves and flattened Rice Bread Recipe),"Rice Flour, Poha, Dill Leaves, Green Chilli, Cumin Seeds, Salt",6,10,30,40,4,Karnataka,South Indian Breakfast,Vegetarian
Corn And Bell Pepper Sandwich Recipe,"Whole Wheat Brown Bread, Hung Curd, Sweet Corn, Red Bell Pepper, Parsley Leaves, Red Chilli Flakes, Salt",7,10,15,25,2,Continental,Snack,Vegetarian
Enduri Pitha With Mango Twist Recipe,"Rice Flour, Mango, Salt, Baking Soda, Fennel Seeds, Fresh Coconut, Sugar, Ghee, Banana Leaf",9,260,20,280,4,Oriya Recipes,Dessert,Vegetarian
Matar Masala Recipe - Peas In Onion Tomato Gravy,"Green Peas, Sunflower Oil, Cumin Seeds, Turmeric Powder, Red Chilli Powder, Coriander Powder, Kasuri Methi, Salt, Garam Masala Powder, Onion, Tomato, Green Chilli, Garlic, Ginger, Cashew Nuts, Almond Milk",16,20,30,50,3,Indian,Lunch,Vegetarian
Aloo Gajar Matar Sabzi Recipe,"Potato, Carrots, Green Peas, Tomato, Onion, Ginger, Garlic, Ajwain, Turmeric Powder, Red Chilli Powder, Coriander, Garam Masala Powder, Salt, Mustard Oil, Coriander",15,15,45,60,4,North Indian Recipes,Lunch,High Protein Vegetarian
Tangy Tomato Pie Tart Recipe,"Tomato, Garlic, Cheese, Mixed Herbs, Red Chilli Flakes, Extra Virgin Olive Oil, Salt, All Purpose Flour, Butter, Salt, Sugar, Chilled Water",12,30,60,90,4,Continental,Appetizer,Vegetarian
Pudalangai Poriyal Recipe  - Snake Gourd Poriyal Recipe,"Snake Gourd, Onion, Green Chilli, Cumin Powder, Turmeric Powder, Sunflower Oil, Mustard Seeds, Fresh Coconut, Salt, Curry Leaves",10,10,30,40,4,South Indian Recipes,Lunch,Vegetarian
Posto Chicken Recipe - Bengali Chicken In Poppy Seed Paste,"Chicken, Poppy Seeds, Garlic, Ginger, Green Chilli, Onion, Tomato, Red Chilli Powder, Garam Masala Powder, Mustard Oil, Salt, Bay Leaf, Cloves, Cardamom, Cinnamon Stick, Fennel Seeds, Lemon Juice, Ginger, Garlic, Salt, Turmeric Powder, Mustard Oil",22,60,40,100,4,Bengali Recipes,Dinner,High Protein Non Vegetarian
Kasuri Methi Mach Recipe - Dry Fenugreek Flavoured Fish Curry,"Rohu Fish Katlaany Carp, Curd, Kasuri Methi, Turmeric Powder, Ginger, Garlic, Garam Masala Powder, Sugar, Mustard Oil, Salt",10,30,15,45,4,Bengali Recipes,Dinner,High Protein Non Vegetarian
Kerala Style Christmas Plum Cake Recipe,"Raisins, Glazed Cherries, Dried Figs, Tutti Frutti, Badam, Cashew Nuts, Rum Orange Juice, Butter, Ghee, Caster Sugar, Egg Yolks, Vanilla Extract, Candied Orange Peel, Caramel Sauce, Orange, All Purpose Flour, Baking Powder, Baking Soda, Cinnamon Powder, Nutmeg Powder, Cloves, Dry Ginger Powder, Milk, Egg Whites, Lemon Juice, Sugar",26,120,40,160,6,Kerala Recipes,Dessert,Eggetarian
Masala Karela ,"Bitter Gourd, Salt, Onion, Flour, Turmeric Powder, Red Chilli Powder, Cumin Seeds, Coriander Powder, Amchoor Powder, Oil",10,15,30,45,6,Indian,Side Dish,Diabetic Friendly
Kerala Style Chemmeen Moilee Recipe - Prawn Curry,"Shrimps, Pearl Onion, Tomato, Green Chilli, Ginger, Garlic, Cinnamon Stick, Cardamom, Whole Black Peppercorns, Curry Leaves, Coconut Milk, Turmeric Powder, Lemon Juice, Sugar, Salt, Coconut Oil",16,5,25,30,4,Kerala Recipes,One Pot Dish,Non Vegeterian
Mullu Murukku Recipe - Chakli Recipe - South Indian Snack,"Rice Flour, Fresh Cream, Green Chilli, Ginger, Asafoetida, Sesame Seeds, Salt, Water, Sunflower Oil",9,10,40,50,4,Tamil Nadu,Snack,Vegetarian
Peshawari Chole ,"Of Chickpea Chickpeachickpeas, Onion, Tomato, Green Chili, Ginger, Garlic, Salt, Black Tea, Cinnamon, Cardamom, , Coriander Powder, Red Chili Powder, Garam Masala Powder, Lemon Juice, Oil",16,10,40,50,3,Lucknowi,Dinner,High Protein Vegetarian
Pumpkin Sabzi With Panch Phoron Masala ,"Gm Pumpkin, Curry Leaves, Dry Red Chilli, Panch Four Masala, Turmeric Powder, Salt, Mustard Oil",7,10,15,25,4,South Indian Recipes,Lunch,Vegetarian
Thai Fish Cake Recipe,"Basa Fish, Whole Egg, Garlic, Galangal, Onion, Coriander, Thai Red Chilli, Fish Sauce, Thai Red Curry Paste, Lemon Juice, Paprika Powder, Corn Flour, Sunflower Oil, Salt",14,20,10,30,6,Thai,Appetizer,High Protein Non Vegetarian
Bajra Aloo Paratha Recipe,"Bajra Flour, Whole Wheat Flour, Potato, Methi Leaves, Green Chilli, Ginger, Red Chilli Powder, Turmeric Powder, Cumin Seeds, Ajwain, Chaat Masala Powder, Salt, Lukewarm Water, Sunflower Oil",14,20,25,45,4,Indian,Lunch,Vegetarian
Crunchy Carrot Peanut Raita Recipe - Gajar Moongphali Raita,"Carrot, Curd, Raw Peanuts, Dry Red Chilli, Kashmiri Red Chilli Powder, Green Chilli, Salt",7,10,5,15,4,Indian,Lunch,Vegetarian
Egg In A Biscuit Recipe,"All Purpose Flour, Sugar, Baking Powder, Baking Soda, Salted Butter, Cheese, Coriander, Curd, Whole Eggs",9,15,25,40,4,Continental,World Breakfast,Eggetarian
Baked Potato & Peas Samosa With Phyllo Pastry Recipe,"Onion, Potato, Green Peas, Coriander Powder, Cinnamon Powder, Garam Masala Powder, Amchur, Kashmiri Red Chilli Powder, Phyllo Sheets, Sunflower Oil, Butter Ghee For Brushing, Salt",12,20,40,60,4,Indian,Snack,Vegetarian
Eggless Baked Chocolate Chip Coins Recipe,"Whole Wheat Flour, Vivatta Maida, Caster Sugar, Butter, Chocolate Chips, Vanilla Extract, Baking Soda, Baking Powder, Milk, Sunflower Oil Brush",10,15,30,45,25,Continental,Snack,Vegetarian
Carrot Lemon Rice Recipe,"Cooked Rice, Carrot, Sunflower Oil, Mustard Seeds, Green Chilli, White Urad Dal, Curry Leaves, Lemon Juice, Dessicated Coconut, Turmeric Powder, Salt",11,20,45,65,4,South Indian Recipes,Lunch,Vegetarian
Whole Wheat Homemade English Muffins Recipe,"All Purpose Flour, Whole Wheat Flour, Active Dry Yeast, Sugar, Salt, Butter, Milk, Corn Meal Semolina For Dusting",8,120,30,150,6,Continental,World Breakfast,Vegetarian
Roasted Vegetable Flan Recipe In Herbed Sauce,"Extra Virgin Olive Oil, Garlic, Button Mushrooms, Green Peas, Carrots, Sweet Corn, Black Pepper Powder, Paprika Powder, Nutmeg, Vegetable Stock, Heavy Whipping Cream, Butter, Parmesan Cheese, Egg Yolks, Parsley Leaves, Handful Walnuts, Salt And Pepper",17,15,60,75,6,Italian Recipes,Dinner,Eggetarian
Mushroom Biryani Recipe,"Basmati Rice, Button Mushrooms, Onion, Tomato, Ginger, Garlic, Green Chilli, Coconut Milk, Coriander, Red Chilli Powder, Coriander Powder, Turmeric Powder, Garam Masala Powder, Sunflower Oil, Cinnamon Stick, Cardamom, Bay Leaf",17,20,30,50,4,Indian,One Pot Dish,Vegetarian
Gawar Ki Sabzi Recipe - Cluster Beans Curry,"Gawar Phali, Sunflower Oil, Ajwain, Onion, Tomato, Garlic, Ginger, Coriander Powder, Red Chilli Powder, Turmeric Powder, Salt, Coriander",12,10,20,30,4,Rajasthani,Lunch,Vegetarian
Curried Couscous Recipe,"Couscous, Spinach, Green Beans, Green Peas, Celery, Onion, Tomato, Garlic  Minced, Curd, Turmeric Powder, Curry Powder, Salt, Paprika Powder, Extra Virgin Olive Oil",14,10,20,30,2,Continental,World Breakfast,High Protein Vegetarian
Gujarati Style Lapsi Recipe - Millet Sweet Pudding,"Foxtail Millet, Yellow Moong Dal, Cardamom Powder, Jaggery, Ghee, Cashew Nuts",6,5,30,35,4,Gujarati Recipesï»¿,Dessert,Vegetarian
Chilli Egg In Soya Sauce Recipe,"Whole Eggs, Ginger Paste, Corn Flour, Soy Sauce, Black Pepper Powder, Onion, Salt, Ginger, Green Bell Pepper, Garlic, Green Chilli, Spring Onion Greens, Dark Soy Sauce, Corn Flour, Sesame, Salt, Salt",17,10,20,30,4,Asian,Dinner,Eggetarian
Kale & Leeks Frittata Recipe,"Whole Eggs, Parmesan Cheese, Provolone Cheese, Fresh Thyme Leaves, Dried Oregano, Leek, Extra Virgin Olive Oil, Clove Garlic, Onion, Ricotta Cheese, Kale, Salt And Pepper",12,15,20,35,4,Italian Recipes,World Breakfast,Vegetarian
Goan Style Mushroom Vindaloo ,"Button Mushroom, Onion, Garlic, Ginger, Turmeric Powder, Oil, Salt, Dry Red Chilli, Teaspoon Coriander Seeds, Cumin Seeds, Whole Black Pepper Corn, Green Cardamom, ",13,20,30,50,4,Goan Recipes,Dinner,Vegetarian
Moong Sprouts And Sweet Potato Cutlet Recipe,"Green Moong Sprouts, Sweet Potato, Instant Oats, Ginger Garlic Paste, Turmeric Powder, Red Chilli Powder, Garam Masala Powder, Cumin Powder, Amchur, Salt, Sunflower Oil",11,15,15,30,4,Indian,Snack,Vegetarian
Andhra Style Allam Pachadi (Ginger Chutney Recipe),"Chana Dal, White Urad Dal, Dry Red Chilli, Coriander, Ginger, Onion, Tomato, Salt, Mustard Seeds, Curry Leaves, Asafoetida, Sunflower Oil",12,10,20,30,4,Andhra,South Indian Breakfast,Vegetarian
Croquettes Recipe With Bhetki Fish,"Bhetki Fish, Onion, Onion, Garlic, Garlic, Green Chilli, Bay Leaves, Cinnamon Stick, Cardamom, Tomato Ketchup, Sugar, Sunflower Oil, Salt, Potato, Black Pepper Powder, Salt, Whole Egg, All Purpose Flour, Whole Wheat Bread Crumbs, Sunflower Oil",20,15,45,60,4,Indian,Appetizer,Non Vegeterian
Sagu Masala Dosa Recipe,"White Urad Dal, Red Matta Rice, Dosa Rice, Poha, Chana Dal, Arhar Dal, Methi Seeds, Rice Flour, Salt, Sugar, Carrots, Green Beans, Turnips, Kaddu, Chana Dal, Tamarind Paste, Jaggery, Coriander, Sunflower Oil, Cumin Seeds, Coriander, Byadagi Dried Chilli, Guntur Dried Chilli, Cinnamon Stick, Turmeric Powder, Fresh Coconut, Onion, Mustard Seeds, Dry Red Chilli, Asafoetida, Curry Leaves, Salt, Roasted Gram Dal, Byadagi Dried Chilli, Fresh Coconut, Tamarind Paste, Garlic, Salt",38,25,30,55,4,Karnataka,South Indian Breakfast,Vegetarian
Mediterranean Tomato Basil Sandwich Recipe With Sweet PiquantÃ© Pepper,"Whole Wheat Brown Bread, Homemade Hummus, Green Chilli Paste, Coriander, Lemon Juice, Cucumber, Red Onion, Tomato, Sweet PiquantÃ© Pepper, Salt And Pepper, Lettuce Leaves, Feta Cheese, Summac",13,15,10,25,4,Mediterranean,Main Course,High Protein Vegetarian
Vegetable Coconut Milk Soup With Vermicelli Noodles Recipe,"Vegetable Stock, Coconut Milk, Lemongrass, Fresh Red Chilli, Coconut Sugar, Lemon, Soy Sauce, Carrot, Green Zucchini, Garlic, Tofu, Button Mushrooms, Coriander, Ginger, Cherry Tomato, Rice Vermicelli Noodles, Salt",17,10,20,30,4,Asian,Side Dish,Vegetarian
Methi Pakoras Recipe,"Gram Flour, Rice Flour, Salt, Methi Leaves, Red Chilli Powder, Asafoetida, Turmeric Powder, Ajwain, Coriander, Sunflower Oil",10,20,30,50,4,Indian,Snack,Vegetarian
Spinach Dates & Banana Smoothie Recipe,"Spinach, Ripe Bananas, Chia Seeds, Badam, Dates, Water, Ice Cubes",7,10,5,15,2,Continental,Snack,High Protein Vegetarian
Milagu Jeera Curry Leaf Sadam Recipe,"Cooked Rice, Mustard Seeds, White Urad Dal, Raw Peanuts, Salt, Whole Black Peppercorns, Cumin Seeds, Curry Leaves, Sesame",9,10,15,25,2,South Indian Recipes,Lunch,Vegetarian
Chettinad Muttai Paniyaram Recipe | Egg Paniyaram Recipe,"Idli Dosa Batter, Whole Eggs, Onion, Green Chilli, Curry Leaves, Mint Leaves, Mustard Seeds, Turmeric Powder, Whole Black Pepper Corns, Fresh Coconut, Salt, Sesame",12,10,30,40,20,Tamil Nadu,South Indian Breakfast,Eggetarian
Healthy Vegetable Poha Cutlet Recipe -Vegetable Beaten Rice Patty,"Poha, Potato, Paneer, Carrot, Black Pepper Powder, Garam Masala Powder, Chaat Masala Powder, Red Chilli Powder, Ginger, Green Chilli, Lemon Juice, All Purpose Flour, Coriander, Whole Wheat Bread Crumbs, Sunflower Oil, Salt",16,15,40,55,4,North Indian Recipes,Snack,Eggetarian
Evergreen Smoothie Recipe,"Spinach Leaves, Bottle Gourd, Curd, Mint Leaves, Rock Salt, Ajwain, Amla, Lemon Juice",8,15,10,25,1,Continental,World Breakfast,Vegetarian
Chocolate Nutella Lava Cookies Recipe,"All Purpose Flour, Butter, Sugar, Brown Sugar, Whole Eggs, Cocoa Powder, Baking Soda, Corn Flour, Salt, Vanilla Extract, Nutella Spread, Chocolate Chips",12,20,60,80,5,Continental,Snack,Vegetarian
Rasgulla Custard Pudding Recipe,"Rasgulla, Rasgulla Syrup, Milk, Custard Powder, Rose Water, Pistachios",6,10,20,30,5,North Indian Recipes,Dessert,Vegetarian
Masala Vada Curry Recipe - Chana Dal Vada Curry Recipe,"Chana Dal, Dry Red Chilli, Curry Leaves, Fennel Seeds, Sunflower Oil, Cinnamon Stick, Cloves, Cardamom, Whole Black Pepper Corns, Bay Leaf, Green Chilli, Curry Leaves, Onion, Ginger, Garlic, Homemade Tomato Puree, Turmeric Powder, Red Chilli Powder, Coriander Powder, Salt, Mint Leaves",21,30,30,60,3,South Indian Recipes,Lunch,Vegetarian
Vanilla Flavored Kunafa Recipe,"Kunafa Pastry, Butter, Sugar, Vanilla Extract, Milk, Corn Flour, Sugar, Vanilla Extract, Sugar, Water",10,30,20,50,4,Mediterranean,Dessert,Vegetarian
Karwar Style Madgane Recipe With Oats & Rajgira,"Chana Dal, Water, Instant Oats, Fresh Coconut  Grated, Jaggery, Rice Flour, Rajgira Flour, Cardamom Powder, Cashew Nuts, Dates, Raisins, Ghee, Salt",13,15,40,55,8,Karnataka,Dessert,Vegetarian
Leftover Dal Paratha Recipe,"Arhar Dal, Whole Wheat Flour, Kashmiri Red Chilli Powder, Salt, Curd, Coriander, Onion, Ghee Oil As Required",8,20,25,45,4,Indian,Indian Breakfast,High Protein Vegetarian
Punjabi Kadhi Pakora Recipe - Delicious Punjabi Kadhi,"Gram Flour, Green Chilli, Onion, Potato, Ajwain, Cooking Soda, Salt, Water Combine The Ingredients, Sunflower Oil, Curd, Gram Flour, Turmeric Powder, Green Chilli, Ginger, Water, Salt, Ghee, Mustard Seeds, Curry Leaves, Red Chilli Powder, Dry Red Chilli, Asafoetida, Coriander",23,10,40,50,4,Punjabi,Dinner,Vegetarian
Carrot Cake Parfait With Custard And Strawberries Recipe,"Sugar, Brown Sugar, Sunflower Oil, Whole Eggs, All Purpose Flour, Whole Wheat Flour, Cinnamon Powder, Baking Soda, Vanilla Extract, Salt, Carrots, Raisins, Walnuts, Badam, Milk, Custard Powder, Sugar, Strawberries, Sugar, Lemon Juice, Strawberries, Walnuts, Cinnamon Powder",23,10,40,50,3,Continental,Dessert,Vegetarian
Herbed Vegetables In Roasted Bell Pepper Sauce Recipe,"Extra Virgin Olive Oil, Carrots, Yellow Zucchini, Baby Corn, Button Mushrooms, Dry Mix Herbs, Red Bell Pepper, Pickled Jalapenos, Whole Black Pepper Corns, Salt, Extra Virgin Olive Oil, Garlic, Homemade Tomato Puree, Fresh Cream",14,15,40,55,4,Continental,Main Course,Vegetarian
Prawns Coconut Curry Recipe,"Prawns, Coconut Milk, Coconut Milk, Fennel Seeds, Black Pepper Powder, Coriander Powder, Red Chilli Powder, Turmeric Powder, Green Chilli, Curry Leaves, Coriander, Tamarind Paste, Ginger, Garlic, Tomato, Onion, Mustard Seeds, Salt, Coconut Oil",19,15,30,45,4,South Indian Recipes,Lunch,Non Vegeterian
Pudina Khara Pongal Recipe,"Rice, Yellow Moong Dal, Mint, Coriander, Green Chili, Ginger, Cumin Seeds, Water, Oil, Salt, Ghee, Cashews, Cumin Seeds, Whole Pepper, Curry Leaves, Asafetida",16,10,20,30,4,South Indian Recipes,South Indian Breakfast,High Protein Vegetarian
Tandoori Paneer Tikka Masala ,"G Paneer, Coals, Tomato Puree, Cream, Mint, Bud Garlic, Ginger, Fennel, Celery, Saffron, Little  Cumin Powder, Coriander Powder, Chaat Masala Powder, Garam Masala Powder, Black Pepper Powder, Red Chilli Powder, Black Saltrock Salt, Turmeric Powder, Salt, Salt",20,20,40,60,4,North Indian Recipes,Side Dish,High Protein Vegetarian
Lauki Wadi Tarkari Recipe - Bengali Style Moong Dal Dumplings & Bottle Gourd Sabzi,"Yellow Moong Dal, Ginger, Cumin Seeds, Red Chilli Powder, Asafoetida, Salt, Bottle Gourd, Tomato, Onion, Green Chilli, Ginger, Panch Phoran Masala, Turmeric Powder, Coriander Powder, Salt, Sugar, Mustard Oil, Sunflower Oil Fry Wadis, Coriander",19,10,25,35,4,Bengali Recipes,Side Dish,High Protein Vegetarian
Mushroom and Broccoli Soup Recipe,"Broccoli, Button Mushroom, Cumin, Whole Pepper, Salt, Cream, Coriander, Oil",8,20,20,40,4,Continental,Appetizer,Vegetarian
Red Lentil Curry Without Coconut Recipe,"Masoor Dal, Tomato, Onion, Garlic, Ginger, Green Chilli, Kasuri Methi, Sunflower Oil, Red Chilli Powder, Salt, Turmeric Powder, Garam Masala Powder, Coriander Powder, Cumin Powder",14,20,30,50,5,Indian,Lunch,High Protein Vegetarian
Aloo Gobi Sabzi Recipe - Potato And Cauliflower Dry Curry,"Cauliflower, Potato, Curry Leaves, Coriander Powder, Garam Masala Powder, Red Chilli Powder, Turmeric Powder, Asafoetida, Salt, Sunflower Oil Ghee, Kasuri Methi, Lemon Wedges",12,10,20,30,4,North Indian Recipes,Lunch,Vegetarian
Semiya Payasam Recipe - Vermicelli Kheer Recipe,"Milk, Semiya, Water, Sugar, Cashew Nuts, Raisins, Cardamom Powder, Saffron Strands, Ghee",9,15,30,45,4,Indian,Dessert,Vegetarian
Raw Mango Dhokla Recipe Topped With Sweet Mango Chutney,"Mango, Mustard Seeds, Dry Red Chilli, Panch Phoran Masala, Cumin Seeds, Fennel Seeds, Kalonji, Methi Seeds, Mustard Seeds, Sunflower Oil, Jaggery, Salt, Gram Flour, Turmeric Powder, Salt, Sugar, Enos Fruit Salt, Mango, Sunflower Oil",19,20,40,60,5,Gujarati Recipesï»¿,Snack,High Protein Vegetarian
No Onion No Garlic Lauki Paneer Kofta Curry Recipe,"Bottle Gourd, Paneer, Turmeric Powder, Garam Masala Powder, Rajgira Flour, Salt Rock Salt, Tomato, Green Chilli, Bay Leaf, Cinnamon Stick, Cardamom, Turmeric Powder, Coriander Powder, Curd, Salt Rock Salt, Coriander, Sunflower Oil",17,25,45,70,5,North Indian Recipes,Dinner,High Protein Vegetarian
Rajasthani Style Mutton Banjara Recipe,"Mutton, Sunflower Oil, Onion, Garlic, Ginger, Red Chilli Powder, Coriander Powder, Turmeric Powder, Curd, Coriander, Bay Leaf, Cloves, Whole Black Peppercorns, Dry Red Chilli, Cinnamon Stick, Salt",16,20,30,50,4,Rajasthani,Dinner,Non Vegeterian
Ulundogorai - Spicy Urad Dal flavoured Rice (for Prashad & Naivedyam) Recipe,"Rice, Salt, Sunflower Oil, Few Whole Black Peppercorns, Black Urad Dal, Fresh Red Chilli, Asafoetida, Black Pepper Powder, Sunflower Oil, White Urad Dal, Mustard Seeds, Cashew Nuts, Curry Leaves, Ghee",14,15,30,45,4,South Indian Recipes,Lunch,Vegetarian
Creamy Radish Soup Recipe With Sweet Potato,"Red Baby Radish, Sweet Potato, Onion, Fennel Seeds, Ajwain, Black Pepper Powder, Bay Leaves, Vegetable Stock, Sunflower Oil, Salt, Hung Curd, Coriander, Mooli Mullangi",13,10,15,25,4,Continental,Appetizer,Vegetarian
Crispy Chicken Nuggets Recipe - KFC Style,"Chicken Breasts, Buttermilk, Salt, Black Pepper Powder, All Purpose Flour, Whole Eggs, Whole Wheat Bread Crumbs, Corn Flakes, Dried Oregano, Black Pepper Powder, Salt, Garlic Powder, Onion Powder, Paprika Powder, Sunflower Oil",15,10,30,40,3,Continental,Appetizer,High Protein Non Vegetarian
Light And Healthy Spinach Soup Recipe,"Spinach Leaves, Extra Virgin Olive Oil, Clove Garlic, Stalk Coriander, Milk, Vegetable Stock Water, Black Pepper Powder, Salt",8,10,30,40,4,Continental,Appetizer,Vegetarian
Malwani Pumpkin And Raw Mango Curry Recipe,"Mango, Kaddu, Green Chilli, Ginger, Dry Red Chilli, Cumin Seeds, Fennel Seeds, Methi Seeds, Whole Black Peppercorns, Coriander, Fresh Coconut, Sunflower Oil",12,10,30,40,4,Malvani,Dinner,Vegetarian
Tangy Tamarind Pumpkin Curry ,"Pumpkin, Oil, Mustard, Cumin Seeds, Ginger, Garlic, Green Chilli, Onion, Curry Leaves, Red Chilli Powder, Turmeric Powder, Coriander Powder, Salt, Water, Tamarind, Jaggery",16,20,30,50,4,Indian,Dinner,Vegetarian
Sweet Chili & Orange Chicken Recipe,"Chicken Breasts, Onion, Garlic, Salt, Sunflower Oil, Fresh Orange Juice, Red Chilli Sauce, Corn Flour, Black Pepper Powder",9,10,30,40,4,Continental,Dinner,High Protein Non Vegetarian
Kashmiri Style Chaman Recipe-Qaliya Cottage Cheese Curry,"Paneer, Mustard Oil Refined Oil As Required, Saffron Strands, Bay Leaf, Cinnamon Stick, Cloves, Milk, Water, Turmeric Powder, Cumin Powder, Fennel Powder, Salt, Cardamom Powder, Coriander",14,20,25,45,4,Kashmiri,Dinner,Vegetarian
Focaccia Bread with Sweet Onion and Capers Recipe,"Whole Wheat Flour, Active Dry Yeast, Sugar, Extra Virgin Olive Oil, Milk, Salt, Onion, Capers, Fresh Thyme Leaves, Dried Oregano",10,120,30,150,4,Italian Recipes,Side Dish,Vegetarian
Baked Bhakarwadi Recipe,"All Purpose Flour, Gram Flour, Turmeric Powder, Kashmiri Red Chilli Powder, Ghee, Salt, Water Knead, Poppy Seeds, Sesame Seeds, Dessicated Coconut, Ginger, Green Chilli, Coriander Powder, Garam Masala Powder, Turmeric Powder, Cumin Powder, Ajwain, Asafoetida, Coriander, Mint Leaves, Sugar, Lemon, Sunflower Oil",23,20,40,60,6,Maharashtrian Recipes,Snack,Vegetarian
Gul Poli Recipe (Maharashtrian Jaggery & Sesame Stuffed Flatbread),"Whole Wheat Flour, All Purpose Flour, Sunflower Oil, Salt, Lukewarm Water, Jaggery, Gram Flour, Ghee, Sesame Seeds, Poppy Seeds, Cardamom Powder, Water, Ghee Serve",13,40,40,80,6,Maharashtrian Recipes,Dessert,Vegetarian
Vatana Bateta Na Rotla Recipe - Gujarati Peas and Potato Roti,"Potato, Green Peas, Rice Flour, Fresh Coconut, Coriander, Green Chilli, Ginger, Sugar, Lemon Juice, Sesame Seeds, Turmeric Powder, Asafoetida, Sunflower Oil, Salt",14,20,40,60,4,Gujarati Recipesï»¿,Snack,Vegetarian
Mutton Chaap Recipe - Slow Cooked Lamb Chops,"Mutton, Onion, Ginger, Garlic, Black Cardamom, Cardamom, Cinnamon Stick, Fresh Red Chilli, Cloves, Mace Powder, Kashmiri Red Chilli Powder, Turmeric Powder, Cumin Powder, Whole Black Peppercorns, Mustard Oil, Curd, Salt",17,140,40,180,4,Mughlai,Main Course,High Protein Non Vegetarian
Lemongrass Tofu and Vegetable Curry Recipe,"Tofu, Carrots, Green Peas, Broccoli, Red Bell Pepper, Turmeric Powder, Chinese  Spice Powder, Coconut Milk, Homemade Tomato Puree, Sesame, Stalk Lemon Grass, Spring Onion Greens, Fresh Red Chilli, Ginger, Garlic",15,15,40,55,4,Fusion,Side Dish,Vegetarian
Ghee Tooria Per Eda Recipe - Parsi Style Ridge Gourd With Fried Eggs,"Ridge Gourd, Whole Eggs, Onion, Green Chilli, Ginger, Cumin Seeds, Red Chilli Powder, Cumin Powder, Garam Masala Powder, Black Pepper Powder, Sunflower Oil, Salt",12,10,20,30,4,Parsi Recipes,Indian Breakfast,Eggetarian
Milagai Podi Uthappam Recipe - Spicy Chilli Powder Pancake Recipe,"White Urad Dal, Chana Dal, Sesame Seeds, Dry Red Chilli, Curry Leaves, Garlic, Asafoetida, Salt, Idli Dosa Batter, Sesame",10,5,15,20,10,Tamil Nadu,South Indian Breakfast,Vegetarian
Rajasthani Style Safed Maas Recipe,"Mutton, Bay Leaf, Cinnamon Stick, Cloves, Cardamom, Dry Red Chilli, Ginger Garlic Paste, Milk, Curd, Salt, Badam, Cashew Nuts, Onion",13,10,45,55,4,Rajasthani,Lunch,Non Vegeterian
Eggless Rich Chocolate Brownies Recipe,"Dark Chocolate, Butter, Brown Sugar, Vanilla Extract, All Purpose Flour, Cocoa Powder, Baking Powder, Salt, Walnuts, Flax Seed Powder, Chilled Water",11,5,45,50,4,Continental,Dessert,Vegetarian
Chilled Sweet & Sour Cucumber Noodle Salad Recipe,"Cucumbers, Red Chilli Flakes, Vinegar, Soy Sauce, Brown Sugar, Extra Virgin Olive Oil, Sesame Seeds, Black Sesame Seeds",8,15,0,15,4,Asian,Appetizer,Vegetarian
Cucumber Neer Dosa Recipe-Rice Pancake,"Dosa Rice, Cucumber, Fresh Coconut, Salt, Sunflower Oil",5,150,45,195,4,Mangalorean,South Indian Breakfast,Vegetarian
Eggless Chocolate Chip And Honey Cookies Recipe,"All Purpose Flour, Caster Sugar, Honey, Vanilla Extract, Butter, Chocolate Chips",6,20,25,45,4,Continental,Snack,Vegetarian
Rajasthani Mirchi Bada Recipe - Chilli Fritters,"Green Chilli, Potato, Gram Flour, Ajwain, Red Chilli Powder, Garam Masala Powder, Chaat Masala Powder, Amchur, Black Salt, Cumin Powder, Coriander, Green Chilli, Chaat Masala Powder, Salt, Sunflower Oil Deep Fry",15,15,30,45,4,Rajasthani,Snack,Vegetarian
Andhra Style Bangaladumpa Vepudu Recipe - Potato Fry Recipe,"Potato, Onion, Garlic, Mustard Seeds, White Urad Dal, Curry Leaves, Cumin Seeds, Red Chilli Powder, Turmeric Powder, Coriander Powder, Cumin Powder",11,10,15,25,4,Andhra,Lunch,Vegetarian
Rajasthani Curry with Corn Papad ,"Rabodi, Tomato Puree, Capsicum, Onion, Garlic, Turmeric Powder, Red Chili Powder, Coriander Powder, Garam Masala Powder, Salt, Oil",11,10,30,40,2,Rajasthani,Lunch,Vegetarian
Awadhi Style Khatti Arbi Ka Salan ,"Gm Arabic, Onion Grind, Onion, Ginger, Garlic, Red Chilli Powder, Turmeric Powder, Garam Masala Powder, Coriander Powder, Cardamom, Cinnamon, , Yogurt, Salt, Ghee, Rose Leaves",16,10,20,30,4,Awadhi,Lunch,Diabetic Friendly
Avocado Cheese Chilli Toast Recipe,"Whole Wheat Brown Bread, Butter, Classic Mayonnaise, Black Pepper Powder, Tomato, Avocado, Cup Cheese, Red Chilli Flakes",8,10,10,20,2,Continental,Snack,Vegetarian
Indian Spiced Brussel Sprouts Sabzi Recipe (Brussel Sprouts Stir Fry),"Brussel Sprouts, Onion, Red Bell Pepper, Homemade Tomato Puree, Sunflower Oil, Mustard Seeds, Cumin Seeds, Cumin Powder, Coriander Powder, Red Chilli Powder, Turmeric Powder, Garam Masala Powder, Bay Leaf, Ginger, Garlic, Salt, Coriander",17,10,30,40,4,Indian,Lunch,High Protein Vegetarian
Moong Matar Kebab Recipe - Green Lentil And Peas Kebab,"Green Moong Dal, Green Peas, Green Chilli, Onion, Gram Flour, Mint Leaves, Garlic, Ginger, Coriander, Cumin Powder, Garam Masala Powder, Salt, Sunflower Oil",13,60,15,75,15,Lucknowi,Appetizer,High Protein Vegetarian
Pomegranate Sauce Recipe,"Pomegranate Juice, Anardana Powder, Red Wine, Butter, Garlic, Whole Black Peppercorns, Jaggery, Salt, Rosemary",9,0,40,40,10,Continental,Appetizer,High Protein Vegetarian
Gluten-Free Mango and Coconut Milk Ice-Cream Recipe,"Mango, Condensed Milk, Coconut Milk, Mint Leaves",4,20,30,50,4,Continental,Dessert,Gluten Free
Polenta Pizza With Vegetables Recipe,"Makki Ka Atta, Milk, Water, Whole Black Peppercorns, Extra Virgin Olive Oil, Salt, Homemade Pizza And Pasta Sauce As Required, Red Yellow And Green Bell Peppers, Button Mushrooms, Mixed Herbs, Onion, Cheese",12,10,60,70,2,Italian Recipes,Main Course,Vegetarian
Baby Corn and Green Peas Sabzi Recipe,"Baby Corn, Green Peas, Onion, Green Chilli, Ginger, Mustard Seeds, Asafoetida, Turmeric Powder, Cumin Seeds, Red Chilli Powder, Garam Masala Powder, Salt, Sunflower Oil, Curry Leaves, Coriander",15,10,30,40,4,South Indian Recipes,Lunch,Vegetarian
Roasted Eggplant Parmigiana Recipe,"Brinjal, Tomato Basil Pasta Sauce, S Basil Leaves, Mozzarella Cheese, Parmigiano Reggiano Cheese, Whole Wheat Bread Crumbs, Salt And Pepper",7,30,45,75,4,Italian Recipes,Side Dish,Vegetarian
Karnataka Style Kashi Halwa Recipe With Ash Gourd,"Vellai Poosanikai, Sugar, Cardamom Powder, Saffron Strands, Cashew Nuts, Ghee",6,10,30,40,4,Karnataka,Dessert,Vegetarian
Veg Tunday Kabab Recipe,"Paneer, Curd, Onion, Garlic, Ginger, Green Chilli, Bay Leaf, Kalonji, Cumin Seeds, Coriander, Turmeric Powder, Black Pepper Powder, Cloves, Cardamom, Cinnamon Stick, Yellow Mustard Seeds, Sesame Seeds, Methi Seeds, Fennel Seeds, Amchur, Red Chilli Powder, Star Anise, Anardana Powder, Black Salt, Saffron Strands, Sunflower Oil, Salt",27,100,20,120,4,Indian,Appetizer,Vegetarian
Kesar Pista Kulfi Recipe,"S Milk, Sugar, Saffron Strands, Cardamom Powder, Pistachios",5,60,35,95,4,North Indian Recipes,Dessert,Vegetarian
Crispy Palak Pakora Recipe - Made In Kuzhi Paniyaram Pan,"Gram Flour, Rice Flour, Spinach, Onion, Green Chilli, Garlic, Ginger, Fennel Seeds, Enos Fruit Salt, Ssp Asafoetida, Salt, Sunflower Oil, Chaat Masala Powder",13,10,20,30,4,North Indian Recipes,Snack,Vegetarian
Dahi Wale Aloo ,"Potato, , Flour, Asafoetida, Cumin Seeds, Curry Leaves, Onion, Ginger, Garlic, Green Chilli, Red Chilli Powder, , Turmeric Powder, Salt, Oil, Coriander",16,10,45,55,4,North Indian Recipes,Lunch,Vegetarian
Karamani Poriyal ,"Cowpea Pods, Coconut, Turmeric Powder, Mustard, White Urad Dal, Asafoetida, Oil, Curry Leaf  Salt, Salt",9,10,20,30,4,South Indian Recipes,Lunch,Vegetarian
Chow Chow Curry Recipe,"Chow Chow, Rye, White Urad Dal, Asafoetida, Turmeric Powder, Curry Leaves, Oil, According",8,10,40,50,4,South Indian Recipes,Lunch,Vegetarian
Shehenshahi Parsi Keema Pulao Recipe,"Basmati Rice, Mutton, Onion, Ginger, Garlic, Green Chilli, Curd, Sunflower Oil, Ghee, Salt, Coriander Powder, Red Chilli Powder, Cloves, Whole Black Peppercorns, Bay Leaves, Ajwain, Cardamom, Black Cardamom, Cinnamon Stick, Star Anise, Green Chilli, Mint Leaves, Coriander, Cashew Nuts, Raisins, Lemon Juice, Saffron Strands, Whole Eggs, Onion",29,20,65,85,4,Parsi Recipes,Dinner,Non Vegeterian
Sorakkai Puli Kuzhambu Recipe - Tangy Bottle Gourd Curry,"Bottle Gourd, Shallots, Drumstick, Tomato, Garlic, Ginger, Tamarind Water, Sambar Powder, Salt, Sesame, Mustard Seeds, Methi Seeds, Curry Leaves",13,20,30,50,4,South Indian Recipes,Side Dish,Vegetarian
Vegan Navratan Korma ,"Carrots, Green Beans, Cabbage, Potato, Tofu, Onion, Green Chilies, Tablespoon Ginger Garlic Paste, Turmeric Powder, Red Chilli Powder, Cardamom Powder, Large Cardamom, , Ginger, Coconut Curd, Coconut Milk, Mint, Saffron, Silver Work, Pineapple, Kisameys, Cashew Nuts  Take It, Almond, Pistachios, Garam Masala Powder, Coconut Oil, , Cashew Nuts, Almonds",29,60,30,90,4,North Indian Recipes,Lunch,Vegan
Coriander Garlic Baked Chicken Recipe,"Chicken Legs, Onion, Coriander, Green Chilli, Ginger, Garlic, Cumin Seeds, Salt, Sunflower Oil, Mixed Vegetables",10,15,30,45,4,Indian,Dinner,High Protein Non Vegetarian
Coconut French Toast with Chocolate Chips Recipe,"Milk, Fresh Cream, Whole Eggs, Vanilla Extract, Nutmeg Powder, Salt, Caster Sugar, Fresh Coconut, Butter, Whole Wheat Brown Bread, Maple Syrup Chocolate Syrup",11,10,40,50,4,Continental,World Breakfast,Eggetarian
Roasted Bell Pepper Rasam Recipe,"Tamarind Water, Arhar Dal, Rasam Powder, Garlic, Fennel Seeds, Whole Black Peppercorns, Green Bell Pepper, Tomato, Curry Leaves, Sunflower Oil, Mustard Seeds, Asafoetida, Curry Leaves, Dry Red Chilli",14,5,45,50,4,Tamil Nadu,Lunch,Vegetarian
Green Chana Chutney Recipe,"Green, Green Chilli, Garlic, Salt, Water, Oil, Cumin Seeds, Yogurt",8,5,10,15,4,Rajasthani,Side Dish,Vegetarian
Gingerbread Pancake Recipe,"Whole Wheat Flour, Baking Powder, Cinnamon Powder, Dry Ginger Powder, Clove Powder, Nutmeg Powder, Whole Eggs, Butter, Milk, Brown Sugar, Maple Syrup Serve",11,15,20,35,4,Continental,World Breakfast,Eggetarian
Punjabi Style Lobia Masala Recipe (Black Eyed Peas Masala),"Black Eyed Beans, Sunflower Oil, Cumin Seeds, Fennel Seeds, Cinnamon Stick, Onion, Green Chilli, Ginger Garlic Paste, Red Chilli Powder, Turmeric Powder, Salt, Coriander Powder, Garam Masala Powder, Cumin Powder, Sugar, Tamarind Paste, Homemade Tomato Puree, Milk",18,120,45,165,4,Punjabi,Lunch,High Protein Vegetarian
Peanut Curry ,"Peanuts, Coconut, Green Chilli, Red Chili Powder, Jaggery, , Kokum, Curry Leaves, Ghee, Cumin, Water, Salt",12,15,20,35,4,Indian,Lunch,High Protein Vegetarian
Roasted Peppers And Mushroom Tortilla Pizza Recipe,"Tortillas, Homemade Marinara Sauce, Extra Virgin Olive Oil, Garlic, Mozzarella Cheese, Red Yellowgreen Bell Pepper, Onion, Kalmatta Olives, Button Mushrooms",9,15,15,30,2,Mexican,Dinner,Vegetarian
Red Chilli Pesto & Roasted Tomato Spaghetti Pasta Recipe,"Dry Red Chilli, Pine Nuts, Parmesan Cheese, Cumin Powder, Garlic, Basil Leaves, Tomato, Extra Virgin Olive Oil, Salt, Spaghetti Pasta",10,15,30,45,4,Italian Recipes,Dinner,Vegetarian
Uparghi Laadu Recipe - Whole Wheat Flour & Banana Squares,"Cups Whole Wheat Flour, Sunflower Oil, Ghee, Water, Jaggery, Ghee, Ripe Bananas, Caster Sugar",8,10,30,40,3,Gujarati Recipesï»¿,Dessert,Vegetarian
Mangalorean Neer Dosa Recipe-Savory Rice & Coconut Crepe,"Broken Raw Rice, Fresh Coconut, Salt, Sunflower Oil Grease The Pan",4,20,30,50,4,Mangalorean,South Indian Breakfast,Vegetarian
Andhra Style Munakkada Masala Kura Recipe - Drumstick Dry Curry Recipe,"Drumstick, Onion, Ginger Garlic Paste, Red Chilli Powder, Turmeric Powder, Salt, Roasted Peanuts, Coriander, Cloves, Cinnamon Stick, Fresh Coconut, Tomato",12,10,45,55,4,Andhra,Lunch,Vegetarian
Kasuri Methi Chole Recipe,"Kabuli Chana, Kasuri Methi, Tomato, Cashew Nuts, Red Chilli Powder, Turmeric Powder, Garam Masala Powder, Bay Leaf, Sunflower Oil, Green Chilli, Salt, Cinnamon Stick, Cloves, Cumin Seeds, Coriander",15,15,20,35,4,Punjabi,Lunch,High Protein Vegetarian
Dal Vangi Recipe - Spicy Lentils with Roasted Eggplant,"Arhar Dal, Brinjal, Green Chilli, Garlic, Cumin Seeds, Dry Coconut, Kokum, Jaggery, Maharashtrian Goda Masala, Asafoetida, Curry Leaves, Mustard Seeds, Turmeric Powder, Salt, Coriander, Sunflower Oil",16,10,45,55,4,Maharashtrian Recipes,Lunch,High Protein Vegetarian
Karupatti Coffee Recipe,"Palm Jaggery, Water, Cup Dry Ginger Powder, Coriander, Cumin Seeds, Whole Black Peppercorns, Fennel Seeds",7,10,5,15,1,Indian,Snack,Vegetarian
Pasta In Tomato Onion Chutney Recipe,"Onion, Tomato, Fresh Red Chilli, Garlic, Extra Virgin Olive Oil, Spaghetti Pasta Any Pasta Of Your Choice, Salt, Black Pepper Powder",8,10,30,40,3,Fusion,Dinner,Vegetarian
Minced Meat And Egg Croquettes Recipe,"Mutton, Whole Eggs, Onion, Ginger Garlic Paste, Red Chilli Powder, Turmeric Powder, Cumin Powder, Coriander Powder, Salt, Sunflower Oil, Water, All Purpose Flour, Whole Eggs, Whole Wheat Bread Crumbs, Sunflower Oil",15,10,45,55,4,North Indian Recipes,Appetizer,Non Vegeterian
Kovakka Thoran ,"Tindora, Coconut, Green Chilli, Curry Leaves, Cumin Seeds, Mustard, Turmeric Powder, Salt",8,10,15,25,4,Tamil Nadu,Lunch,Vegetarian
Whole Wheat Beetroot Paratha Recipe,"Whole Wheat Flour, Beetroots, Red Chilli Powder, Turmeric Powder, Cumin Powder, Salt, Water, Ghee Oilcook Paratha",8,25,25,50,4,Indian,Lunch,Vegetarian
Karwar Style Khatkhate Recipe (Mixed Vegetable Curry With Toor Dal & Coconut),"Arhar Dal, Mixed Vegetables, Turmeric Powder, Jaggery, Kokum, Salt, Fresh Coconut, Dry Red Chilli, Coriander Powder, Sichuan Peppercorns, Sunflower Oil, Mustard Seeds, Cumin Seeds, Curry Leaves",14,10,20,30,4,Karnataka,Lunch,Vegetarian
Khatti Meethi Mirchi Ki Sabzi Recipe,"Green Chilli, Asafoetida, Chilled Water, Red Chilli Powder, Turmeric Powder, Amchur, Coriander Powder, Garam Masala Powder, Lemon Juice, Raw Peanuts, Salt, Sunflower Oil, Coriander",13,10,35,45,4,North Indian Recipes,Lunch,No Onion No Garlic (Sattvic)
Avocado Mint Soup Recipe,"Avocados, Garlic, Ginger, Onion, Mint, Olive Oil, Water, Cayenne",8,5,20,25,2,Continental,Appetizer,Vegetarian
Cold Pasta Salad With Potatoes And Green Peas Recipe,"Penne Pasta, Baby Potato, Green Peas, Classic Mayonnaise, Black Pepper Powder, Iceberg Lettuce, Lemon, Salt, Italian Seasoning",9,10,20,30,2,Italian Recipes,Dinner,Vegetarian
Chocolate Toast Recipe Topped With Pumpkin & Sunflower Seeds,"Whole Wheat Brown Bread, Butter, Pumpkin Seeds, Sunflower Seeds, Sesame Seeds, Flax Seeds, Dark Chocolate, Fresh Cream, Vanilla Extract",9,10,20,30,3,Continental,Snack,Vegetarian
Bihari Suran Chutney Recipe (Bihar Style Elephant Yam Chutney),"Elephant Yam, Lemon Juice, Ginger, Green Chilli, Turmeric Powder, Red Chilli Powder, Mustard Powder, Ajwain, Asafoetida, Mustard Oil, Salt, Onion, Coriander",13,20,20,40,4,Bihari,Side Dish,Diabetic Friendly
Ellu Chutney Recipe,"Black Sesame Seeds, White Urad Dal, Coconut, Dry Red Chilli, Curry Leaves, Tamarind, Salt, Mustard Seeds, Curry Leaves",9,10,10,20,4,Karnataka,Side Dish,Vegetarian
Chicken And Basil Quiche Recipe,"All Purpose Flour, Butter, Icing Sugar, Whole Egg, Salt, Onion, Garlic, Chicken Breasts, Basil Leaves, Dried Oregano, Dried Thyme Leaves, Red Chilli Flakes, Salt, Whole Egg, Milk, Salt And Pepper Sprinkle",16,10,35,45,4,French,World Breakfast,High Protein Non Vegetarian
Spinach and Dill Tart With Roasted Peppers Recipe,"Red Bell Pepper, Garlic, Spinach, Dill Leaves, Britannia Cheese Spread, All Purpose Flour, Salt, Sugar, Chilled Butter, Chilled Water",10,20,45,65,4,Continental,Snack,Vegetarian
Besan Methi Paratha Recipe,"Sunflower Oil, Gram Flour, Asafoetida, Ajwain, Cumin Seeds, Red Chilli Powder, Coriander Powder, Cumin Powder, Amchur, Garam Masala Powder, Salt, Methi Leaves, Whole Wheat Flour, Water Bind The Dough, Salt, Ghee Cook The Parathas",16,10,20,30,4,North Indian Recipes,North Indian Breakfast,Vegetarian
Palak Kichdi Recipe,"Rice, Pink Masoor Dal, Spinach Leaves, Garlic, Onion, Green Peas, Broccoli, Tofu, Cinnamon Stick, Cumin Seeds, Bay Leaf, Green Chilli, Garlic, Turmeric Powder, Asafoetida, Garam Masala Powder, Tomato, Ghee Oil As Required",18,15,30,45,6,Indian,Lunch,Vegetarian
Green Chilli Vegetable ,"Green Chilli, Oil, Mustard, Salt, Turmeric Powder, Red Chili Powder, Fennel Powder, Teaspoon Coriander Powder, Lemon Juice, Sugar",10,10,10,20,4,Rajasthani,Lunch,Vegetarian
Paneer Pyaz Paratha Recipe,"Whole Wheat Flour, Water Knead, Sunflower Oil, Whole Wheat Flour, Salt, Paneer, Onion, Green Chilli, Coriander, Coriander Powder, Red Chilli Powder, Garam Masala Powder, Chaat Masala Powder, Salt, Ghee",15,20,25,45,4,North Indian Recipes,Lunch,High Protein Vegetarian
Spicy Coconut Peanut Stuffed Baby Brinjal Recipe,"Small Brinjal, Mustard Oil Vegetable Oil, Mustard Seeds, Garlic, Salt, Raw Peanuts, Homemade Tomato Puree, Dry Coconut, Cumin Seeds, Coriander Powder, Garam Masala Powder, Salt, Red Chilli Powder, Sesame Seeds, Coriander",15,15,45,60,4,Indian,Dinner,Vegetarian
Aloo Parwal In Poppy Seed Masala ,"Parwal, Of Fenugreek Seeds, Potato, Cumin Seeds, Fennel, , Cinnamon, Dry Red Chilli, Ginger, Coconut, Dry Poppy, Dried Red Chilli, Turmeric Powder, Sugar, Green Chilies  Finely  Take Salt  As Per, Mustard Oil",16,15,45,60,6,Bengali Recipes,Dinner,Vegetarian
Zoodles In Tomato And Cashew Cream Sauce Recipe (Vegan),"Green Zucchini, Onion, Garlic, Blanched Tomato, Cashew Nuts, Dried Basil Leaves, Dried Oregano, White Pepper Powder, Extra Virgin Olive Oil, Salt",10,10,10,20,2,Italian Recipes,Main Course,Vegan
Andhra Style Erra Kaaram Dosa Recipe (Spicy Red Chilli Chutney Dosa Recipe),"Idli Dosa Batter, Dry Red Chilli, Onion, Garlic, Tamarind, Mustard Seeds, Sunflower Oil, Roasted Gram Dal, Garlic",9,10,25,35,4,Andhra,South Indian Breakfast,Vegetarian
Bengali Posto Porota Recipe (Spiced Poppy Seed Parathas),"Whole Wheat Flour, Curd, Poppy Seeds, Green Chilli  Finely, Sesame Seeds, Onion, Sugar, Kalonji, Coriander, Ghee Oil For Cooking The Paranthas",10,20,30,50,5,Bengali Recipes,Dinner,Vegetarian
Lebu Lonka Murgi Recipe - Chicken With Gondhoraj Lebu & Green Chillies,"Chicken, Curd, Kaffir Lime Leaves, Gondhoraj Lebu Lemon, Gondhoraj Lebu Juice, Onion, Ginger, Green Chilli, Ginger, Garlic, Green Chilli, Whole Black Peppercorns, Black Pepper Powder, Mustard Oil, Honey, Salt",16,5,30,35,4,Indian,Dinner,Non Vegeterian
Spinach Egg Muffins Recipe,"Whole Eggs, Onion, Spinach Leaves, Salt, Black Pepper Powder, Tomato, Garlic, Sunflower Oil",8,10,20,30,6,Continental,World Breakfast,Eggetarian
Thai Green Curry with Chicken & Red Rice Recipe,"Stalks Lemongrass, Green Chilli, Coriander, Basil Leaves, Coriander, Cumin Seeds, Whole Black Peppercorns, Onion, Garlic, Ginger, Salt, Chicken Breasts, Ginger, Button Mushrooms, Carrots, Coconut Milk, Thai Green Curry Paste, Lukewarm Water Vegetable Stock, Brown Sugar, Basil Leaves Kaffir Lime Leaves, Salt, Sunflower Oil, Red Matta Rice",23,5,35,40,4,Thai,Lunch,Non Vegeterian
Butter Coriander & Lemon Sweet Corn Recipe,"Sweet Corn, Coriander, Butter, Salt, Green Chilli, Chaat Masala Powder, Red Chilli Powder, Lemon",8,5,10,15,2,Indian,Snack,Vegetarian
Kashmiri Style Dum Oluv Recipe - Dum Aloo Recipe,"Baby Potato, Water, Salt, Sunflower Oil, Bay Leaf, Cloves, Cinnamon Stick, Cardamom, Kashmiri Red Chilli Powder, Fennel Seeds, Dry Ginger Powder, Black Cardamom, Cumin Seeds, Hung Curd",14,5,30,35,4,Kashmiri,Lunch,Vegetarian
Oats Cheela Recipe Stuffed With Creamy Palak Paneer in Hindi,"Wheat Flour, Oats, Spinach, Cottage Cheese, Cumin Powder, Red Chili Powder, Salt, Nutralite Classic Spread",8,20,40,60,4,Indian,Indian Breakfast,Vegetarian
Tamil Nadu Style Karamani Murungakkai Kuzhambu Recipe-Black eyed Beans & Drumstick Curry,"Black Eyed Beans, Drumstick, Pearl Onion, Garlic, Cinnamon Stick, Cloves, Cardamom, Whole Black Peppercorns, Coriander Powder, Red Chilli Powder, Salt, Sunflower Oil, Onion, Fennel Seeds, Dry Red Chilli",15,10,35,45,4,Tamil Nadu,Lunch,Vegetarian
Karwar Style Lasani Kadhi Recipe - Kokum And Coconut Milk Curry,"Kokum, Fresh Coconut  Grated Coconut Milk, Green Chilli, Garlic, Cumin Seeds, Salt, Jaggery, Coriander, Sunflower Oil, Mustard Seeds, Cumin Seeds",11,10,5,15,4,Coastal Karnataka,Lunch,Vegetarian
Pudina Mavinakayi Chutney Recipe - Mint Mango Chutney,"Mango, Fresh Coconut, Coriander, Mint Leaves, Ginger, Green Chilli, Lemon Juice, Salt, White Urad Dal, Mustard Seeds, Dry Red Chilli, Sunflower Oil",12,15,0,15,4,Karnataka,Side Dish,Vegetarian
Crispy Potato Roses Recipe,"Potato, Butter, Italian Seasoning, Garlic Powder, Kosher Salt, Black Pepper Powder, Parmesan Cheese",7,25,30,55,4,Continental,Appetizer,Vegetarian
Goan Sweet Khatkhati Recipe (Coconut Candy),"Fresh Coconut, Sesame Seeds, Raw Peanuts, Jaggery, Cardamom Powder, Ghee",6,10,20,30,4,Goan Recipes,Dessert,Vegetarian
Goan Prawns Vindaloo Recipe,"Prawns, Onion, Tomato, Salt, Sunflower Oil, Onion, Garlic, Ginger, Dry Red Chilli, Methi Seeds, Mustard Seeds, Coriander, Cardamom, Cinnamon Stick, Cloves, Turmeric Powder, Cumin Seeds, Black Pepper Corns, Vinegar",19,15,15,30,4,Goan Recipes,Side Dish,Non Vegeterian
Spicy Haryana Style Egg Curry Recipe,"Whole Eggs, Green Peas, Paneer, Onion, Tomato, Ginger Garlic Paste, Green Chilli, Coriander Powder, Turmeric Powder, Red Chilli Powder, Garam Masala Powder, Coriander",12,15,30,45,4,Haryana,Lunch,Eggetarian
Baked Chana Dal Vada Recipe,"Chana Dal, Fennel, Cumin Seeds, Green Chilli, Curry Leaves, Onion, Green Coriander, Ginger, Garlic, Salt, Oil, Baking Soda",12,195,20,215,4,Indian,Snack,Vegetarian
Achari Amla Mirchi Ki Sabzi Recipe - Gooseberry & Green Chilli Sabzi,"Amla, Green Chilli, Achari Masala, Red Chilli Powder, Turmeric Powder, Jaggery, Salt, Fennel Seeds, Methi Seeds, Mustard Seeds, Sunflower Oil, Asafoetida",12,10,20,30,4,North Indian Recipes,Side Dish,Vegetarian
Mughlai Style Aloo Matar Gobi Gravy Recipe,"Cauliflower, Green Peas, Potato, Saffron Strands, Curd, Butter, Cumin Seeds, Salt, Onion, Dry Red Chilli, Coriander, Cinnamon Stick, Cloves, Cardamom, Fennel Seeds",15,10,25,35,5,Mughlai,Lunch,Vegetarian
Kimami Sewai Recipe,"Semiya, Khoya, Sugar, Milk, Water, Ghee, Cardamom Powder, Phool Makhana, Badam, Whole Cashews, Raisins, Dry Coconut",12,10,45,55,4,Indian,Dessert,Vegetarian
Chammanthi Chutney Recipe,"Coconut, Ginger, Onion, Curry Leaves, Asafoetida, Mustard, Dry Red Chilli, Oil, Salt",9,20,20,40,4,Indian,Side Dish,Vegetarian
Red Beans And Oats Cutlet Recipe,"Rajma, Soy Granules, Instant Oats, Onion, Ginger, Garlic, Salt, Cumin Powder, Red Chilli Powder, Coriander, Sunflower Oil",11,25,30,55,4,Indian,Snack,Vegetarian
Cantonese Style Chicken Chowmein Recipe,"Egg Noodles, Boneless Chicken, Garlic  Crushed, Ginger, Black Pepper Powder, Spring Onion Greens, Carrot, Cabbage, Red Yellow And Green Bell Peppers, Bok Choy, Soy Sauce, Fish Sauce, Oyster Sauce, Red Chilli Sauce, Rice Wine Vinegar, Sesame, Salt, Spring Onion Greens",18,0,35,35,5,Chinese,Lunch,Non Vegeterian
Milk Braid Rolls Recipe,"Vivatta Maida, Milk, Active Dry Yeast, Whole Egg, Butter, Caster Sugar, Salt, Sugar, Vanilla Extract, Sesame Seeds",10,120,20,140,8,French,Snack,Eggetarian
Chilli Chocolate Cookies Recipe,"All Purpose Flour, Cocoa Powder, Chocolate Bar, Butter, Whole Eggs, Red Chilli Powder, Baking Soda, Brown Sugar, Sugar, Vanilla Extract, Salt, Chocolate Chips, Chocolate Bar",13,25,60,85,25,Continental,Snack,Vegetarian
ProvenÃ§al Tomato Rice Soup Recipe,"Rice  Semicooked, Extra Virgin Olive Oil, Onion, Carrot, Garlic, Orange Zest, Dried Thyme Leaves, Fennel Powder, Homemade Tomato Puree, Lukewarm Water, Tomato, Vegetable Stock, Salt, Sugar, Basil Leaves Garnish",15,10,30,40,4,Fusion,Lunch,Vegetarian
Aloo Subz Dum Biryani Recipe,"Potato, Onion, Carrot, Green Beans, Del Monte Whole Corn Kernels, Tomato, Cloves, Cinnamon Stick, Red Chilli Powder, Turmeric Powder, Green Chilli, Curd, Garam Masala Powder, Ginger Garlic Paste, Salt, Ghee, Basmati Rice, Cloves, Cardamom, Cinnamon Stick, Ginger Garlic Paste, Salt, Coriander, Lemon Juice, Garam Masala Powder, Saffron Strands, Caramelized Onion, Ghee",28,20,50,70,4,North Indian Recipes,Lunch,Vegetarian
Malabar Style Dates Coriander Chutney Recipe,"Dates, Tamarind, Dry Red Chilli, Mint, Garlic, Coriander, Ginger, Salt",8,0,20,20,4,Malabar,Side Dish,Vegetarian
Mushroom filled Vol-au-Vent Recipe,"Puff Pastry Sheet, Button Mushrooms, Garlic, Fresh Cream, Fresh Thyme Leaves, Red Chilli Flakes, Lemon Juice, Salt, Whole Black Peppercorns",9,180,45,225,4,French,Appetizer,Vegetarian
Tomato Poha With Peas Recipe,"Poha, Green Peas, Onion, Tomato, Green Chilli, Garlic, Fennel Seeds, Mustard Seeds, Asafoetida, Turmeric Powder, Red Chilli Powder, Coriander Powder, Curry Leaves, Coriander, Sunflower Oil, Lemon Juice, Salt",17,10,10,20,4,North Indian Recipes,North Indian Breakfast,Vegetarian
Methi Sprouts Salad Recipe - Healthy & Tasty Diabetic Snack,"Methi Seeds, Peanuts, Onion, Tomato, Coriander, Salt, Black Pepper Powder, Lemon Juice, Chaat Masala Powder",9,15,0,15,4,Indian,Appetizer,Diabetic Friendly
Lebanese Style Caramelized Onion Pilaf with Fried eggs Recipe,"Foxtail Millet, Masoor Dal, Sweet Corn, Onion, Garlic, Cinnamon Stick, Cumin Seeds, Cumin Powder, Black Pepper Powder, Sugar, Whole Egg, Salt And Pepper",12,10,30,40,4,Middle Eastern,Lunch,Diabetic Friendly
Thai Style Paneer Toast Recipe,"Whole Wheat Brown Bread, Whole Egg, Paneer, Salt, Soy Sauce, Coriander, Green Chilli, Garlic, Coriander, Whole Black Peppercorns, Sesame Seeds, Fresh Red Chilli, Coriander",13,10,30,40,4,Thai,World Breakfast,Eggetarian
Sprouted Moong Chaat Recipe,"Sunflower Oil, Mustard Seeds, Cumin Seeds, Ginger, Green Chilli, Turmeric Powder, Curry Leaves, Green Moong Sprouts, Mint Leaves, Coriander, Coriander, Mint Leaves, Green Chilli, Ginger, Garlic, Badam, Lemon, Jaggery, Salt, Onion, Tomato, Fresh Pomegranate Fruit Kernels, Coriander, Chaat Masala Powder",24,25,10,35,4,North Indian Recipes,Snack,Vegetarian
Hunase Saaru Recipe - Mysore Style Spicy Tamarind Rasam,"Tamarind, Cumin Seeds, Mustard Seeds, Asafoetida, Curry Leaves, Dry Red Chilli, Rasam Powder Red Chilly Powder, Jaggery, Salt, Ghee",10,10,20,30,2,Karnataka,Dinner,Vegetarian
Eggless Custard Cookie Recipe,"All Purpose Flour, Vanilla Custard, Baking Powder, Icing Sugar, Butter, Vanilla Extract",6,15,45,60,4,Continental,Snack,Vegetarian
Egg Dosa Recipe,"Rice, White Urad Dal, Chana Dal, Methi Seeds, Instant Oats, Salt, Water, Whole Eggs, Onion, Coriander, Green Chilli, Sunflower Oil",12,10,18,28,4,South Indian Recipes,South Indian Breakfast,Eggetarian
Sweet Potato Balls Recipe Stuffed With Cheesy Garlic Mayo Recipe,"Sweet Potato, S Coriander, Red Chilli Powder, Cumin Powder, Amchur, Rice Flour, Corn Flour, Whole Wheat Bread Crumbs, Salt, Del Monte Cheesy Garlic Mayo, Whole Black Peppercorns, Sunflower Oil",12,30,30,60,4,Appetizer,South Indian Breakfast,Eggetarian
Baked Palak Ki Mathri Recipe (Baked Spinach Spicy Tea-Time Crackers),"Whole Wheat Flour, Sooji, Ghee, Ajwain, Salt, Spinach Leaves",6,20,40,60,4,Indian,Snack,Vegetarian
Mixed Vegetable Handi Recipe,"Sunflower Oil, Cumin Seeds, Bay Leaves, Onion, Ginger, Garlic, Green Chilli, Tomato, Cashew Nuts, Kashmiri Red Chilli Powder, Turmeric Powder, Garam Masala Powder, Coriander Powder, Butter, Salt, Carrots, Sweet Corn, Green Peas, Green Beans, Green Bell Pepper, Cauliflower, Button Mushrooms, Paneer, Water, Curd, Fresh Cream, Kasuri Methi, Coriander, Mint Leaves, Lemon",30,20,25,45,4,North Indian Recipes,Lunch,Vegetarian
Aloo Matar Sabzi Recipe,"Potato, Green Peas, Onion, Ginger, Tomato, Cumin Seeds, Green Chilli, Garam Masala Powder, Turmeric Powder, Red Chilli Powder, Kasoori Methi, Salt, Sugar, Nutralite Classic Spread",14,4,40,44,4,Punjabi,Side Dish,Vegetarian
Thandai Shahi Tukda Recipe,"Whole Wheat Brown Bread, Sugar, Water, Ghee, Milk, Condensed Milk, Thandai Masala, Badam, Pistachios",9,10,30,40,3,North Indian Recipes,Dessert,Vegetarian
Macha Mahura Recipe - Odia Style Fish Curry With Vegetables,"Kaddu, Colocasia Root, Elephant Yam, Plantain Stem, Kala Chana, Badi, Rohu Fish, Coriander, Fennel Seeds, Cloves, Cumin Seeds, Whole Black Peppercorns, Cinnamon Stick, Turmeric Powder, Panch Phoran Masala, Onion, Ginger Garlic Paste, Salt, Sunflower Oil, Water",20,10,20,30,4,Oriya Recipes,Dinner,High Protein Non Vegetarian
Amrood Raita Recipe - Guava Raita,"Guava, Curd, Salt, Mustard Seeds, White Urad Dal, Curry Leaves, Dry Red Chilli, Asafoetida, Sunflower Oil",9,15,0,15,4,Indian,Side Dish,Vegetarian
Roasted Pumpkin Spinach and Walnut Spaghetti Recipe,"Spaghetti Pasta, Garlic, Extra Virgin Olive Oil, Red Chilli Flakes, Mixed Herbs, Kaddu, Spinach Leaves, Walnuts, Salt",9,10,25,35,2,Italian Recipes,Dinner,Vegetarian
Oat Banana Pancakes Recipe,"Instant Oats, Baking Soda, Ripe Bananas, Baking Powder, Vanilla Extract, Salt, Buttermilk, Sugar, Butter Coconut Oilcook As Needed, Strawberries, Chocolate Sauce",11,15,20,35,10,Continental,World Breakfast,Vegetarian
Mutton Dum Biryani Recipe,"Onion, Ginger, Garlic, Green Chilli, Bay Leaves, Cardamom, Cinnamon Stick, Cloves, Basmati Rice, Salt, Mutton, Hung Curd, Ginger Garlic Paste, Red Chilli Powder, Turmeric Powder, Garam Masala Powder, Salt, Bay Leaves, Cinnamon Stick, Cloves, Mace, Dagad Phool, Red Chilli Powder, Garam Masala Powder, Tomato, Mint Leaves, Salt, Milk, Saffron Strands, Sunflower Oil, Ghee, Whole Wheat Flour",32,30,60,90,4,North Indian Recipes,Lunch,Non Vegeterian
Pita Saga Bati Basa Recipe,"Pita Saga, Potato, Tomato, Onion, Brinjal, Garlic, Green Chilli, Badi, Mustard Seeds, Cumin Seeds, Turmeric Powder, Salt, Mustard Oil",13,10,15,25,2,Oriya Recipes,Dinner,Vegetarian
Mint Coriander Spice Pulao Recipe,"Rice  Washed And Soaked, Coriander, Ghee, Mint Leaves, Star Anise, Fennel Seeds, Bay Leaves, Cinnamon Stick",8,5,20,25,4,Indian,Main Course,Vegetarian
Maharashtrian Green Chilli Thecha Recipe,"Green Chilli, Garlic, Sunflower Oil, Mustard Seeds, Asafoetida, Salt",6,10,5,15,4,Maharashtrian Recipes,Side Dish,Vegetarian
Tart Provencal With Ratatouille Recipe,"All Purpose Flour, Butter, Salt, Water, Japanese Eggplant, Green Zucchini, Yellow Zucchini, Red Bell Pepper, Yellow Bell Pepper, Onion, Garlic, Tomato, Homemade Tomato Puree, Fresh Thyme Leaves, Sugar, Extra Virgin Olive Oil, Whole Black Peppercorns, Gruyere Cheese, Salt",19,55,80,135,4,French,Lunch,Vegetarian
Chettinad Kathirikai Chops Recipe - Brinjal Curry for Biryani,"Small Brinjal, Turmeric Powder, Garam Masala Powder, Red Chilli Powder, Jaggery, Tamarind Paste, Tomato, Salt, Black Sesame Seeds, Raw Peanuts, Cumin Seeds, Ginger, Garlic, Onion, Green Chilli, Gingelly Oil, Mustard Seeds, Asafoetida, Curry Leaves",19,20,20,40,3,Chettinad,Main Course,Vegetarian
Shanghai Style Mantou Recipe - Pan Fried Momos,"All Purpose Flour, Salt, Vegetable Stock, Red Chilli Sauce, Garlic, Ginger, Red Bell Pepper, Broccoli, Spring Onion, Homemade Hoisin Sauce, Salt, Black Pepper Powder",12,10,30,40,4,Chinese,Appetizer,Vegetarian
Karnataka Style Southekayi Seppe Chutney Recipe (Mangalore Cucumber Peel Chutney Recipe),"Mangalorean Cucumber, Fresh Coconut, Dry Red Chilli, White Urad Dal, Chana Dal, Tamarind, Jaggery, Sunflower Oil, Mustard Seeds, Curry Leaves",10,10,10,20,4,Karnataka,Side Dish,Vegetarian
Savory Semolina Breakfast Pudding ,"Semolina, Onion, Ginger, Green Chilli, Curry Leaves, Carrot, Green Beans, Rye, White Urad Dal, Asafoetida, Oil, Ghee, Lemon Juice, Sugar, Salt",15,5,30,35,4,South Indian Recipes,South Indian Breakfast,Vegetarian
Masala Dosa Recipe With Vegetable Filling Recipe,"Dosa Rice, Black Urad Dal, Methi Seeds, Salt, Sunflower Oil Castor Oil As Neededfry The Dosa, Red Bell Pepper, Tomato, Red Onion, Green Chilli, Ginger, Garlic, Curry Leaves, Dry Red Chilli, Mustard Seeds, Cumin Seeds, Asafoetida, Coriander",17,10,30,40,4,South Indian Recipes,South Indian Breakfast,Vegetarian
Badam Nu Gosht Recipe,"Of Mutton, Bay Leaves, Salt, Onion, Tomato, Milk, Ghee, Almonds, Ginger, Bud Garlic, Dry Red Chilli, Cinnamon, Whole Black Pepper, ",14,10,20,30,3,Parsi Recipes,Main Course,Non Vegeterian
Mizoram Style Arsa Beipenek Recipe  - Spicy Chicken Stew,"Chicken, Onion, Dry Red Chilli, Ginger, Garlic, Turmeric Powder, Whole Wheat Flour, Salt, Coriander, Mustard Oil",10,10,45,55,4,North East India Recipes,Lunch,Non Vegeterian
Konkan Style Modachya Moongachi Amti Recipe-Sprouted Moong Bean Curry,"Green Moong Dal, Sunflower Oil Ghee, Mustard Seeds, Asafoetida, Curry Leaves, Salt, Onion, Dessicated Coconut, Dry Red Chilli, Garlic, Ginger, Cumin Seeds, Red Chilli Powder, Turmeric Powder, Kokum",15,15,20,35,4,Konkan,Lunch,Vegetarian
Pudina Tambuli Recipe,"Mint Leaves, Cumin Seeds, Whole Black Peppercorns, Green Chilli, Fresh Coconut, Buttermilk, Ghee, Salt, Ghee, Mustard Seeds, Cumin Seeds, Curry Leaves, Dry Red Chilli",13,10,5,15,4,Karnataka,Side Dish,Vegetarian
Eggless Spicy Spinach Bread Recipe,"All Purpose Flour, Onion, Baking Powder, Salt, Spinach, Green Chilli, Garlic, Sesame Seeds, Sunflower Oil, Sunflower Oil, Curd, Milk",12,10,50,60,2,Continental,World Breakfast,High Protein Vegetarian
Palak Makki Ki Roti Recipe - Spicy Spinach Cornmeal Flatbread Recipe),"Makki Ka Atta, Whole Wheat Flour, Spinach Leaves, Ginger, Red Chilli Powder, Cumin Powder, Salt, Sunflower Oil",8,25,10,35,4,North Indian Recipes,North Indian Breakfast,Vegan
Eggwhite Frittata With Roasted Vegetables Recipe,"Beetroot, Yellow Bell Pepper, Broccoli, Extra Virgin Olive Oil, Sea Salt, Egg Whites, Cheese, Dried Oregano, Extra Virgin Olive Oil",9,10,30,40,2,Continental,World Breakfast,Eggetarian
Aloo Dal Pakoras Recipe,"Green Moong Dal, Ginger, Green Chilli, Salt, Potato, Red Chilli Powder, Coriander Powder, Turmeric Powder, Fennel Seeds, Lemon Juice, Coriander, Asafoetida, Salt, Sunflower Oil",14,60,20,80,4,North Indian Recipes,Snack,Vegetarian
Roasted Potato Wrap/Roll Recipe With Spiced Cheese Spread,"Tortillas, Extra Virgin Olive Oil, Potato, Garlic, Dried Oregano, Green Bell Pepper, Onion, Britannia Cheese Spread, Sweet And Spicy Red Chilli Sauce, Salt",10,10,30,40,4,Mexican,Lunch,Vegetarian
Vankaya Ulli Karam Recipe - Eggplant In Spicy Onion Gravy,"Small Brinjal, Onion, Tomato, Garlic, Ginger, Green Chilli, Cumin Seeds, Coriander, Methi Seeds, Salt, Sunflower Oil Cook, Coriander",12,10,25,35,4,Andhra,Side Dish,Vegetarian
Vetrilai Thogayal Recipe -  Paan Chutney Recipe,"Betel Leaves, Onion, Garlic, Coriander, Black Urad Dal, Chana Dal, Cumin Seeds, Tamarind, Salt, Asafoetida, Sunflower Oil",11,20,20,40,4,South Indian Recipes,Side Dish,Vegetarian
Batata Nu Shaak ,"Potato, Ginger, Tomato Puree, Cumin Seeds, Mustard, Turmeric Powder, Asafoetida, Red Chili Powder, Coriander Powder, Oil, Green Coriander, Black Saltrock Salt, Salt, Black Salt, Salt",15,20,35,55,4,Gujarati Recipesï»¿,Lunch,Vegetarian
Spicy Jawla Stuffed In Brinjal Recipe,"Jawla Fish, Onion, Fresh Coconut, Tamarind Water, Red Chilli Powder, Coconut Oil, Ginger, Garlic, Salt, Brinjal, Fresh Coconut, Dry Red Chilli, Coriander, Methi Seeds, Turmeric Powder, Lemon Juice, Onion, Sunflower Oil, Water",19,15,20,35,3,South Indian Recipes,Lunch,Non Vegeterian
Verkadalai Sundal- Peanut Sundal Recipe,"Raw Peanuts, Water, Mustard Seeds, White Urad Dal, Ssp Asafoetida, Ginger, Sesame, Green Chilli, Curry Leaves, Fresh Coconut, Salt, Coriander",12,5,15,20,4,South Indian Recipes,Side Dish,High Protein Vegetarian
Paneer Raw Mango Curry Recipe,"Paneer, Mango, Pearl Onion, Drumstick, Sunflower Oil, Turmeric Powder, Coriander Powder, Red Chilli Powder, Salt, Coconut Milk, Garlic, Green Chilli, Ginger, Fresh Coconut, Coconut Oil Any Other Oil, Mustard Seeds, Dry Red Chilli, Onion, Curry Leaves",19,10,30,40,2,North Indian Recipes,Lunch,High Protein Vegetarian
White Chocolate Maltesers Fudge Recipe,"White Chocolate, Condensed Milk, Maltesers",3,10,30,40,2,Continental,Dessert,Vegetarian
Badam And Khus Khus Milk Recipe,"Badam, Poppy Seeds, Milk, Sugar Jaggery, Pistachios, Cardamom Powder, Glazed Cherries, Saffron Strands",8,10,20,30,4,Indian,Snack,Vegetarian
Bhut Jolokia Murgh Recipe,"Chicken, Ghost Chilli Peppers, Onion, Ginger, Garlic, Ghee, Ghee, Turmeric Powder, Cumin Powder, Coriander Powder, Garam Masala Powder, Kashmiri Red Chilli Powder, Homemade Tomato Puree, Salt, Coriander",15,20,50,70,2,North Indian Recipes,Side Dish,Non Vegeterian
Eggplant Foot Yam Stir Fry Recipe,"Suran, , Garlic, Onion, Turmeric Powder, , Black Pepper Powder, Fennel Powder, Oil, Mustard, Curry Leaves",11,15,35,50,4,Kerala Recipes,Lunch,Vegetarian
"Cauliflower Crust Pizza With Pesto, Sundried Tomatoes & Goat Cheese","Cauliflower, Whole Eggs, Mozzarella Cheese, Parmesan Cheese, Dried Oregano, Dried Basil Leaves, Red Chilli Flakes, Garlic Powder, Onion Powder, Homemade Basil Pesto, Homemade Marinara Sauce, Sun Dried Tomato, Mozzarella Cheese, Salt",14,15,45,60,4,Italian Recipes,Dinner,Vegetarian
Chicken Tomato Macaroni Recipe- Pasta with Indian Masalas,"Chicken, Dry Red Chilli, Green Chilli, Fennel Seeds, Turmeric Powder, Salt, Sunflower Oil, Macaroni Pasta, Onion, Ginger Garlic Paste, Green Chilli  Finely, Tomato, Garam Masala Powder, Salt, Sunflower Oil Cook, Coriander, Sunflower Oil Cook, Coriander",18,10,90,100,4,Fusion,Dinner,Non Vegeterian
Vegetarian Laksa Curry Recipe,"Button Mushrooms, Spring Onion, Green Beans, Carrots, Red Yellowgreen Bell Pepper, Baby Corn, Tofu, Bean Sprouts, Coconut Milk, Vegetable Stock, Rice Noodles, Soy Sauce, Sunflower Oil, Coriander, Mint Leaves, Lemon Wedges Serve, Sunflower Oil, Salt, Fresh Red Chilli, Dry Red Chilli, Lemon Grass, Garlic, Galangal, Coriander Powder, Cumin Powder, Fresh Turmeric Root, Pearl Onion, Cashew Nuts",28,10,60,70,3,Asian,Dinner,Vegetarian
Hara Pyaz Paratha Recipe - Spring Onion Paratha Recipe,"Whole Wheat Flour, Bajra Flour, Jowar Flour, Spring Onion, Salt, Turmeric Powder, Cumin Powder, Ghee",8,15,20,35,4,Indian,Lunch,Vegetarian
Shahi Dal Recipe,"White Urad Dal, Badam, Milk, Turmeric Powder, Salt, Onion, Tomato, Cumin Seeds, Red Chilli Powder, Green Chilli, Sunflower Oil",11,10,35,45,4,North Indian Recipes,Lunch,High Protein Vegetarian
Buttered Carrot Fingers Recipe (Finger Food For Babies Over 9 Months),"Carrot, Butter, Cumin Powder, Black Pepper Powder, Salt",5,10,5,15,4,Indian,Snack,Vegetarian
Palak Paratha Recipe-Spiced Spinach Flatbread,"Spinach Leaves, Green Chilli, Whole Wheat Flour, Fennel Seeds, Turmeric Powder, Cumin Powder, Salt, Black Pepper Powder, Ghee",9,20,30,50,4,Indian,North Indian Breakfast,Diabetic Friendly
Avocado Chocolate Pancakes Recipe,"Avocado, Whole Wheat Flour, Cocoa Powder, Baking Powder, Milk, Vanilla Extract, Honey, Salt, Ghee",9,10,15,25,4,Continental,World Breakfast,Vegetarian
Paneer Kalimirch Recipe (Paneer in Black Pepper flavored Gravy),"Paneer, Fresh Cream, Milk, Turmeric Powder, Garam Masala Powder, Whole Black Peppercorns, Salt, Sunflower Oil, Onion, Cashew Nuts, Garlic, Ginger, Garlic, Sunflower Oil, Black Pepper Powder",15,20,35,55,4,North Indian Recipes,Side Dish,High Protein Vegetarian
Homemade Summer Pasta Salad Recipe With Herbs,"Fettuccine Pasta, Black Olives, Red Bell Pepper, Yellow Bell Pepper, Red Onion, Cherry Tomato, Cucumber, Green Romaine Lettuce, Basil Leaves, Extra Virgin Olive Oil, Italian Seasoning, Whole Black Peppercorns, Red Chilli Flakes, Salt",14,10,30,40,2,Italian Recipes,Dinner,Vegetarian
Murungai Keerai Masala Vadai Recipe,"Chana Dal, Onion, Drumstick Leaves, Mint Leaves, Green Coriander, Dry Red Chilli, Ginger, Garlic, , Cumin Seeds, Asafoetida, Salt, Oil",13,180,20,200,2,South Indian Recipes,Snack,Vegetarian
Kadai Egg Masala Recipe,"Whole Eggs, Onion, Green Bell Pepper, Ginger, Garlic, Homemade Tomato Puree, Cardamom, Turmeric Powder, Cumin Powder, Red Chilli Powder, Black Pepper Powder, Kasuri Methi, Sunflower Oil, Butter, Salt",15,10,60,70,4,North Indian Recipes,Lunch,Eggetarian
Karnataka Style Ranjaka Recipe (Red Chili Chutney Recipe),"Dry Red Chilli, Methi Seeds, Lemon Juice, Mustard Oil, Mustard Seeds, Curry Leaves, Asafoetida",7,5,20,25,4,Karnataka,Side Dish,Vegetarian
Carrot Idli Recipe,"Idli Dosa Batter, Carrot, Green Chilli, Salt, Sunflower Oil, Mustard Seeds, Curry Leaves, Ginger, Idli Rice, White Urad Dal, Methi Seeds",11,10,15,25,2,South Indian Recipes,South Indian Breakfast,Vegetarian
Spring Onion & Roasted Garlic Brown Rice Recipe,"Brown Rice  Washed And Soaked, Olive Oil, Garlic, Green Onion, Salt, Green Onion Leaves Of",6,30,35,65,4,Continental,Main Course,Vegetarian
Lemon Pudina Curry Leaf Shikanji Recipe in Hindi,"Curry Leaves, Peppermint, Lemonjuice, Take Out  Cumin Seeds, Black Saltrock Salt, Water, Ice",7,10,0,10,4,Indian,Appetizer,Vegetarian
Bread Halwa ,"Breads, Sugar, , Cream, , Cardamom Powder, Dry Fruits, Chandi'S Work",8,10,20,30,2,Mughlai,Dessert,Vegetarian
Singhade Ka Achaar Recipe (Water Chestnut Pickle),"Singhade, Salt, Turmeric Powder, Red Chilli Powder, Mustard Powder, Fennel Seeds, Sugar, Sunflower Oil, Vinegar",9,30,10,40,2,North Indian Recipes,Side Dish,Vegetarian
Prawns Theeyal Recipe (Chemeen Theeyal),"Prawns, Fresh Coconut, Coriander, Dry Red Chilli, Shallots, Garlic, Methi Seeds, Cumin Seeds, Turmeric Powder, Mustard Seeds, Curry Leaves, Tamarind, Salt",13,10,45,55,4,Kerala Recipes,Lunch,Non Vegeterian
Beetroot Chutney Recipe,"Beetroot, Curry Leaves, Green Chilli, Asafoetida, Sesame, Chana Dal, White Urad Dal, Fresh Coconut, Water, Salt, Sesame, Mustard Seeds, Curry Leaves, Asafoetida",14,20,20,40,4,South Indian Recipes,Side Dish,Diabetic Friendly
Bengali Style Chingri Macher Cutlet Recipe (Prawn Cutlet),"Prawns, Onion, Garlic, Red Chilli Powder, Garam Masala Powder, Whole Eggs, Salt, Whole Wheat Bread Crumbs, Gram Flour, Sunflower Oil, Onion",11,30,10,40,4,Bengali Recipes,Snack,Non Vegeterian
Angaya Podi Recipe,"Dry Ginger Powder, Kandathipli, Arisithipli, Dry Red Chilli, Arhar Dal, White Urad Dal, Chana Dal, Dried Neem Flowers, Turkey Berries, Manathakkali KaiÂ Vathal, Cumin Seeds, Mustard Seeds, Coriander, Whole Black Peppercorns, Salt, Asafoetida",16,10,10,20,3,Tamil Nadu,Side Dish,Vegetarian
Carrot And Capsicum Mix Dal Recipe,"Arhar Dal, Carrot, Capsicum, Tomato, Ginger, Turmeric Powder, Tamarind Water, Salt, Mustard, Cumin Seeds, Asafetida, Curry Leaves, Tomato, Green Chili",14,10,30,40,4,South Indian Recipes,Lunch,High Protein Vegetarian
Delhi Style Fruit Chaat Recipe -Homemade Kulle Chaat Of North India,"Apple, Ripe Bananas, Pineapple, Anardana Powder, Potato, Sweet Potato, Green Chilli, Coriander, Chaat Masala Powder, Cumin Powder, Red Chilli Powder, Salt, Lemon Juice, Ghee",14,30,0,30,2,North Indian Recipes,Snack,Vegan
Mamidikaya Pappu Recipe - Andhra Pappu - Raw Mango Dal,"Arhar Dal, Mango, Turmeric Powder, Onion, Tomato, Garlic, Dry Red Chilli, Mustard Seeds, Curry Leaves",9,15,25,40,2,Andhra,Side Dish,High Protein Vegetarian
Easy Creamy Chicken Curry Recipe,"Chicken, Yogurt, Lemon Juice, Salt, Ginger, Garlic, Black Pepper Powder, Kasuri Methi, Cream, Oil",10,2,40,42,4,North Indian Recipes,Lunch,Non Vegeterian
Pumpkin Thoran Recipe - South Indian Pumpkin Sabzi,"Kaddu, Pearl Onion, Mustard Seeds, Curry Leaves, Green Chilli, Salt, Turmeric Powder, Fresh Coconut, Curry Leaves, Cumin Seeds, Green Chilli",11,10,15,25,4,Indian,Side Dish,Vegetarian
Potato Vindaloo Recipe,"Dry Kashmiri Peppers, Fenugreek Seeds, Garlic, Small Onion, Cumin Seeds, Turmeric Powder, Vinegar, Water, Potato, Salt, Oil, Rye, Curry Leaves, Water, Sugar",15,10,30,40,4,Goan Recipes,Lunch,Vegetarian
Green Chutney Recipe - Coriander Mint Chutney Recipe,"Coriander, Mint Leaves, Curry Leaves, Roasted Peanuts, Ginger, Green Chilli, Sugar, Lemon Juice, Salt, Water",10,10,20,30,4,North Indian Recipes,Side Dish,Vegetarian
Panchmel Dal Recipe | Rajasthani Dal | Panchkuti Dal,"Arhar Dal, Masoor Dal, Chana Dal, Black Urad Dal, Green Moong Dal, Ghee, Cumin Seeds, Onion, Garlic, Ginger, Green Chilli, Bay Leaves, Cinnamon Stick, Tomato, Turmeric Powder, Red Chilli Powder, Asafoetida, Salt, Lemon, Ghee, Cumin Seeds, Dry Red Chilli",22,10,30,40,4,Rajasthani,Lunch,High Protein Vegetarian
Lehsuni Pudina Chutney Recipe,"Mint Leaves, Garlic, Ginger, Green Chilli, Raw Peanuts, Salt, Sugar, Lemon Juice",8,10,30,40,4,North Indian Recipes,Side Dish,Vegetarian
Chicken Vindaloo Recipe,"Chicken, Onion, Dry Red Chilli, Garlic, Ginger, White Wine Vinegar, Mustard Seeds, Sunflower Oil, Salt, Cloves, Cardamom, Cinnamon Powder, Whole Black Peppercorns, Cumin Seeds",14,10,30,40,4,Goan Recipes,Lunch,Non Vegeterian
Sweet Potato & Methi Stuffed Paratha Recipe,"Whole Wheat Flour, Sunflower Oil, Salt, Sweet Potato, Methi Leaves, Cumin Seeds, Ginger, Green Chilli, Turmeric Powder, Red Chilli Powder, Coriander Powder, Mustard Oil, Salt",13,30,60,90,4,North Indian Recipes,North Indian Breakfast,Diabetic Friendly
Karela Muthia Recipe - Bitter Gourd Steamed Dumplings,"Karela, Gram Flour, Rice Flour, Jowar Flour, Ginger, Garlic, Green Chilli Paste, Cooking Soda, Turmeric Powder, Cumin Powder, Garam Masala Powder, Salt, Cumin Seeds, Mustard Seeds, Sesame Seeds, Dry Red Chilli, Sunflower Oil",17,5,30,35,4,Gujarati Recipesï»¿,Snack,Vegetarian
Rich Chocolate Cheesecake Recipe,"Bourbon Biscuits Any Other Biscuits Of Your Choice, Butter, Dark Chocolate, Butter, Cocoa Powder, Britannia Cream Cheese, Mascarpone Cheese, Caster Sugar, Whole Eggs, Vanilla Extract, Strawberry Compote Fresh RaspberriesÂ To Serve",11,20,780,800,8,Continental,Dessert,Eggetarian
Thai Style Fried Bananas Recipe,"Ripe Bananas, All Purpose Flour, Rice Flour, Corn Flour, Dessicated Coconut, Salt, Baking Powder, Cardamom Powder, Sunflower Oil Drizzle, Rice Flour, Sesame Seeds",11,20,40,60,4,Thai,Dessert,Vegan
Pohala Jhola Recipe (Pohala Fish Curry),"Pohala Fish, Turmeric Powder, Tomato, Onion, Green Chilli, Garlic, Cumin Powder, Mustard Oil, Water, Salt",10,10,40,50,4,Oriya Recipes,Lunch,High Protein Non Vegetarian
Assamese Bilahir Tok Recipe,"Tomato, Turmeric Powder, Red Chilli Powder, Sugar, Salt, Mustard Oil, Panch Phoran Masala, Bay Leaves, Dry Red Chilli",9,10,15,25,4,Assamese,Side Dish,Vegetarian
Misa Maas Kordoi Tenga Recipe (Shrimp With Star Fruit Curry),"Star Fruit, Shrimps, Tomato, Garlic, Dry Red Chilli, Turmeric Powder, Sugar, Mustard Oil, Mustard Seeds, Salt",10,5,30,35,2,Assamese,Side Dish,Non Vegeterian
Karnataka Style Menthya Soppu Hesaru Kaalu Palya Recipe,"Green Moong Sprouts, Methi Leaves, Onion, Tomato, Turmeric Powder, Jaggery, Coriander, Sunflower Oil, Salt, Shallots, Garlic, Dry Red Chilli, Cumin Seeds",13,10,20,30,4,Karnataka,Side Dish,High Protein Vegetarian
Macaroni With Tahini Sauce Recipe,"Tahini, Garlic, Lemon Juice, Extra Virgin Olive Oil, Vinegar, Salt, Black Pepper Powder, Macaroni Pasta, Red Bell Pepper, Salt, Black Pepper Powder",11,10,10,20,2,Fusion,Dinner,Vegetarian
Thayir Vada Recipe (Spicy Fritter Soaked In Sweet Yogurt Recipe),"White Urad Dal, Green Chilli, Asafoetida, Ginger, Salt, Curd, Sugar, Fresh Coconut, Salt, Mustard Seeds, White Urad Dal, Dry Red Chilli, Curry Leaves, Sunflower Oil, Boondi, Coriander, Red Chilli Powder, Boondi, Coriander",19,60,45,105,4,South Indian Recipes,Snack,Vegetarian
Paneer Methi Paratha Recipe,"Whole Wheat Flour, Salt, Sunflower Oil, Paneer, Cumin Powder, Green Chilli, Onion, Methi Leaves, Salt",9,10,40,50,4,North Indian Recipes,North Indian Breakfast,High Protein Vegetarian
Pahari Style Phanu Recipe,"Arhar Dal, Urad Dal, Tomato, Ginger, Garlic, Turmeric Powder, Asafetida, Ginger, Garlic, Cumin Seeds, Green Chilli, Mustard Oil",12,120,35,155,4,Uttarakhand-North Kumaon,Lunch,High Protein Vegetarian
Tandoori Chicken Crostini Recipe,"Ciabatta Bread, Chicken, Kashmiri Red Chilli Powder, Lemon Juice, Curd, Ginger Garlic Paste, Salt, Garam Masala Powder, Mustard Oil, Butter Baste, Chaat Masala Powder, Classic Mayonnaise, Green Chutney, Lemon Juice, Mixed Vegetables, Green Chilli, Coriander",17,60,40,100,4,Italian Recipes,Appetizer,Non Vegeterian
Gujarati Dhokla Pizza Recipe,"Rice, White Urad Dal, Chana Dal, Green Chilli, Ginger, Curd, Salt, Carrot, Mint Leaves, Onion, Green Bell Pepper, Britannia Cheezza, Tomato Basil Pasta Sauce, Sweet Corn, Black Olives",15,20,20,40,4,Fusion,Appetizer,High Protein Vegetarian
Chanar Dalna ,"G Paneer, Potato, Bay Leaves, Dry Red Chilli, Panch Four Masala, Tomato, Turmeric Powder, Red Chilli Powder, Cumin Seeds, Ginger, Salt, Sugar, Oil",13,15,60,75,4,Bengali Recipes,Lunch,Vegetarian
Avarekalu Payasa Recipe - Broad Beans Payasa,"Avarekalu  Lilva Beans, Fresh Coconut, Poppy Seeds, Jaggery, Salt, Cardamom, Ghee, Cashew Nuts, Raisins",9,10,15,25,4,Karnataka,Dessert,Vegetarian
Kerala Style Eggplant Curry Recipe,"Brinjal, Mustard Seeds, Onion, Green Chilli, Turmeric Powder, Coriander Powder, Fennel Seeds, Methi Seeds, Tomato, Coconut Milk, Coconut Oil Vegetable Oil As Required, Curry Leaves, Coriander",13,15,35,50,4,Kerala Recipes,Lunch,Vegetarian
Whole Wheat Crepes With Roasted Vegetables And White Sauce Recipe,"Whole Wheat Flour, Milk, Whole Eggs, Nutmeg, Ghee  Meltedbutter, Salt, Water, Ghee Buttercoat The Pan, Mixed Vegetables, Onion, Black Pepper Powder, Garlic, Fresh Herbs, Butter, Salt, Whole Wheat Flour, Butter, Milk, Mustard Powder Paste, Whole Black Peppercorns, Salt",21,10,30,40,2,Continental,World Breakfast,Vegetarian
Strawberry Raita ,"Of Strawberries, , Onion, Green Chili, Sugar, Cumin Powder, Salt, Pepper Powder, Coriander, Strawberry",10,15,15,30,4,Indian,Side Dish,Vegetarian
Eggless Mango Cake Recipe,"All Purpose Flour, Chiroti Rava, Milk Powder, Baking Soda, Baking Powder, Mixed Nuts, Salt, Sugar, Cardamom, Mango, Curd, Sunflower Oil, Hot Water",13,15,60,75,8,Continental,Dessert,Vegan
Amritsari Ajwaini Paneer ,"Cheese, Tomato Puree, Onion, Garlic, Green Chili, Ginger, Cashews, , Celery, Garam Masala Powder, Turmeric Powder, , Red Chilli Powder, Sugar, Salt, Oil, Coriander",17,20,40,60,4,North Indian Recipes,Side Dish,Vegetarian
"Rava Upma Recipe With Peanuts, Peas & Corn","Semolina, Mustard, Ghee, Peanuts, Cumin Seeds, Onion, Ginger, Asafetida, White Urad Dal, Green Chilli, Curry Leaves, Carrot, Capsicum, Tomato, Green Peas, Green Coriander, Sweet Corn, Lemon Juice, Salt, Red Chili Powder, Coriander Powder, Pomegranate",22,10,20,30,4,South Indian Recipes,South Indian Breakfast,Diabetic Friendly
Tamil Nadu Style Kothamali Aval Upma Recipe - Coriander Poha Recipe,"Poha, Turmeric Powder, Salt And Pepper, Fresh Coconut, Coriander, Green Chilli, Jaggery, Lemon Juice, Sunflower Oil, Mustard Seeds, White Urad Dal, Curry Leaves",12,10,15,25,4,Tamil Nadu,South Indian Breakfast,Vegetarian
Carrot Puree Recipe - First Food For Babies,"Carrot, Water",2,5,20,25,1,Indian,Lunch,Vegetarian
Heart Shaped Sugar Cookies Recipe,"Vivatta Maida, Salt, Butter, Chilled Water, Sugar, Vivatta Maida",6,60,30,90,1,Continental,Snack,Vegetarian
Eggless Chocolate Banana Cake Recipe,"Butter, Caster Sugar, Dark Chocolate, Vivatta Maida, Baking Powder, P Salt, Baking Soda, Ripe Bananas, Chocolate Chips, Flax Seed Powder, Chilled Water, Chilled Water",12,20,45,65,4,Continental,Dessert,Vegetarian
Cranberry Whole Wheat Naan Recipe,"Whole Wheat Flour  Extra For Dusting, Active Dry Yeast, Sugar, Curd, Lukewarm Water, Salt, Sunflower Oil, Ghee Butter As Needed, Prune Spread, Cranberries, Black Sesame Seeds, Badam",12,45,25,70,4,North Indian Recipes,Lunch,Vegetarian
Paneer And Grapes Platter Recipe - Healthy Party Appetizer,"Paneer, Black Grapes, Toothpicks, Extra Virgin Olive Oil, Dill Leaves, Parsley Leaves, Canned Cherries",7,30,0,30,10,Continental,Snack,Vegetarian
Methi Masoor Dal Recipe With Whole Masoor,"Masoor Dal, Methi Leaves, Asafoetida, Cumin Seeds, Onion, Tomato, Green Chilli, Coriander Powder, Turmeric Powder, Red Chilli Powder, Salt, Ghee",12,10,30,40,4,North Indian Recipes,Lunch,High Protein Vegetarian
Chocolate Flan Cake Recipe,"Vivatta Maida, Sugar, Cocoa Powder, Baking Powder, Baking Soda, Salt, Whole Eggs, Milk, Sunflower Oil, Vanilla Extract, Hot Water, Fl Oz Britannia Cream Cheese, Whole Eggs, Fl Oz Condensed Milk, Fl Oz Evaporated Milk, Vanilla Extract",16,20,60,80,4,Continental,Dessert,Eggetarian
Spinach And Paneer Samosa Recipe With Figaro Pure Olive Oil,"Whole Wheat Flour, Sooji, Figaro Pure Olive Oil, Ajwain, Salt, Water Knead, Spinach, Paneer, Green Chilli, Garam Masala Powder, Chaat Masala Powder, Salt, Figaro Pure Olive Oil",13,20,40,60,5,Indian,Snack,Vegetarian
Karnataka Style Badnekayi Mosaru Gojju Recipe,"Brinjal, Hung Curd, Coriander, Green Chilli, Salt, Mustard Seeds, White Urad Dal, Chana Dal, Asafoetida, Dry Red Chilli, Curry Leaves",11,5,45,50,4,Karnataka,Lunch,Vegetarian
Assamese Poita Bhat With Aloo Pitika Recipe,"Cooked Rice, Curd, Onion, Green Chilli, Salt, Potato, Turmeric Powder, Mustard Oil, Green Chilli, Salt",10,5,20,25,2,Assamese,North Indian Breakfast,Gluten Free
Chicken Taquitos Recipe - A Classic Mexican Appetizer,"Tomato, Onion, Green Chilli, Cumin Powder, Salt, Sugar, Coriander, Tabasco Original, Homemade Tomato Puree, Makki Ka Atta, All Purpose Flour, Salt, Water, Extra Virgin Olive Oil, Chicken Breasts, Garlic, Taco Seasoning, Cheddar Cheese",18,10,25,35,4,Mexican,Appetizer,Non Vegeterian
Lobia Masala ,"Cowpea, Tomato Puree, Cumin Seeds, Ginger, Green Chili, Turmeric Powder, Coriander Powder, Red Chilli Powder, Sugar, Lemon Juice Tamarind Water, Oil, Salt, Coriander Leaves",13,10,35,45,3,Punjabi,Lunch,High Protein Vegetarian
Lebanese Style Mujaddara Recipe,"Basmati Rice, Masoor Dal, Onion, Cumin Seeds, Black Pepper Powder, Cinnamon Powder, Red Chilli Powder, Badam, Lemon Juice, Salt, Sunflower Oil, Hung Curd, Coriander",13,15,30,45,4,Middle Eastern,Main Course,Vegetarian
Sindhi Kheerni Recipe - Sindhi Seviyan Kheer,"Cardamom Powder, Thin Semiya, Milk, Saffron Strands, Sugar, Badam, Pistachios",7,5,25,30,4,Sindhi,Dessert,Vegetarian
Papaya Basil Smoothie With Chia Seeds Recipe,"Papaya, Basil Leaves, Milk, Honey, Chia Seeds, Badam",6,5,5,10,2,Continental,World Breakfast,Vegan
Whole Wheat Methi Garlic Naan Recipe  | Oven Method with yeast,"Whole Wheat Flour, Active Dry Yeast, Salt, Sugar, Garlic, Methi Leaves, Curd, Sunflower Oil, Butter",9,120,20,140,12,North Indian Recipes,Dinner,Vegetarian
Savory Oatmeal Bowl with SautÃ©ed Spinach and Corn Recipe,"Rolled Oats Or Instant Oats, Water, Garlic, Spinach, Sweet Corn, Red Chilli Flakes, Dried Thyme Leaves, Salt",8,10,15,25,1,World Breakfast,Vegetarian,Vegetarian
Marghi Na Farcha Recipe - Parsi Crispy Fried Chicken,"Chicken Thighs, Red Chilli Powder, Turmeric Powder, Ginger, Garlic, Green Chilli, Salt, Onion, Coriander, Cumin Seeds, Cinnamon Stick, Whole Wheat Bread Crumbs, Sunflower Oil",13,15,30,45,3,Parsi Recipes,Main Course,Non Vegeterian
Spaghetti Aglio Olio Pasta Recipe with Bacon,"Spaghetti Pasta, Garlic, Extra Virgin Olive Oil, Red Chilli Flakes, Mixed Herbs, Bacon Strips, Salt, Parmesan Cheese, Stalk Parsley Leaves",9,10,35,45,4,Italian Recipes,Dinner,Non Vegeterian
Chicken In Tomato Onion Gravy Recipe,"Chicken, Sunflower Oil Cook, Onion, Green Chilli, Tomato, Ginger Garlic Paste, Curd, Lemon, Chicken Masala, Salt, Coriander",11,10,20,30,4,Indian,Side Dish,High Protein Non Vegetarian
Mangalorean Style Bella Metthe Dosa Recipe (Jaggery & Fenugreek Seed Pancakes Recipe),"Rice, White Urad Dal, Methi Seeds, Jaggery, Fresh Coconut, Brown Rice, Active Dry Yeast, Sugar, Salt",9,560,10,570,4,Mangalorean,Indian Breakfast,Vegetarian
Hariyali Paneer Tikka Masala Gravy Recipe -No Onion No Garlic Recipe,"Paneer, Fennel Seeds, Green Chilli, Coriander, Mint Leaves, Tomato, Ginger, Cinnamon Stick, Cardamom, Bay Leaf, Garam Masala Powder, Chaat Masala Powder, Fresh Cream, Salt, Butter Cook",15,20,25,45,4,North Indian Recipes,Lunch,High Protein Vegetarian
Chocolate Crinkle Cookies Recipe,"Cocoa Powder, Caster Sugar, Butter, Whole Eggs, Vanilla Extract, All Purpose Flour, Baking Powder, Salt, Icing Sugar",9,25,35,60,4,Continental,Snack,Vegetarian
Chicken Mapas Recipe - Chicken in Coconut Milk Curry,"Chicken, Onion, Tomato, Green Chilli, Garlic, Ginger, Red Chilli Powder, Turmeric Powder, Coriander Powder, Garam Masala Powder, Curry Leaves, Coconut Milk, Coconut Oil, Salt",14,10,45,55,4,South Indian Recipes,Lunch,High Protein Non Vegetarian
Gavar Pumpkin Sabji Recipe,"Gawar Phali, Kaddu, Onion, Garlic, Dry Red Chilli, Methi Seeds, Asafoetida, Fennel Seeds, Coriander Powder, Cumin Seeds, Mustard Seeds, Amchur, Roasted Peanuts, Turmeric Powder, Sunflower Oil, Salt, Coriander",17,10,20,30,4,Indian,Lunch,Vegetarian
Watermelon Bocconcini Arugula Salad Recipe,"Watermelon, Arugula Leaves, Bocconcini Cheese, Whole Black Peppercorns, Salt, Lemon Juice",6,10,0,10,2,Continental,Appetizer,Vegetarian
Strawberry Compote Recipe (Coulis),"Strawberries, Sugar, Lemon Juice",3,0,30,30,6,Continental,Vegetarian,Non Vegeterian
Awadhi Style Sultani Dal Recipe,"Arhar Dal, Milk, Fresh Cream, Curd, Onion, Cumin Seeds, Red Chilli Powder, Green Chilli, Garlic, Ginger, Cardamom, Ghee Oil For Cooking, Salt",13,10,30,40,4,Awadhi,Dinner,High Protein Vegetarian
Pomegranate Flavoured Stuffed Khandvi Recipe,"Gram Flour, Curd, Pomegranate Juice, Red Chilli Powder, Salt, Paneer, Fresh Coconut, Sugar, Green Chilli, Coriander, Sesame Seeds, Salt, Sunflower Oil, Mustard Seeds, Asafoetida, Green Chilli, Coriander, Fresh Coconut",18,20,30,50,4,Gujarati Recipesï»¿,Snack,Vegetarian
Lemon Cherry Berry Spa Water Recipe,"Mixed Berries, Lemon, Mint Leaves, Water, Ice Cubes",5,10,10,20,2,Continental,Snack,Vegetarian
High Protein Soya Dosa Recipe,"Idli Rice, Soybeans, White Urad Dal, Methi Seeds, Chana Dal, Salt, Water, Ghee",8,360,45,405,12,South Indian Recipes,South Indian Breakfast,High Protein Vegetarian
Doi Bhetki Recipe - Bengali Style Yogurt Fish Curry,"Bhetki Fish, Curd, Onion, Green Chilli, Garlic, Ginger, Turmeric Powder, Cumin Powder, Coriander Powder, Red Chilli Powder, Garam Masala Powder, Black Pepper Powder, Bay Leaf, Cloves, Cardamom, Mustard Oil, Salt",17,10,60,70,4,Bengali Recipes,Dinner,High Protein Non Vegetarian
"Ginger, Lemon And Honey Kadha Recipe","Ginger, Honey, Lemon Juice, Water",4,10,0,10,10,Indian,Vegetarian,High Protein Non Vegetarian
Maharashtrian Style Gajarachi Koshimbir Recipe -Carrot Salad,"Carrots, Lemon Juice, Fresh Coconut, Salt, Coriander, Mustard Seeds, Asafoetida, Sunflower Oil",8,10,20,30,4,Maharashtrian Recipes,Side Dish,Vegetarian
Red Chilli and Tomato Pachadi Recipe,"Sunflower Oil, White Urad Dal, Chana Dal, Fresh Red Chilli, Tomato, Salt, Tamarind Paste, Mustard Seeds, Cumin Seeds, Curry Leaves",10,5,10,15,6,South Indian Recipes,Side Dish,Vegetarian
Rajasthani Laal Maas Recipe-Mutton In Red Spicy Gravy,"Kashmiri Dry Red Chilli, Mutton, Curd, Cumin Seeds, Cumin Powder, Coriander Powder, Turmeric Powder, Ginger Garlic Paste, Ghee, Brown Cardamom, Cardamom, Cinnamon Stick, Cloves, Bay Leaf, Onion, Garam Masala Powder, Salt, Coriander, Charcoal",19,10,40,50,4,Rajasthani,Dinner,Non Vegeterian
Vegetable Pasta Soup Recipe,"Mixed Vegetables, Onion, Garlic, Tomato, Pasta, Kabuli Chana, Tomato Ketchup, Dried Basil Leaves, Cinnamon Powder, Paprika Powder Red Chilli Flakes, Whole Black Peppercorns, Turmeric Powder, Salt, Water, Extra Virgin Olive Oil",15,10,30,40,4,Italian Recipes,Dinner,Vegetarian
Mor Milagai Recipe - South Indian Sun Dried Chillies,"Green Chilli, Curd, Water, Salt",4,10,0,10,100,South Indian Recipes,Side Dish,Vegetarian
Whole Wheat Spinach Paneer Lifafa Paratha Recipe,"Whole Wheat Flour, Ghee, Salt, Ghee, Corn Flour, Paneer, Spinach Leaves, Cumin Seeds, Cumin Powder, Chaat Masala Powder, Onion, Green Chilli, Salt, Sunflower Oil",14,20,45,65,4,Indian,Lunch,Diabetic Friendly
Instant Palkova Recipe (Milk Based Sweet Recipe),"Condensed Milk, Curd",2,10,20,30,2,Tamil Nadu,Dessert,Vegetarian
Kathirikai Gotsu Recipe,"Eggplant, Small Onion, Tomato, Ginger, Tamarind Water, Sambar Powder, Asafoetida, Turmeric Powder, Jaggery, Rye, Curry Leaves, Sesame Oil, Salt, Green Coriander",14,20,30,50,4,South Indian Recipes,Side Dish,Vegetarian
Roasted Cauliflower Broccoli Au Gratin Recipe,"Broccoli, Cauliflower, Garlic, Onion, Extra Virgin Olive Oil, Salt, Milk, Corn Flour, Whole Black Pepper Corns, Mixed Herbs, Cheese Spread, Salt, Cheddar Cheese",13,10,50,60,4,Continental,Main Course,Vegetarian
Himachali Khatta Recipe (Tangy Black Chickpea Curry),"Kala Chana, Bay Leaf, Onion, Mustard Oil, Mustard Seeds, Cumin Seeds, Asafoetida, Gram Flour, Turmeric Powder, Water, Jaggery, Coriander Powder, Garam Masala Powder, Amchur, Red Chilli Powder, Asafoetida, Gram Flour, Turmeric Powder, Salt",19,540,40,580,4,Himachal,Lunch,High Protein Vegetarian
Kung Pao Spaghetti Recipe,"Spaghetti Pasta, Chicken Breasts, Raw Peanuts, Dry Red Chilli, Sunflower Oil, Cloves Garlic, Ginger  Julienned, Spring Onion Greens, Corn Flour, Rice Wine Vinegar, Light Soy Sauce, Dark Soy Sauce, Sugar, White Vinegar, Water",15,20,20,40,2,Asian,Dinner,Non Vegeterian
Rajasthani Kalmi Vada Recipe - Chana Dal Vada,"Chana Dal, Onion, Garlic, Coriander, Green Chilli, Red Chilli Powder, Cumin Seeds, Salt, Sunflower Oil",9,10,20,30,5,Rajasthani,Snack,Vegetarian
Burnt Garlic Mushroom Fried Rice Recipe,"Cooked Rice, Sunflower Oil, Button Mushrooms, Garlic, Onion, Ginger, Green Chilli, Carrot, Spring Onion Greens, Salt, Black Pepper Powder, Schezwan Sauce, Vinegar, Soy Sauce, Garlic",15,15,20,35,4,Indo Chinese,Main Course,Vegetarian
Refreshing Smoothie Recipe With Cucumber & Kiwi,"Cucumber, Kiwi, Green Apple, Tender Coconut Water, Lemon Juice, Mint Leaves, Chia Seeds, Ice Cubes",8,10,5,15,1,Continental,World Breakfast,Vegan
How to Make Tutty Fruity Recipe,"Raw Papaya, Sugar, Vanilla Extract, Saffron Strands",4,20,60,80,1,Continental,World Breakfast,Vegan
Himachali Bhey Recipe - Stir Fried Lotus Stem,"Lotus Stem, Ginger, Garlic, Onion, Red Chilli Powder, Turmeric Powder, Coriander Powder, Gram Flour, Sunflower Oil",9,20,30,50,4,Himachal,Side Dish,Vegetarian
Chalimidi Recipe,"Jaggery, Rice, Cardamom Powder, Ghee, Cashew Nuts, Raisins, Fresh Coconut",7,20,45,65,4,South Indian Recipes,Dessert,Vegetarian
Achari Baingan Bharta ,"Eggplant, Tomato, Onion, Garlic, Green Chilli, Ginger, Turmeric Powder, Green Coriander, Tablespoon Coriander Powder, Red Chilli Powder, Pickle  Mango, , Oil, Asafoetida, Salt, Teaspoon Mustard Seeds, Cumin Seeds, Fennel Seeds, Kalonji Seeds, Fenugreek Seeds, Celery, Dry Red Chilli, Mango Powder Powder",23,10,45,55,3,North Indian Recipes,Lunch,Vegetarian
Tomato Onion Chutney Recipe With Coconut And Mint,"Onion, Tomato, Green Chilli, Mint Leaves, Fresh Coconut, Mustard Seeds, Asafoetida, Curry Leaves, Sunflower Oil, Salt",10,5,10,15,4,South Indian Recipes,Side Dish,Vegetarian
How to Cook Lentils (Dals/Pulses) in a Pressure Cooker,"Yellow Moong Dal, Water As Needed",2,0,30,30,4,South Indian Recipes,Side Dish,Vegetarian
Tangy Lemon Pickle Recipe With Kalonji & Rock Salt,"Lemons, Kalonji, Turmeric Powder, Black Pepper Powder, Mustard Oil, Rock Salt, Mustard Seeds, Asafoetida, Red Chilli Powder",9,20,15,35,20,Indian,Side Dish,Vegetarian
Dal Kabila Recipe,"Ghee, White Urad Dal, Cinnamon, , Dry Red Chilli, Onion, Garlic, Ginger, Tomato, Green Chili, Red Chilli Powder, Coriander Powder, Turmeric Powder, Garam Masala Powder, Green Coriander, Ghee, Cumin Seeds, Whole Pepper",18,10,20,30,4,North Indian Recipes,Lunch,Diabetic Friendly
Avocado Salsa Open Multigrain Toast With Fried Egg Recipe,"Whole Wheat Brown Bread, Whole Eggs, Avocado, Tomato, Onion, Garlic, Green Chilli, Coriander, Lemon, Del Monte Cheesy Garlic Mayo, Salt, Black Pepper Powder, Butter",13,15,15,30,2,Continental,World Breakfast,Eggetarian
Masala Oats And Potato Sandwich Recipe,"Whole Wheat Brown Bread, Tomato, Onion, Potato, Rolled Oats Or Instant Oats, Ginger, Green Chilli, Turmeric Powder, Curry Leaves, Coriander, Salt, Sunflower Oil, Mustard Seeds, White Urad Dal, Chana Dal, Asafoetida",16,10,30,40,4,Continental,World Breakfast,Vegetarian
Basbousa Recipe - Middle Eastern Semolina Cake,"Sooji, Sugar, Dessicated Coconut, All Purpose Flour, Baking Powder, Sunflower Oil, Milk, Vanilla Extract Essence, Badam, Water, Sugar, Lemon Juice, Rose Essence",13,50,50,100,4,Middle Eastern,Snack,Vegetarian
Spicy Egg Biryani Recipe with Figaro Olive Oil,"Basmati Rice, Onion, Onion, Tomato, Whole Eggs, Green Chilli, Ginger, Garlic, Mint Leaves, Curd, Saffron Strands, Turmeric Powder, Red Chilli Powder, Garam Masala Powder, Bay Leaves, Cinnamon Stick, Cloves, Salt, Figaro Pure Olive Oil, Onion, Coriander, Cashew Nuts, Coriander, Cashew Nuts",24,30,70,100,4,Indian,Lunch,Eggetarian
Whole Wheat Lemon & Cranberry Muffins Recipe,"Whole Wheat Flour, Coconut Sugar, Whole Eggs, Buttermilk, Lemon Zest, Cranberries, Baking Powder, Vanilla Extract, Corn Flakes Meuseli, Brown Sugar, Cranberries",11,20,30,50,4,Continental,Dessert,Vegetarian
French Toast Jam Roll Ups Recipe,"Whole Wheat Brown Bread, Jam, Dessicated Coconut, Ghee",4,5,10,15,3,Continental,World Breakfast,Vegetarian
Roasted Potatoes With Za'atar Recipe,"Potato, Lemon Juice, Extra Virgin Olive Oil, Paprika Powder, Za'Atar, Sesame Seeds, Sumac, Dried Thyme Leaves, Sea Salt",9,25,20,45,4,Mediterranean,Snack,Vegetarian
One Pot Tomato Rice Recipe Using Preethi Electric Pressure Cooker - Thakkali Sadam,"Rice, Pearl Onion, Garlic, Tomato, Mustard Seeds, Curry Leaves, Sambar Powder, Cardamom Powder, Turmeric Powder, Mint Leaves, Sesame, Ghee, Salt",13,10,30,40,4,South Indian Recipes,Lunch,Vegetarian
Quick & Spicy Mutton Curry Recipe,"Mutton, Tomato, Salt, Sunflower Oil, Water, Fresh Coconut, Onion, Whole Black Peppercorns, Coriander, Ginger, Garlic, Turmeric Powder, Salt, Cloves, Cinnamon Stick, Red Chilli Powder, Salt",17,30,30,60,3,Indian,Dinner,Non Vegeterian
Aloo Beans Sabzi Recipe - Potato & Beans Stir Fry,"Potato, Green Beans, Mustard Seeds, Cumin Seeds, Coriander Powder, Turmeric Powder, Asafoetida, Red Chilli Powder, Curry Leaves, Sunflower Oil",10,10,30,40,4,Gujarati Recipesï»¿,Lunch,Vegetarian
Oven Crisped Burritos with Shredded Chicken Recipe,"Chicken Breasts, Green Bell Peppers, Onion, Garlic, Cumin Seeds, Black Pepper Powder, Salt, Makki Ka Atta, Whole Wheat Flour, Extra Virgin Olive Oil, Water Knead",11,10,45,55,4,Fusion,Appetizer,Non Vegeterian
Bajri Methi Na Vada Recipe - Pearl Millet Flour Fritters,"Bajra Flour, Whole Wheat Flour, Red Chilli Powder, Coriander Powder, Methi Leaves, Curd, Sunflower Oil, Green Chilli, Sesame Seeds, Ajwain, Cumin Powder, Salt",12,20,30,50,4,Maharashtrian Recipes,Snack,Vegetarian
Lauki Paratha Recipe - Bottle Gourd Flatbread,"Bottle Gourd, Whole Wheat Flour, Green Chilli, Ajwain, Ginger, Red Chilli Powder, Garam Masala Powder, Ghee, Salt",9,20,30,50,4,North Indian Recipes,Indian Breakfast,Diabetic Friendly
Hunase Gojju Recipe,"Tamarind Paste, Jaggery, Rasam Powder Red Chilli Powder, Salt, Sunflower Oil, Methi Seeds, Curry Leaves, Mustard Seeds, Asafoetida, Green Chilli",10,10,30,40,4,Karnataka,Lunch,Vegetarian
Herbed Potato Salad Recipe,"Potato, Vegetable Stock, Garlic, Curd, Mixed Herbs, Classic Mayonnaise, Fresh Cream, Vinegar, Coriander, Stalks Spring Onion Greens Roasted Peanuts For Garnish, Salt And Pepper",11,20,30,50,8,Continental,Appetizer,Vegetarian
Carrot Capsicum Poriyal Recipe,"Carrots, Capsicum, Mustard, Cumin Seeds, White Urad Dal, Curry Leaves, Green Chilli, Coconut, Salt, Sesame Oil",10,10,20,30,4,South Indian Recipes,Side Dish,No Onion No Garlic (Sattvic)
Kadai Mushroom Recipe,"Button Mushrooms, Cumin Seeds, Onion, Garlic, Ginger, Green Bell Pepper, Red Bell Pepper, Carrot, Tomato, Brown Cardamom, Kasuri Methi, Turmeric Powder, Red Chilli Powder, Coriander Powder, Garam Masala Powder, Ghee, Salt, Honey",18,10,20,30,4,Indian,Dinner,Vegetarian
Beetroot Carrot Raita Recipe,"Carrot, Beetroot, Curd, Cumin Powder, Red Chilli Powder, Salt, Chaat Masala Powder, Mint Leaves",8,15,10,25,4,Indian,Side Dish,Vegetarian
Crunchy Fish Tacos - Perfect Mexican Appetizer,"Tortillas, Carrot, Cabbage, Onion, Sour Cream, Black Pepper Powder, Salt, Sunflower Oil Deep Fry, Basa Fish, Salt, Black Pepper Powder, Whole Egg, Rice Flour, Corn Flour, All Purpose Flour, Dry Mix Herbs, Cheese",17,15,30,45,4,Mexican,Appetizer,Non Vegeterian
Masala Jowar Bhakri Recipe,"Jowar Flour, Onion, Green Chilli, Coriander, Curry Leaves, Sesame Seeds, Ajwain, Sunflower Oil, Salt",9,15,20,35,2,Maharashtrian Recipes,Indian Breakfast,Gluten Free
Green Moong Dal Sundal Recipe,"Sesame, Mustard Seeds, Cumin Seeds, Asafoetida, Curry Leaves, Green Chilli, Salt, Fresh Coconut, Green Moong Sprouts, Lemon Juice, Coriander",11,420,20,440,4,South Indian Recipes,Side Dish,Vegetarian
"Mexican Breakfast Tortilla, Fried Eggs & Black Beans With Salsa Recipe","Tortillas, Refried Beans, Guacamole, Whole Eggs, Tomato Salsa, Sunflower Oil, Sour Cream",7,10,15,25,4,Mexican,World Breakfast,Eggetarian
Bengali Chirer Pulao Recipe - Bengali Style Vegetable Poha,"Poha, Onion, Carrot, Green Beans, Cauliflower, Green Peas, Roasted Peanuts, Raisins, Kalonji, Turmeric Powder, Sugar, Salt And Pepper, Lemon Juice, Coriander, Sunflower Oil",15,10,25,35,4,Bengali Recipes,North Indian Breakfast,Vegetarian
Pan Fried Chinese Chilli Chicken recipe,"Boneless Chicken, Extra Virgin Olive Oil, Red Yellow And Green Bell Peppers, Onion, Garlic  Minced, Green Chilli, Stalks Spring Onion, Soy Sauce, Whole Black Peppercorns, Red Chilli Powder, Whole Eggs, Rice Flour, Soy Sauce, Red Chilli Sauce, Tomato Ketchup, Whole Black Peppercorns, Honey",17,15,35,50,4,Chinese,Dinner,Non Vegeterian
Instant Oats Rava Idli Recipe,"Instant Oats, Sooji, Curd, Carrot, Coriander, Enos Fruit Salt, Salt, Sunflower Oil, Mustard Seeds, Curry Leaves, Asafoetida, Green Chilli, Chana Dal, Cashew Nuts",14,0,30,30,4,South Indian Recipes,South Indian Breakfast,Diabetic Friendly
Maharashtrian Style Farasbi Chi Bhaji Recipe - Beans Cooked With Peanuts,"Green Beans, Raw Peanuts, Maharashtrian Goda Masala, Turmeric Powder, Jaggery, Red Chilli Powder, Mustard Seeds, Asafoetida, Curry Leaves, Lemon Juice, Sunflower Oil, Salt",12,10,15,25,4,Maharashtrian Recipes,Lunch,Vegetarian
Creamy & Delicious Egg Mayo Sandwich Recipe - Kids Recipes Made With Del Monte,"Whole Wheat Brown Bread, Whole Eggs, Classic Mayonnaise, Cucumber, Coriander, Salt And Pepper",6,20,20,40,4,Continental,World Breakfast,High Protein Non Vegetarian
Pumpkin Creme Brulee Recipe,"Heavy Whipping Cream, Pumpkin Puree, Brown Sugar, Egg Yolks, Pumpkin Pie Spice, Sugar",6,15,25,40,8,French,Dessert,Eggetarian
Vegan Curried Rice with Chickpeas Recipe,"Brown Rice, Kabuli Chana, Garlic, Ginger, Fennel Seeds, Vegetable Stock, Curry Powder, Salt, S Coriander",9,10,45,55,4,Asian,Lunch,Vegetarian
Vegan Godhi Payasa Recipe  - Lapsi Kheer,"Broken Wheat, Coconut Oil, Cardamom, Cashew Nuts, Badam, Poppy Seeds, Fresh Coconut, Jaggery",8,140,30,170,3,South Indian Recipes,Dessert,Vegetarian
Maize Daliya Khichri Recipe,"Maize Dalia, Govind Bhog Rice Risotto Rice, Carrot, Green Beans, Potato, Ghee, Panch Phoran Masala, Green Chilli, Ginger, Cardamom, Bay Leaf, Turmeric Powder, Red Chilli Powder, Garam Masala Powder, Water, Salt",16,10,20,30,2,Indian,Dinner,Vegetarian
Spiced Beetroot Buttermilk Recipe,"Beetroots, Curd, Water, Ginger, Green Chilli, Chaat Masala Powder, Salt, Mustard Seeds, Curry Leaves, Sunflower Oil",10,10,15,25,6,South Indian Recipes,Lunch,Vegetarian
North East Khapse Recipe (Deep Fried Biscuits From Arunachal),"All Purpose Flour, Sunflower Oil, Sugar, Milk",4,20,30,50,4,Indian,Snack,Vegetarian
Pea And Spring Onion Soup Recipe,"Green Peas, Spring Onion Greens, Spring Onion, Garlic, Extra Virgin Olive Oil, Salt, Black Pepper Powder, Vegetable Stock, Fresh Cream, Black Pepper Powder",10,10,30,40,4,Continental,Appetizer,Vegetarian
Baked & Crisp Whole Wheat Methi Puri Recipe (Healthy Snack),"Whole Wheat Flour, Kasuri Methi, Red Chilli Powder, Cumin Powder, Turmeric Powder, Kalonji, Ghee, Salt",8,20,30,50,6,Indian,Snack,Non Vegeterian
Pumpkin Chapati Recipe,"Whole Wheat Flour, Kaddu, Salt, Sunflower Oil, Ghee Oil For Cooking",5,10,25,35,4,Indian,Lunch,Vegetarian
Vepilakatti - Lime Leaves Pickle Recipe,"Kaffir Lime Leaves Lemon Leaves, Dry Red Chilli, Shallots, Curry Leaves, Salt, Tamarind, Asafoetida",7,10,15,25,6,South Indian Recipes,Side Dish,Vegetarian
Khaman Dhokla Poha Recipe,"Khaman Dhokla, Onion, Mustard Seeds, Green Chilli, Asafoetida, Fresh Coconut, Coriander, Sunflower Oil",8,10,35,45,4,North Indian Recipes,North Indian Breakfast,Vegetarian
Singhare Atte Ka Halwa/Sheera Recipe (Water Chestnut Flour Halwa Recipe),"Singoda Flour, Sugar, Ghee, Water, Cardamom Powder, Cashew Nuts",6,15,30,45,4,North Indian Recipes,Dessert,Vegetarian
Gajar Vadi Recipe - Maharashtrian Style Steamed Carrot Dumplings,"Carrot, Gram Flour, Whole Wheat Flour, Red Chilli Powder According, Turmeric Powder, Cumin Powder, Curd, Sunflower Oil, Lemon Juice, Sugar, Salt, Sunflower Oil, Sesame Seeds, Mustard Seeds, Cumin Seeds, Asafoetida, Curry Leaves, Green Chilli",18,15,20,35,2,Maharashtrian Recipes,Side Dish,Vegetarian
Soya Chunks Pepper Curry Recipe,"Soy Chunks, Green Bell Pepper, Water, Sunflower Oil, Garlic, Cumin Seeds, Curry Leaves, Pearl Onion, Tomato, Green Chilli, Sambar Powder, Red Chilli Powder, Coriander Powder, Salt",14,10,20,30,3,Indian,Lunch,High Protein Vegetarian
Mexican Inspired Vegetarian Oven Roasted Stuffed Pepper Recipe,"Red Bell Pepper, Rice, Onion, Tomato, Garlic, Celery, Rajma, Paprika Powder, Cumin Powder, Paneer, Cheddar Cheese, Salt And Pepper, Coriander, Mint Leaves",14,15,70,85,12,Mexican,Appetizer,Vegetarian
Pan Fried Brussel Sprouts Recipe,"Brussel Sprouts, Garlic, Black Pepper Powder, Mixed Herbs, Garlic Salt, Extra Virgin Olive Oil",6,5,15,20,2,Indian,Side Dish,Vegetarian
Ravioli Recipe With Broccoli Filling In White And Red Sauce,"All Purpose Flour, Whole Eggs, Salt, Extra Virgin Olive Oil, Broccoli, Extra Virgin Olive Oil, Garlic, Salt, Mozzarella Cheese, Red Chilli Flakes, Dried Oregano, Dried Thyme Leaves, Whole Black Peppercorns, Salt, Tomato, Butter, All Purpose Flour, Milk, Salt, Whole Black Peppercorns, Garlic, Spinach, Del Monte Whole Corn Kernels, Red Chilli Flakes, Dried Thyme Leaves, Dried Oregano, Basil Leaves, Salt, Extra Virgin Olive Oil",29,10,40,50,4,Italian Recipes,Lunch,Vegetarian
Doi Ilish Recipe - Bengali Style Hilsa In Yogurt Gravy Recipe,"Fish, Curd, Kasundi Mustard Sauce, Kalonji, Turmeric Powder, Red Chilli Powder, Green Chilli, Mustard Oil, Salt",9,5,20,25,5,Bengali Recipes,Lunch,High Protein Non Vegetarian
The Homemade Hard Taco Shells Recipe,"Makki Ka Atta, All Purpose Flour, Sunflower Oil, Salt",4,15,15,30,8,Mexican,Main Course,Vegetarian
Paneer Stuffed Ragi Paratha Recipe - High Protein Breakfast,"Ragi Flour, Whole Wheat Flour, Salt, Sunflower Oil, Paneer, Green Chilli, Mint Leaves, Cumin Powder, Salt, Ghee",10,15,20,35,6,North Indian Recipes,North Indian Breakfast,Diabetic Friendly
Sri Lankan Beans With Coconut Recipe,"Green Beans, Onion, Curry Leaves, Garlic, Turmeric Powder, Coconut Milk, Salt, Coconut Oil",8,10,30,40,4,Sri Lankan,Side Dish,Vegetarian
Buttered Peas Puree Recipe For Babies Above 6 months,"Green Peas, Butter, Salt",3,15,10,25,2,Indian,Lunch,Vegetarian
Healthy Brown Rice Salad Recipe,"Brown Rice, Spinach Leaves, Green Bell Pepper, Red Bell Pepper, Carrot, Sweet Corn, Strawberries, Cranberries, Onion, Badam, Feta Cheese, Extra Virgin Olive Oil, Apple Cider Vinegar, Honey, Garlic, Salt, Black Pepper Powder",17,10,30,40,4,Continental,Appetizer,Vegetarian
Bhaji Miligai And Baby Potato Fry Recipe,"Green Chilli, Baby Potato, Turmeric Powder, Garlic, Curry Leaves, Sunflower Oil, Gram Flour, Rice Flour",8,10,15,25,3,Indian,Appetizer,Vegetarian
Quinoa-Flaxseed Banana Muffins Recipe,"Ripe Bananas, Whole Eggs, Curd, Sunflower Oil, Brown Sugar, Chocolate Chips, Flax Seeds, Instant Oats, Quinoa, Whole Wheat Flour, Cocoa Powder, Baking Powder, Baking Soda, Salt",14,15,45,60,6,Continental,World Breakfast,Eggetarian
Sprouted Ragi & Rajma Cutlets Recipe,"Rajma, Sprouted Ragi, Potato, Green Chilli, Turmeric Powder, Coriander Powder, Garam Masala Powder, Amchur, Makki Ka Atta, Coriander, Milk, Whole Wheat Bread Crumbs, Salt, Sunflower Oil",14,10,45,55,4,North Indian Recipes,Appetizer,High Protein Vegetarian
Creamy Thai Sweet Potato Curry Recipe,"Sweet Potato, Onion, Lemon Grass, Coconut Milk, Thai Red Curry Paste, Turmeric Powder, Coconut Oil, Salt, Garlic, Onion, Ginger, Fresh Turmeric Root, Green Chilli, Roasted Peanuts, Coriander",15,10,50,60,4,Asian,Dinner,Vegetarian
Carrot Capsicum Poriyal Recipe,"Carrots, Green Bell Pepper, Mustard Seeds, Cumin, White Urad Dal, Curry Leaves, Asafoetida, Green Chilli, Fresh Coconut, Salt, Sesame",11,10,20,30,4,South Indian Recipes,Side Dish,No Onion No Garlic (Sattvic)
Paneer in White Gravy Recipe - No Onion No Garlic Recipe,"Paneer, Ghee, Bay Leaf, Star Anise, Brown Cardamom, Cinnamon Stick, Green Chilli, Kasuri Methi, Cashew Nuts, Milk, Curd, Salt",12,10,25,35,4,North Indian Recipes,Lunch,Vegetarian
Thor Chal Recipe - Banana Stem Pulao Recipe,"Basmati Rice  Soaked In Water For  Minutes And Drain The Water, Salt, Banana Stem, Bay Leaf, Cinnamon Powder, Ghee, Cashew Nuts, Raisins, Sunflower Oil, Sugar",10,30,30,60,2,Bengali Recipes,Lunch,Vegetarian
Chicken Galouti Kebab Recipe,"Chicken Breasts, Onion, Garlic, Ginger, Raw Papaya, Kababchini, Cardamom Powder, Red Chilli Powder, Coriander, Mughlai Meetha Attar, Rose Water, Saffron Strands, Garam Masala Powder, Gram Flour, Salt, Ghee, Sunflower Oil",17,60,15,75,8,Lucknowi,Appetizer,Non Vegeterian
Chatpata Aloo Chaat Taco Recipe With Sour Cream & Salad,"Hard Taco Shells, Summer Salad, Tomato Salsa, Sour Cream, Potato, Roasted Peanuts, Chaat Masala Powder, Cumin Powder, Amchur, Salt, Lemon Juice, Lemon Juice",12,15,0,15,4,Mexican,Dinner,Vegetarian
Eggless Sugarless Oats And Nuts Cookie Recipe,"Instant Oats, Cashew Nuts, Badam, Whole Wheat Flour, Honey, Curd, Baking Soda, Vanilla Extract Pistachio Extract",8,10,65,75,4,Continental,Snack,Vegetarian
Badam Halwa Recipe - Delicious Almond Halwa With Khoya,"Badam, Ghee, Milk, Sugar, Khoya, Mixed Nuts",6,20,60,80,2,Indian,Dessert,Vegetarian
Stuffed Karela With Aloo Recipe,"Karela, Potato, Turmeric Powder, Red Chilli Powder, Garam Masala Powder, Chaat Masala Powder, Salt, Sunflower Oil",8,15,45,60,6,Indian,Lunch,Vegetarian
Indo Chinese Chicken Hakka Noodles Recipe,"Hakka Noodles, Chicken Breasts, Onion, Green Bell Pepper, Carrot, Garlic, Green Chilli, Soy Sauce, Tablespoon Vinegar, Tablespoon Red Chilli Sauce, Sunflower Oil, Salt, Black Pepper Powder",13,15,15,30,2,Indo Chinese,Dinner,Non Vegeterian
Lau Chingri Recipe (Bottle Gourd And Shrimp Curry),"Bottle Gourd, Shrimps, Cumin Seeds, Bay Leaf, Ginger, Tomato, Turmeric Powder, Cumin Powder, Salt, Sugar",10,10,20,30,2,Bengali Recipes,Lunch,Non Vegeterian
Raw Banana & Ajwain Paratha Recipe,"Whole Wheat Flour, Salt, Raw Banana, Ajwain, Garam Masala Powder, Amchur, Coriander Powder, Turmeric Powder, Green Chilli, Sugar, Coriander",11,10,30,40,4,North Indian Recipes,North Indian Breakfast,Diabetic Friendly
Strawberry Coconut Trifle Pudding Recipe,"Lemon Pound Cake   Into  Cubes, Coconut Milk, Corn Flour, Sugar, Strawberries, Walnuts",6,55,380,435,4,Continental,Dessert,Vegetarian
Spicy Soya Keema Masala Recipe,"Cups Soy Chunks, Onion, Tomato, Green Chilli, Bay Leaf, Black Cardamom, Cloves, Whole Black Peppercorns, Cinnamon Stick, Ginger Garlic Paste, Turmeric Powder, Coriander Powder, Red Chilli Powder, Tablespoon Garam Masala Powder, Tablespoon Lemon Juice, Salt, Sunflower Oil",17,15,25,40,2,North Indian Recipes,Dinner,High Protein Vegetarian
Greek Style Green Beans Stir Fry Recipe,"Green Beans, Onion, Garlic, Homemade Tomato Puree, Black Raisins, Whole Black Peppercorns, Red Chilli Flakes, Coriander, Salt, Extra Virgin Olive Oil",10,5,45,50,4,Greek,One Pot Dish,Vegetarian
Kothamalli Karuveppilai Sadam Recipe - Coriander And Curry Leaves Rice,"Cooked Rice, Salt, Mustard Seeds, White Urad Dal, Curry Leaves, Turmeric Powder, Roasted Peanuts, Sambar Powder, Gingelly Oil, Fresh Coconut, Coriander, Curry Leaves, Ghee",13,15,30,45,4,Tamil Nadu,Lunch,Vegetarian
Methi Chaman Recipe -Paneer In Dark Leafy Greens Based Gravy,"Methi Leaves, Spinach Leaves, Paneer, Green Chilli, Onion, Cumin Seeds, Mustard Oil, Turmeric Powder, Coriander Powder, Garam Masala Powder, Fresh Cream, Water, Salt",13,15,25,40,3,North Indian Recipes,Side Dish,Vegetarian
Quick Microwave Chocolate Pudding Recipe,"Cocoa Powder, Sugar, Corn Flour, Salt, Milk, Dark Chocolate Chips, Butter",7,5,30,35,4,Continental,Dessert,Vegetarian
Healthy Ragi Energy Balls with Strawberry Recipe,"Ragi Flour, Strawberries, Fresh Coconut, Salt, Sunflower Oil",5,10,45,55,2,Continental,Snack,Vegetarian
Lemon Rosemary Sauce Baked Penne Pasta Recipe,"Cups Penne Pasta, Butter, Garlic, Lemon Juice, Lemon, Rosemary, Black Pepper Powder, Mozzarella Cheese",8,15,20,35,2,Italian Recipes,Main Course,Vegetarian
No Churn Strawberry Ice Cream Recipe,"Heavy Whipping Cream, Condensed Milk, Lemon Juice, Strawberry Compote",4,360,15,375,4,Continental,Dessert,Vegetarian
Spaghetti With Broccoli And Smoked Almonds Recipe,"Spaghetti Pasta, Extra Virgin Olive Oil, Garlic, Badam, Green Chilli, Lemon Juice, Salt, Parmesan Cheese",8,10,5,15,2,Italian Recipes,Dinner,Vegetarian
Pizza With Soy And Corn Recipe,"Pizza Base, Mozzarella Cheese, Onion, Soy Granules, Sweet Corn, Homemade Tomato Puree, Dried Oregano, Butter, Tomato, Garlic, Sunflower Oil, Sugar, Dried Oregano, Red Chilli Flakes, Salt, Black Olives, Cherry Tomato Garnish",17,20,40,60,3,Italian Recipes,Dinner,High Protein Vegetarian
Healthy Jamun Cooler Recipe (Black Plum Juice),"Jamun, Chilled Water, Honey, Black Pepper Powder, Salt, Lemon, Mint Leaves",7,10,15,25,2,Indian,Snack,Vegetarian
Senai Kizhangu Gotsu Recipe - Spicy & Tangy Yam Curry Recipe,"Methi Seeds, Mustard Seeds, Curry Leaves, Pearl Onion, Tomato, Elephant Yam, Tamarind Water, Sambar Powder, Jaggery, Sesame, Salt, Sunflower Oil",12,10,30,40,4,Tamil Nadu,Lunch,Vegetarian
Classic Greek salad Recipe,"Extra Virgin Olive Oil, Lemon Juice, Salt And Pepper, Iceberg Lettuce, Tomato, English Cucumber, Red Onion, Kalmatta Olives, Feta Cheese, Parsley Leaves, Kalmatta Olives, Feta Cheese, Parsley Leaves, Salt And Pepper",14,30,0,30,4,Greek,Appetizer,Vegetarian
Maharashtrian Misal Pav Recipe,"Mixed Sprouts, Potato, Onion, Green Chilli, Ginger, Garlic, Mustard Seeds, Cumin Seeds, Curry Leaves, Maharashtrian Goda Masala, Turmeric Powder, Kashmiri Red Chilli Powder, Coriander Powder, Cumin Powder, Sunflower Oil, Tamarind Water, Salt, Pav Buns, Onion, Sev, Lemon, Coriander",22,45,45,90,4,Maharashtrian Recipes,Snack,Vegetarian
Mughlai Fish Curry Recipe,"Mackerel Fish, Turmeric Powder, Lemon Juice, Curd, Milk, Garam Masala Powder, Salt, Sunflower Oil, Poppy Seeds, Onion, Garlic, Ginger, Whole Black Peppercorns, Coriander, Cumin Seeds, Red Chilli Powder, Turmeric Powder, Badam, Vinegar",19,5,30,35,4,Mughlai,Lunch,High Protein Vegetarian
Karuveppilai Chutney Podi Recipe - Curry Leaves Chutney Podi,"Curry Leaves, Chana Dal, Black Pepper Powder, Methi Seeds, Cumin Seeds, Tamarind, Salt",7,10,20,30,2,South Indian Recipes,Side Dish,Vegetarian
Refried Beans and Mushroom Tostada Recipe,"Tortillas, Cheddar Cheese, Avocado, Iceberg Lettuce, Tomato Salsa, Lemon, Salt, Whole Black Peppercorns, Red Chilli Flakes, Button Mushrooms, Onion, Garlic, Sunflower Oil, Red Chilli Flakes, Salt, Cups Rajma, Onion, Garlic, Cumin Powder, Red Chilli Flakes, Coriander, Sunflower Oil, Salt",23,20,45,65,4,Mexican,Snack,Vegetarian
Cranberry Cookie Recipe,"All Purpose Flour, Butter, Caster Sugar, Whole Eggs, Cranberries, Vanilla Extract, Salt",7,20,35,55,4,Continental,Snack,Vegetarian
Malabar Style Dates Coriander Chutney Recipe,"Dates, Tamarind, Dry Red Chilli, Coriander, Mint Leaves, Garlic, Ginger, Salt",8,0,20,20,4,Malabar,Side Dish,Vegetarian
Masaledar Moongphali Til Wale Aloo Recipe,"Sesame Seeds, Raw Peanuts, Baby Potato, Salt, Sunflower Oil, Cumin Seeds, Green Chilli, Ginger, Garlic, Cumin Powder, Red Chilli Powder, Garam Masala Powder, Lemon Juice, Coriander, Mint Leaves, Chaat Masala Powder",16,10,10,20,2,North Indian Recipes,Side Dish,Vegetarian
Mangalorean Manoli Curry Recipe - Indian Gherkins Curry,"Tindora, Onion, Dry Red Chilli, Methi Seeds, Coriander, Cumin Seeds, Whole Black Peppercorns, Tamarind, Fresh Coconut, Garlic, Turmeric Powder, Salt, Sunflower Oil",13,15,30,45,2,Mangalorean,Side Dish,Diabetic Friendly
Basil Tea Recipe,"Water, Tulsi, Tea Leaves, Sugar Honey",4,2,10,12,2,Indian,Snack,Vegetarian
Mysore Chutney Recipe - Chana Dal Chutney,"Sunflower Oil, Chana Dal, Dry Red Chilli, Lemon Juice, Salt, Dessicated Coconut, Tamarind, Curry Leaves, Ginger",9,20,45,65,4,Karnataka,Side Dish,Vegetarian
Mangai Inji Pickle Recipe- Instant Mango Ginger Pickle,"Mango Ginger, Sesame, Mustard Seeds, Red Chilli Powder, Salt, Turmeric Powder, Lemon Juice, Asafoetida",8,15,5,20,10,South Indian Recipes,Side Dish,Vegetarian
Bengali Style Mixed Vegetable Sweet Pilaf Recipe,"Govind Bhog Rice, Mixed Vegetables, Onion, Raisins, Green Chilli, Cashew Nuts, Paneer, Bay Leaves, Cardamom, Cinnamon Stick, Cloves, Sugar, Salt, Ghee, Sunflower Oil",15,30,30,60,10,Bengali Recipes,Main Course,Vegetarian
Mulakushyam Recipe - A Mixed Vegetable Lentil Curry,"Yellow Moong Dal, Chayote, Potato, Carrot, Green Peas, Green Chilli, Turmeric Powder, Salt, Curry Leaves, Black Pepper Powder, Coconut Oil",11,18,30,48,4,Kerala Recipes,Side Dish,High Protein Vegetarian
"Sweet Potato, Celery & Peanut Soup Recipe","Sweet Potato, Extra Virgin Olive Oil, Stalks Celery, Stalks Leek, Clove Garlic, Ginger, Vegetable Stock, Cinnamon Powder, Peanut Butter, Honey, Heavy Whipping Cream, Salt And Pepper",12,15,30,45,4,Continental,Dinner,Gluten Free
Caprese Empanada Recipe With Tomato Basil And Mozzarella,"All Purpose Flour, Salt, Italian Seasoning, Butter, Whole Egg, Chilled Water, Mozzarella Cheese, Tomato, Basil Leaves, Paprika Powder, Salt",11,10,180,190,3,Italian Recipes,Snack,Vegetarian
Lapsi Recipe  - Sweetened Gujarati Broken Wheat,"Broken Wheat, Jaggery, Cardamom Powder, Raisins, Cashew Nuts, Ghee",6,10,40,50,4,Gujarati Recipesï»¿,Dessert,Vegetarian
Asian Watermelon Salad Recipe,"Watermelon, Red Baby Radish, Cucumber, Mint Leaves, Basil Leaves, Spring Onion, Roasted Peanuts, Lemon Zest, Rice Vinegar White Vinegar, Soy Sauce, Sriracha Sauce, Ginger, Lemon Juice, Black Pepper Powder, Salt",15,10,10,20,2,Asian,Side Dish,Vegetarian
Karnataka Style Obbattu Saaru Recipe - Sweet & Spicy Rasam Recipe,"Tamarind Water, Chana Dal, Jaggery, Fresh Coconut, Cardamom Powder, Methi Seeds, Coriander, Ajwain, Poppy Seeds, Dry Coconut, Dry Red Chilli, Onion, Tomato, Curry Leaves, Coriander, Mustard Seeds, Sunflower Oil, Asafoetida, Ghee",19,30,45,75,4,Karnataka,Lunch,Vegetarian
Giant Chocolate Chunk Cookie Recipe with Walnuts,"All Purpose Flour, Baking Powder, Salt, Butter, Caster Sugar, Brown Sugar, Whole Eggs, Dark Chocolate, Walnuts",9,20,45,65,8,Continental,Snack,Vegetarian
Mushrooms And Zucchini Puffs Recipe,"All Purpose Flour, Butter, Salt, Chilled Water, Lemon Juice, Button Mushrooms, Green Zucchini, Onion, Garlic, Dried Thyme Leaves, Butter, Sunflower Oil, Cheese, Salt, Sesame Seeds, Whole Egg, Milk",17,60,25,85,14,Continental,Snack,Eggetarian
Sri Lankan Chilli Potatoes Recipe,"Potato, Cinnamon Stick, Garlic, Onion, Turmeric Powder, Red Chilli Powder, Red Chilli Flakes, Mustard Seeds, Curry Leaves, Lemon Juice, Sunflower Oil, Salt",12,10,10,20,4,Sri Lankan,Lunch,Vegan
Radhaballabhi Recipe (Bengali Stuffed Poori With Spiced Urad Dal),"All Purpose Flour, Water, Black Urad Dal, Cumin Seeds, Fennel Seeds, Kashmiri Red Chilli Powder, Garam Masala Powder, Ginger, Sugar, Salt, Sunflower Oil",11,30,50,80,4,Bengali Recipes,North Indian Breakfast,Vegetarian
Spinach Ricotta Balls in Garlic Tomato Basil Sauce Recipe,"Ricotta Cheese Homemade Paneer, Cheese, Spinach Leaves, Onion, Mixed Herbs, Red Chilli Flakes, Black Pepper Powder, Cumin Powder, Salt, Corn Flour, Extra Virgin Olive Oil, Garlic, Basil Leaves, Homemade Tomato Puree, Mixed Herbs, Salt, Sugar, Black Pepper Powder, Red Chilli Powder",19,15,30,45,6,Continental,Main Course,Vegetarian
Methi & Pudina Aloo Sabzi Recipe,"Potato, Methi Leaves, Mint Leaves, Onion, Tomato, Ginger, Turmeric Powder, Garam Masala Powder, Coriander Powder, Salt, Red Chilli Powder, Cumin Seeds, Sunflower Oil",13,10,25,35,4,North Indian Recipes,Lunch,Vegetarian
Fruit Tart Recipe - Vegan,"Instant Oats, Badam, Flax Seed Powder, Coconut Oil Melted Butter, Maple Syrup Honey, Almond Milk, Hung Curd, Peanut Butter, Jam, Fresh Fruits",10,10,30,40,4,Continental,World Breakfast,Vegan
Parsi Style Baingan Capsicum Ka Salan Recipe,"Brinjal, Green Bell Pepper, Tomato, Onion, Turmeric Powder, Red Chilli Powder, Dhansak Masala, Salt, Coriander, Sunflower Oil",10,10,30,40,4,Parsi Recipes,Lunch,Vegetarian
Savoury Crepes with Za'atar Spiced Chicken Recipe,"Whole Wheat Flour, Sugar, Milk, Salt, Whole Eggs, Boneless Chicken, Red Bell Pepper, Tomato, Za'Atar, Lemon Juice, Salt, Black Pepper Powder, Paprika Powder, Coriander, All Purpose Flour, Butter, Milk, Fresh Cream, Dijon Mustard",19,10,30,40,3,Mediterranean,Dinner,High Protein Non Vegetarian
Recheado Chicken Naan Wraps Recipe,"Chicken Breasts, Goan Recheado Masala, Onion, Coriander, Onion, Sunflower Oil, Naan Tawa Parathas",7,60,30,90,6,Fusion,Snack,High Protein Vegetarian
Vegetable Tortilla Pizza Recipe,"Corn Flour Tortilla, Del Monte Mint Mayo, Mozzarella Cheese, Tomato  Deseeded And Pieces, Onion, Red Bell Pepper, Green Bell Pepper, Yellow Bell Pepper, Baby Corn, Basil Leaves, Italian Seasoning, Red Chilli Flakes, Rosemary",13,10,10,20,2,Fusion,Appetizer,Vegetarian
Bhune Pyaz Ka Gosht Recipe - Mutton Curry With Roasted Onion & Spices,"Mutton, Curd, Salt, Turmeric Powder, Sunflower Oil, Cinnamon Stick, Cloves, Cardamom, Cumin Seeds, Onion, Ginger, Garlic, Homemade Tomato Puree, Salt, Green Chilli, Red Chilli Powder, Cumin Powder, Coriander, Ghee, Cinnamon Powder, Bay Leaf, Cardamom, Cloves, Garam Masala Powder, Nutmeg Powder",25,30,30,60,4,North Indian Recipes,Main Course,Non Vegeterian
Dherosh Chingri Jhol Recipe (Bengali Style Prawn Curry With Ladies Finger),"Bhindi, Onion, Ginger, Green Chilli, Tomato, Prawns, Turmeric Powder, Red Chilli Powder, Coriander Powder, Cumin Powder, Salt, Mustard Oil, Coriander",13,15,25,40,2,Bengali Recipes,Side Dish,Non Vegeterian
Aloo Bread Pakora Recipe,"Whole Wheat Brown Bread, Coriander, Mint Leaves, Curry Leaves, Green Chilli, Ginger, Roasted Peanuts, Sugar, Lemon, Water, Salt, Potato, Onion, Green Chilli, Cumin Powder, Red Chilli Powder, Turmeric Powder, Amchur, Chaat Masala Powder, Coriander, Salt, Gram Flour, Rice Flour, Ajwain, Red Chilli Powder, Turmeric Powder, Asafoetida, Enos Fruit Salt, Salt, Water, Sunflower Oil",31,10,30,40,2,North Indian Recipes,Snack,Vegetarian
Spicy Mushroom Puffs Recipe (Empanadas stuffed with Mushroom Recipe),"Whole Wheat Flour, All Purpose Flour, Butter, Whole Egg, Butter, Button Mushrooms, Garlic, Onion, Green Chilli, Honey, Red Chilli Powder, Coriander, Stalks Spring Onion, Salt",14,20,30,50,4,Indian,Snack,Vegetarian
Instant Chilli Pickle Recipe,"Green Chilli, Turmeric Powder, Salt, Sunflower Oil, Pickle Masala",5,10,15,25,250,Indian,Appetizer,Vegetarian
Bhakri Chaat Recipe With Green Moong Sprouts And Aloo,"Whole Wheat Flour, Jowar Flour, Nutralite Classic Spread, Ajwain, Whole Black Pepper Corns, Turmeric Powder, Dry Ginger Powder, Salt, Green Moong Sprouts, Potato, Onion, Tomato, Green Chutney, Sweet Chutney, Chaat Masala Powder, Cumin Powder, Red Chilli Powder, Lemon Juice, Coriander, Achari Mayo, Boondi",21,30,30,60,4,Indian,Snack,Vegetarian
Rawalpindi Style Chole Recipe,"Kabuli Chana, Onion, Tomato, Garlic, Ginger, Green Chilli, Coriander, Anardana Powder, Cumin Seeds, Cumin Powder, Red Chilli Powder, Turmeric Powder, Amchur, Garam Masala Powder, Black Tea, Ghee, Salt",17,10,45,55,4,Punjabi,Dinner,High Protein Vegetarian
Achari Kaddu Ki Sabzi Recipe,"Kaddu, Ginger, Garlic, Methi Seeds, Mustard Seeds, Fennel Seeds, Cumin Seeds, Kalonji, Asafoetida, Green Chilli, Red Chilli Powder, Amchur, Turmeric Powder, Garam Masala Powder, Sunflower Oil, Salt, Punjabi Style Mango Pickle, Coriander",18,10,30,40,4,North Indian Recipes,Lunch,Vegetarian
Veg Makhanwala Recipe - North Indian Mixed Vegetables Gravy,"Butter, Salt, Carrot, Green Bell Pepper, Green Beans, Baby Corn, Cauliflower, Butter, Cloves, Cardamom, Cinnamon Powder, Kashmiri Dry Red Chilli, Coriander Seeds, Whole Black Pepper Corns, Cashew Nuts, Garlic, Ginger, Green Chilli, Onion, Salt, Kashmiri Red Chilli Powder, Turmeric Powder, Cumin Powder, Garam Masala Powder, Homemade Tomato Puree, Fresh Cream, Butter Serve",27,15,30,45,4,North Indian Recipes,Lunch,Vegetarian
How to make Egg Free Mayonnaise Recipe,"Fresh Cream, Mustard Sauce, Clove Garlic, Black Pepper Powder, Lemon Juice, Extra Virgin Olive Oil, Salt",7,20,20,40,10,Continental,Side Dish,Vegetarian
Sindhi Style Besan Tikki Ki Sabzi Recipe,"Gram Flour, Poppy Seeds, Green Chilli, Anardana Powder, Coriander, Turmeric Powder, Red Chilli Powder, Cumin Seeds, Sunflower Oil, Salt, Sunflower Oil, Onion, Tomato, Turmeric Powder, Coriander Powder, Garam Masala Powder, Red Chilli Powder, Kasuri Methi, Salt, Sunflower Oil, Coriander",21,30,45,75,3,Sindhi,Main Course,Vegetarian
"Turmeric, Ginger And Chilli Pickle Recipe","Fresh Turmeric Root, Ginger, Green Chilli, Mustard Powder, Lemon Juice, Sunflower Oil, Salt",7,20,20,40,200,South Indian Recipes,Side Dish,Vegetarian
Spicy Matar Masala Recipe,"Green Peas, Cumin Seeds, Mustard Seeds, Curry Leaves, Green Chilli, Bay Leaf, Cloves, Cardamom, Ginger Garlic Paste, Onion, Onion, Homemade Tomato Puree, Red Chilli Powder, Turmeric Powder, Coriander Powder, Salt",16,30,30,60,4,Indian,Dinner,Vegetarian
Andhra Style Davva Aava koora Recipe (Sweet and Spicy Banana Stem Peanut Curry Recipe),"Banana Stem, Raw Peanuts, Pearl Onion, Garlic, Tomato, Turmeric Powder, Red Chilli Powder, Sambar Powder, Sugar, Bay Leaf, Curry Leaves, Mustard Seeds, Methi Seeds, Sunflower Oil, Salt, White Urad Dal, Chana Dal, Dry Red Chilli, Coriander",19,15,30,45,4,Andhra,Main Course,Vegetarian
"Broccoli, Carrot And Capsicum Sabzi Recipe","Broccoli, Carrots, Green Bell Pepper, Mustard Seeds, Curry Leaves, Asafoetida, Black Pepper Powder, Onion, Tomato, Ginger, Garlic, Green Chilli, Salt, Sunflower Oil",14,10,25,35,4,South Indian Recipes,Side Dish,Vegetarian
"Mushroom, Spinach & Herbs Frittata with Egg White Recipe","Egg White, Button Mushrooms, Spinach, Onion, Dried Oregano, Basil Leaves, Red Chilli Flakes, Salt And Pepper",8,10,10,20,2,Continental,World Breakfast,High Protein Non Vegetarian
Spinach Hummus Recipe,"Spinach, Kabuli Chana, Tahini, Coriander, Garlic, Cumin Seeds, Extra Virgin Olive Oil, Lemon Juice, Salt",9,30,0,30,4,Middle Eastern,Appetizer,Vegetarian
Pinto Bean Salsa Salad Recipe,"Pinto Beans, Onion, Tomato, Avocado, Adobo Sauce, Chipotle Peppers, Lemon Juice, Coriander",8,10,10,20,4,Mexican,Appetizer,Vegetarian
Chicken Momos Recipe -Delicious Steamed Chicken Dumplings,"All Purpose Flour, Salt, Baking Powder, Chicken, Green Peas, Onion, Garlic, Ginger, Soy Sauce, Salt, Fresh Red Chilli Green Chilli, Whole Black Peppercorns",12,30,30,60,4,North East India Recipes,Snack,High Protein Non Vegetarian
Broccoli Egg Bhurji Recipe,"Whole Egg, Broccoli, Onion, Tomato, Garlic, Turmeric Powder, Red Chilli Powder, Coriander, Salt, Sunflower Oil",10,10,20,30,4,Indian,World Breakfast,Eggetarian
Avocado And Almond Salad Recipe With Feta Cheese,"Avocado, Badam, Salad Leaves Lettuce, Black Olives, Cherry Tomato, Feta Cheese, Extra Virgin Olive Oil, Lemon Juice, Honey, Salt, Black Pepper Powder",11,10,5,15,2,Continental,Snack,High Protein Vegetarian
Masala Akki Roti With Spinach Recipe - sarvapindi,"Rice Flour, Water, Spring Onion Greens, Spinach Leaves, Coriander, Curry Leaves, Green Chilli, Sesame Seeds, Salt, Sunflower Oil",10,30,70,100,4,Andhra,South Indian Breakfast,Gluten Free
Spinach Khandvi Recipe - Savory Gram Flour Pinwheels With Spinach,"Gram Flour, Curd, Spinach Leaves, Water, Turmeric Powder, Asafoetida, Sugar, Salt, Mustard Seeds, Cumin Seeds, Sesame Seeds, Curry Leaves, Fresh Coconut, Coriander, Sunflower Oil",15,10,40,50,4,Gujarati Recipesï»¿,Lunch,Vegetarian
Spiced Onion Pulao Recipe - Pyaz Pulao Recipe,"Rice, Ghee, Bay Leaves, Cloves, Cinnamon Stick, Green Chilli, Onion, Ginger, Garlic, Tomato, Salt, Mint Leaves",12,15,25,40,4,Indian,Main Course,Vegetarian
Kashmiri Methi T Golemach Recipe-Minced Chicken Balls With Fenugreek Leaves,"Chicken, Onion, Mint Leaves, Methi Leaves, Green Chilli, Garam Masala Powder, Garlic, Salt, Black Pepper Powder, Sunflower Oil, Water, Bay Leaf, Cinnamon Stick, Methi Leaves, Sunflower Oil, Dry Red Chilli, Garlic, Salt",18,20,35,55,4,Kashmiri,Lunch,High Protein Non Vegetarian
Carrot Cake Pancakes Recipe,"Whole Wheat Flour Multigrain Flour, Curd, Milk As Required, Pumpkin Pie Spice, Baking Powder, Baking Soda, Carrots, Butter, Pineapple, Whole Egg, Brown Sugar, Salt, Butter",13,10,30,40,4,Continental,World Breakfast,Vegetarian
Oats Cheela Recipe Stuffed With Creamy Palak Paneer,"Whole Wheat Flour, Instant Oats, Spinach, Paneer, Cumin Powder, Red Chilli Powder, Salt, Eggless Mayonnaise, Nutralite Classic Spread",9,20,40,60,4,Indian,Indian Breakfast,Vegetarian
Eggless Lemon Pound Cake Recipe,"Butter, Caster Sugar, All Purpose Flour, Salt, Baking Powder, Milk, Lemon Juice, Vanilla Extract, Lemon Zest, Flax Seed Powder, Water",11,5,45,50,8,Continental,Dessert,Vegetarian
Vegan Mango Lassi Recipe,"Mango, Almond Milk, Maple Syrup, Salt, Vanilla Extract, Saffron Strands, Pistachios, Rose Water",8,15,0,15,8,Indian,Appetizer,Vegan
Puli Inji Recipe - Tamarind and Ginger Chutney,"Tamarind Water, Ginger, Green Chilli, Turmeric Powder, Methi Seeds, Red Chilli Powder, Asafoetida, Jaggery, Sesame, Mustard Seeds, Curry Leaves, Salt",12,10,20,30,4,South Indian Recipes,Side Dish,Vegetarian
Tandoori Mayonnaise Chicken Cigar Recipe,"Boneless Chicken, Del Monte Tandoori Mayo, Salt, Black Pepper Powder, Tortillas, Corn Flour, Sunflower Oil",7,30,60,90,4,Continental,Appetizer,Non Vegeterian
Russian Radish Cucumber Salad Recipe,"Red Radish, Mooli Mullangi, Cucumber, Garlic, Cup Curd, Whole Egg, Dill Leaves, Chives, Almond Oil, Sea Salt",10,15,1,16,3,Continental,Side Dish,Eggetarian
Egg Pakora Recipe - Egg Fritters,"Whole Eggs, Gram Flour, Rice Flour, Turmeric Powder, Red Chilli Powder, Salt, Water, Sunflower Oil",8,20,25,45,8,Indian,Snack,Eggetarian
Soya Keema Aloo Paratha Recipe,"Whole Wheat Flour, Bajra Flour, Jowar Flour, Salt, Sunflower Oil, Soy Chunks, Potato, Onion, Green Chilli, Red Chilli Powder, Garam Masala Powder, Amchur, Mint Leaves, Salt, Ghee",15,15,40,55,4,North Indian Recipes,Indian Breakfast,High Protein Vegetarian
Curd Rice With Carrots Recipe,"Rice, Hung Curd, Milk, Salt, Sunflower Oil, Carrot, Coriander, Curry Leaves, Asafoetida, Ginger, Dry Red Chilli, Green Chilli, Cumin Seeds, Mustard Seeds, Black Urad Dal, Chana Dal, Cashew Nuts, Raw Peanuts",18,15,35,50,4,Indian,Lunch,Vegetarian
No-Bake Strawberry Cream Cheese Dessert Recipe,"Marie Biscuit, Sugar, Butter, Britannia Cream Cheese, Condensed Milk, Lemon Juice, Vanilla Custard, Strawberries, Lemon, Sugar, Water, Corn Flour",12,20,90,110,4,Continental,Dessert,Vegetarian
Eggless Mango Muffins Recipe,"All Purpose Flour, Mango Pulp, Caster Sugar, Sunflower Oil, Flaxmeal Egg Replacer, Vanilla Extract, Salt, Baking Powder",8,15,25,40,6,Continental,Dessert,Vegetarian
Hyderabadi Khatti Dal Recipe (Hyderabadi Tangy Lentil Curry),"Arhar Dal, Tomato, Turmeric Powder, Red Chilli Powder, Garlic, Ginger, Green Chilli, Tamarind Water, Sunflower Oil, Mustard Seeds, Cumin Seeds, Dry Red Chilli, Curry Leaves, Garlic, Coriander",15,20,40,60,4,Hyderabadi,Lunch,High Protein Vegetarian
North Arcot Special Thavalai Dosai Recipe,"Rice, White Urad Dal, Curd, Dry Red Chilli, Asafoetida, Salt, Sesame",7,60,30,90,6,South Indian Recipes,South Indian Breakfast,Vegetarian
Oats Sakkarai Pongal Recipe,"Ghee, Instant Oats, Jaggery, Cardamom Powder, Yellow Moong Dal, Ghee, Cashew Nuts",7,15,30,45,3,South Indian Recipes,Dessert,Vegetarian
Chatpata Lobia Chaat Recipe - Healthy Black Eyed Bean Snack,"Black Eyed Beans, Tomato, Onion, Cucumber, Green Chilli, Coriander, Chaat Masala Powder, Amchur, Lemon Juice, Salt",10,0,20,20,4,North Indian Recipes,Snack,High Protein Vegetarian
Indori Poha Recipe,"Poha, Sunflower Oil, Mustard Seeds, Cumin Seeds, Fennel Seeds, Raw Peanuts, Onion, Ginger, Green Chilli, Curry Leaves, Turmeric Powder, Red Chilli Powder, Salt, Sugar, Coriander, Onion, Fresh Pomegranate Fruit Kernels",17,10,30,40,3,North Indian Recipes,North Indian Breakfast,Vegetarian
Chocolate Chip Cookies With Coconut Recipe,"All Purpose Flour, Butter, Brown Sugar, Sugar, Vanilla Extract, Whole Eggs, Salt, Baking Soda, Baking Powder, Chocolate Chips, Dessicated Coconut",11,20,25,45,6,Continental,Snack,Vegetarian
Singhara Atta Cheela Recipe (No Onion No Garlic Navratri Fasting/Vrat Recipe),"Singoda Flour, Green Chilli, Coriander, Cumin Powder, Turmeric Powder, Black Pepper Powder, Rock Salt Salt, Ghee Oil For Cooking",8,25,20,45,4,North Indian Recipes,Lunch,Vegetarian
Spiced Ghee Rice Recipe | Neychoru,"Basmati Rice, Onion, Green Chilli, Ginger Garlic Paste, Ghee, Fennel Seeds, Bay Leaf, Star Anise, Cloves, Cardamom, Salt, Cashew Nuts, Raisins, Apricots, Water",15,30,20,50,2,South Indian Recipes,Lunch,Gluten Free
Maharashtrian Tandulachi Ukad Recipe - Rice Flour And Buttermilk Porridge,"Buttermilk, Rice Flour, Salt, Mustard Seeds, Green Chilli, Ginger, Curry Leaves, Asafoetida",8,0,10,10,4,Maharashtrian Recipes,North Indian Breakfast,Vegetarian
Parmesan Corn Chili Fries Recipe,"Polenta, Parmesan Cheese, Butter, Vegetable Stock Water, Sage, Basil Leaves, Red Chilli Flakes, Salt, Black Pepper Powder, Extra Virgin Olive Oil",10,140,30,170,4,Continental,Snack,Vegetarian
Dal Fara Recipe (Indian Stuffed Lentil Dumplings),"White Urad Dal, Chana Dal, Arhar Dal, Whole Wheat Flour Rice Flour As Required, Cumin Seeds, Garam Masala Powder, Turmeric Powder, Red Chilli Powder, Asafoetida, Garlic, Green Chilli, Salt, Sunflower Oil, Cumin Seeds, Curry Leaves, Asafoetida, Coriander",17,10,60,70,6,South Indian Recipes,Snack,High Protein Vegetarian
Chinese Fried Rice Recipe With Chicken And Shredded Lettuce,"Cooked Rice, Iceberg Lettuce  Shredded, Boneless Chicken, Soy Sauce, Black Pepper Powder, Sunflower Oil, Salt",7,10,10,20,2,Chinese,Dinner,Non Vegeterian
Aval Payasam Recipe - Sweet Flattened Rice Payasam,"Milk, Poha, Sugar, Ghee, Cardamom Powder, Cinnamon Powder, Cashew Nuts",7,0,30,30,4,Tamil Nadu,Dessert,Vegetarian
Spicy Tomato Rice - Tomato Pulihora Recipe,"Cooked Rice, Tomato, Bisi Bele Bhat Spice Powder, Salt, Chana Dal, White Urad Dal, Cumin Seeds, Mustard Seeds, Green Chilli, Dry Red Chilli, Cashew Nuts Peanuts, Sunflower Oil As Needed, Asafoetida",13,5,10,15,3,South Indian Recipes,Main Course,Vegetarian
Punjabi Style Egg Curry Recipe,"Sunflower Oil, Cloves, Bay Leaf, Black Cardamom, Cardamom, Ginger Garlic Paste, Onion, Green Chilli, Onion, Tomato, Turmeric Powder, Red Chilli Powder, Coriander Powder, Garam Masala Powder, Water, Whole Eggs, Coriander",17,10,30,40,2,Punjabi,Lunch,Eggetarian
Bhopali Style Gosht Ka Pulao Recipe,"Basmati Rice, Mutton, Onion, Garlic, Ginger, Green Chilli, Curd, Bay Leaves, Black Cardamom, Cardamom, Mace Powder, Whole Black Peppercorns, Black Pepper Powder, Cinnamon Stick, Mint Leaves, Coriander Powder, Red Chilli Powder, Coriander, Sunflower Oil, Ghee",20,30,65,95,4,North Indian Recipes,Lunch,Non Vegeterian
Bengali Holud Mishti Pulao Recipe - Saffron Flavored Rice With Nuts,"Basmati Rice, Green Peas, Ginger, Sugar, Nutmeg Powder, Cumin Powder, Turmeric Powder, Bay Leaves, Cinnamon Stick, Cardamom, Cloves, Mace Powder, Saffron Strands, Ghee, Cashew Nuts, Raisins, Pistachios",17,20,30,50,3,Bengali Recipes,Lunch,Vegetarian
Chotti Aloor Dum Recipe - Baby Potatoes In Tomato Gravy,"Baby Potato, Tomato, Cumin Powder, Red Chilli Powder, Coriander Powder, Turmeric Powder, Sunflower Oil, Salt, Cloves, Cardamom, Cinnamon Stick, Water",12,30,20,50,4,North Indian Recipes,Lunch,Vegetarian
Mango Rice Noodle Salad With Cucumber & Carrot Recipe,"Rice Vermicelli Noodles, Cucumber, Carrot, Red Bell Pepper, Yellow Bell Pepper, Mango, Spring Onion, Mint Leaves, Cashew Nuts, Ginger, Soy Sauce, Sesame, Lemon Juice, Honey",14,15,10,25,2,Vietnamese,Side Dish,Vegetarian
Mooli Bhurji Recipe,"Mooli Mullangi, Mooli Ke Patte, Green Chilli, Mustard Oil, Mustard Seeds, Ajwain, Asafoetida, Turmeric Powder, Amchur, Salt",10,20,15,35,4,North Indian Recipes,Dinner,Vegetarian
Gilka Bhajji Recipe-Silk Squash Fritters,"Gilka, Gram Flour, Rice Flour, Ajwain, Red Chilli Powder Green Chilli Paste, Garlic, Turmeric Powder, Coriander, Lemon Juice, Salt, Sunflower Oil Deep Fry",11,10,20,30,4,Maharashtrian Recipes,Snack,Vegetarian
French Toast Recipe Flavored with Orange,"Whole Wheat Brown Bread, Whole Eggs, Caster Sugar, Orange Zest, Fresh Orange Juice, Orange, Hung Curd, Sunflower Oil, Honey, Butter",10,15,20,35,4,French,World Breakfast,Eggetarian
Bisi Bele Bath Recipe - A Spicy Mixed Vegetable Sambar Rice,"Chana Dal, White Urad Dal, Cinnamon Stick, Cloves, Cardamom, Dry Red Chilli, Methi Seeds, Poppy Seeds, Coriander, Fresh Coconut, Turmeric Powder, Asafoetida, Pearl Onion, Green Bell Pepper, Carrots, Green Peas, Green Beans, Potato, Drumstick, Tomato, Tamarind Water, Jaggery, Salt, Rice, Arhar Dal, Turmeric Powder, Salt, Ghee, Mustard Seeds, Cumin Seeds, Dry Red Chilli, Curry Leaves, Coriander, Boondi",34,30,45,75,4,South Indian Recipes,Dinner,Vegetarian
Godhi Chutney Podi Recipe (Wheat Germ South Indian Spice Powder),"Wheat Germ, Dry Red Chilli, Curry Leaves, Jaggery, Methi Seeds, Dessicated Coconut, Salt, Sunflower Oil, Asafoetida, Tamarind",10,10,30,40,100,South Indian Recipes,Side Dish,Vegetarian
Suji Manda Pitha/Sweetened Coconut Stuffed Semolina Dumplings Recipe,"Sooji, Water, Ghee, Sugar, Salt, Cardamom, Sunflower Oil Ghee For Deep Frying, Fresh Coconut, Jaggery, Cardamom Powder, Black Pepper Powder, Ghee, Cashew Nuts, Raisins",14,10,45,55,4,Oriya Recipes,Dessert,Vegetarian
Spinach Enchilada Recipe,"Corn Flour Tortilla Whole Wheat Tortilla, Sour Cream, Cheddar Cheese Mexican Cheese, Spinach, Onion, Soy Granules, Khoya, Pickled Jalapenos, Garlic, Extra Virgin Olive Oil, Cumin Seeds, Whole Black Peppercorns, Salt, Onion, Tomato, Clove Garlic, Pickled Jalapenos, Coriander, Lemon Juice, Salt, All Purpose Flour, Garlic  Minced, Homemade Tomato Puree, Red Chilli Powder, Chipotle Chilli  Peppers, Extra Virgin Olive Oil, Cumin Powder, Sugar, Vegetable Stock, Salt",30,30,25,55,4,Mexican,Dinner,Vegetarian
Healthy General Tso's Chicken Recipe,"Chicken Thighs, Egg Whites, Baking Soda, Soy Sauce, Rolled Oats Or Instant Oats, Sunflower Oil, Sesame Seeds, Spring Onion Greens, Garlic, Ginger, Fresh Red Chilli, Rolled Oats Or Instant Oats, Rice Vinegar, Palm Sugar, Soy Sauce",15,10,45,55,4,Chinese,Appetizer,Non Vegeterian
Crostini With Peppers & Cheese Recipe,"French Loaf, Butter, Garlic  Paste, Extra Virgin Olive Oil, Green Bell Pepper, Tomato Ketchup, Pizza Seasoning, Parsley Leaves, Salt, Mozzarella Cheese, Dried Oregano, Black Pepper Powder, Cherry Tomato",13,10,25,35,4,Italian Recipes,Dinner,Vegetarian
Karnataka Style Hurali Kalu Saaru Recipe,"Horse Gram Dal, Potato, Salt, Sunflower Oil, Turmeric Powder, Onion, Cloves, Cinnamon Stick, Garlic, Ginger, Tomato, Fresh Coconut, Coriander",13,130,45,175,4,Karnataka,Lunch,Diabetic Friendly
Mushroom and Prawn Malai Curry Recipe,"Prawns, Button Mushrooms, Tomato, Onion, Ginger, Garlic, Green Chilli, Curd, Coconut Milk, Cardamom, Cloves, Cinnamon Stick, Bay Leaf, Turmeric Powder, Cumin Seeds, Salt, Red Chilli Powder, Sugar, Mustard Oil, Mustard Oil, Ghee",21,10,40,50,3,Bengali Recipes,Lunch,Non Vegeterian
Beerakaya Tomato Koora Recipe (Andhra Style Ridge Gourd Curry),"Ridge Gourd, Onion, Tomato, Garlic, Jaggery, Red Chilli Powder, Coriander Powder, Turmeric Powder, Methi Seeds, Fennel Seeds, Curry Leaves, Mustard Seeds, Asafoetida, Coriander, Dry Red Chilli, Sunflower Oil, Salt",17,10,15,25,4,Andhra,Dinner,Vegetarian
Sholeh Zard Recipe -  Persian Saffron Rice Pudding,"Basmati Rice, Water, Salt, Icing Sugar, Ghee, Saffron Strands, Water, Almond Meal, Cardamom Powder, Rose Water, Badam, Pistachios, Cinnamon Powder",13,10,20,30,4,Middle Eastern,Dessert,Gluten Free
Tamarind Chilli Potato Recipe,"Potato, Onion, Tamarind Paste, Sugar, Garlic, Cashew Nuts, Curry Leaves, Salt, Coriander, Sunflower Oil, Ajwain, Fresh Red Chilli",12,20,30,50,4,Indian,Side Dish,Vegetarian
Cheese and Bacon Pinwheels Recipe,"Lukewarm Water, Active Dry Yeast Instant Yeast, All Purpose Flour, Salt, Sugar, Extra Virgin Olive Oil, Britannia Cream Cheese, Cheddar Cheese, Bacon Strips, Spring Onion Greens, Dried Oregano, Red Chilli Flakes",12,30,100,130,4,Continental,Appetizer,Non Vegeterian
Vegetable Pasta Soup Recipe,"Carrots, Capsicum, Onion, Garlic, Tomato, Pasta, Of Chickpea Chickpeachickpeas, Tomato Ketchup, Basil Powder, Cinnamon, Paprika Powder Red Chilli Flakes, Whole Pepper, Salt, Water, Olive Oil",15,10,30,40,4,Italian Recipes,Dinner,Vegetarian
Roasted Tomato Basil Pasta & Pizza Sauce Recipe,"Tomato, Garlic, Onion, Extra Virgin Olive Oil, Salt, Sugar, Red Chilli Flakes",7,10,30,40,2,Italian Recipes,Vegetarian,Vegetarian
Paal Payasam Recipe - Rice Kheer/Pudding,"Ghee, Rice, Milk, Sugar",4,10,40,50,4,Indian,Dessert,Vegetarian
Spicy Indian Style Onion Rings Recipe,"Onion, Ginger, Garlic, Curry Leaves, Dry Red Chilli, Green Chilli, All Purpose Flour, Gram Flour, Corn Flour, Baking Soda, Salt, Sunflower Oil",12,15,30,45,4,Indian,Snack,Vegetarian
Penne Arrabbiata Pasta Recipe,"Penne Pasta, Onion, Garlic, Homemade Tomato Puree, Red Chilli Flakes, Mixed Herbs, Whole Black Pepper Corns, Salt, Sugar, Extra Virgin Olive Oil, Basil Leaves",11,10,40,50,4,Italian Recipes,Dinner,Vegetarian
Amritsari Gobi Matar Recipe (Punjabi Style Creamy Cauliflower and Peas Curry),"Cauliflower, Green Peas, Turmeric Powder, Coriander Powder, Red Chilli Powder, Garam Masala Powder, Onion, Tomato, Green Chilli, Garlic, Ginger, Badam, Cashew Nuts, Sunflower Oil, Cumin Seeds, Coriander",16,26,45,71,2,North Indian Recipes,Dinner,Vegetarian
Green Peas Sandwich Recipe,"Green Peas, Whole Wheat Brown Bread, Green Chilli, Coriander Powder, Garam Masala Powder, Amchur, Cumin Seeds, Sunflower Oil, Salt, Hung Curd, Coriander, Black Pepper Powder, Salt",13,5,10,15,2,Continental,World Breakfast,Vegetarian
Congress Buns Recipe,"Burger Buns Masala Buns, Green Chutney, Onion, Carrot, Coriander, Raw Peanuts, Red Chilli Powder, Turmeric Powder, Curry Leaves, Black Pepper Powder, Asafoetida, Salt And Pepper, Sunflower Oil",13,10,30,40,4,South Karnataka,Appetizer,Vegetarian
Lemon 7 Up Cake Recipe,"Lb Butter, Sugar, Whole Egg, All Purpose Flour, Lemon Zest, Seven Up, Lemon Glaze, Sugar, Lemon Juice",9,105,90,195,20,Indian,Dessert,Vegetarian
Methi Moong Dal Recipe - Healthy Diabetic Friendly Recipe,"Methi Leaves, Yellow Moong Dal, Ghee, Garlic, Cumin Seeds, Turmeric Powder, Red Chilli Powder, Salt, Lemon Juice, Sugar",10,30,20,50,2,North Indian Recipes,Lunch,Vegetarian
Sprouted Moong And Onion Pakora,"Flour, Rice Flour, Sprouted Moong, Onion, Green Coriander, Green Chilli, Teaspoon Ginger, Coriander Powder, Lemon Juice, Garam Masala, Salt, Red Chili Powder, Oil Fry",13,15,15,30,2,Indian,Snack,Vegetarian
Beetroot Juice Recipe With Cucumber & Pineapple,"Beetroots, Cucumber, Pineapple, Ginger, Lemon Juice, Water",6,5,10,15,1,Continental,World Breakfast,Vegetarian
Andhra Vankaya Fry Recipe With Peanuts - Brinjal Peanut Sabzi,"Small Green Brinjal, Raw Peanuts, Green Chilli, Asafoetida, Mustard Seeds, Cumin Seeds, Curry Leaves, Ginger, Garlic, Sambar Powder",10,10,30,40,4,Andhra,Lunch,Vegetarian
One Pot Masala Vegetable Rice Recipe,"Coconut Oil, Cumin Seeds, Ginger, Garlic, Onion, Tomato, Turmeric Powder, Red Chilli Powder, Garam Masala Powder, Rice, Carrots, Green Beans, Cabbage, Salt, Water, Coriander",16,20,40,60,4,Indian,Lunch,Vegetarian
Beans Vepudu Recipe (Andhra Style Beans Cooked With Spicy Sesame Spicy Mix),"Green Beans, Mustard Seeds, Curry Leaves, Turmeric Powder, Sunflower Oil, Salt, Sesame Seeds, Fresh Coconut, Garlic, Cumin Seeds, Red Chilli Powder",11,10,15,25,4,Andhra,Side Dish,Vegetarian
Paruppu Keerai Masiyal Recipe - Red Amaranth With Toor Dal,"Arhar Dal, Red Amaranth Leaves, Onion, Garlic, Mustard Seeds, White Urad Dal, Turmeric Powder, Dry Red Chilli, Fresh Coconut, Salt, Curry Leaves, Sunflower Oil",12,10,20,30,4,Tamil Nadu,Side Dish,Vegetarian
Rose Greek Yogurt Dessert Recipe With Pista & Coconut,"Hung Curd, Fresh Cream, Rose Water, Sugar, Butter, All Purpose Flour, Confectioners Sugar, Pistachios, Sugar, Dessicated Coconut",10,30,25,55,4,Fusion,Dessert,Vegetarian
Chicken Tariwala Recipe - Punjabi Murgh Tariwala Recipe,"Chicken, Curd, Turmeric Powder, Red Chilli Powder, Lemon Juice, Sunflower Oil, Onion, Ginger, Garlic, Green Chilli, Bay Leaf, Cloves, Cinnamon Stick, Black Cardamom, Star Anise, Homemade Tomato Puree, Garam Masala Powder, Cumin Powder, Red Chilli Paste, Coriander Powder, Salt",21,30,30,60,3,Punjabi,Main Course,High Protein Non Vegetarian
Hyderabadi Laziz Lamb Handi Recipe,"Lamb Ribs, Ghee, Curd, Kashmiri Red Chilli Powder, Ginger, Garlic, Salt, Sunflower Oil, Onion, Garam Masala Powder, Tomato, Tomato, Fresh Cream, Red Chilli Powder, Turmeric Powder, Cumin Powder, Coriander Powder, Garam Masala Powder, Lemon Juice, Water, Coriander",21,30,45,75,3,Punjabi,Dinner,Non Vegeterian
Raw Mango Puliyogare Gojju Recipe With Peanuts,"Mango, Mustard Seeds, White Urad Dal, Chana Dal, Curry Leaves, Raw Peanuts, Jaggery, Asafoetida, Sunflower Oil, Black Sesame Seeds, Dry Red Chilli, Coriander, Mustard Seeds, Methi Seeds, Cumin Seeds, Whole Black Peppercorns",16,15,20,35,5,South Indian Recipes,Lunch,Vegetarian
Broccoli Chocolate Muffins Recipe,"Broccoli, Cocoa Powder, Vivatta Maida, Baking Powder, Caster Sugar, Whole Eggs, Milk, Sunflower Oil, Badam",9,10,17,27,6,Continental,Dessert,Eggetarian
Stuffed Bharwa Tinda Recipe (Stuffed Apple Gourd),"Tinda, Onion, Tomato, Garlic, Ginger, Turmeric Powder, Red Chilli Powder, Coriander Powder, Garam Masala Powder, Cumin Powder, Amchur, Asafoetida, Salt, Sunflower Oil, Coriander",15,10,35,45,4,Punjabi,Lunch,Vegetarian
Tadkewali Masoor Dal Khichdi Recipe With Garlic & Onions,"Rice, Masoor Dal, Tomato, Ginger, Bay Leaf, Turmeric Powder, Green Chilli, Salt, Ghee, Cumin Seeds, Dry Red Chilli, Garlic, Onion, Salt, Coriander",15,10,35,45,4,North Indian Recipes,Main Course,Vegetarian
Maharashtrian Kulith Shengole Recipe - Spicy Horse Gram Flour Dumplings,"Horse Gram Flour, Garlic  Finely, Green Chilli  Finely, Sunflower Oil, Mustard Seeds, Cumin Seeds, Salt, Lukewarm Water",8,15,15,30,4,Maharashtrian Recipes,Lunch,Vegetarian
Kesar Malai Doodh Recipe,"Milk, Cardamom Powder, Saffron Strands, Cashew Nuts, Sugar, Saffron Strands, Dried Rose Petals, Dry Fruits",8,10,120,130,1,North Indian Recipes,Snack,Vegetarian
Paruppu Urundai Mor Kuzhambu Recipe(Lentil Balls in Yogurt Curry),"Arhar Dal, Dry Red Chilli, Asafoetida, Garlic, Curry Leaves, Coriander, Turmeric Powder, Salt, Sunflower Oil, Buttermilk, Fresh Coconut, Green Chilli, Cumin Seeds, Rice Flour, Turmeric Powder, Salt, Mustard Seeds, Curry Leaves, Dry Red Chilli",19,10,30,40,4,Tamil Nadu,Lunch,High Protein Vegetarian
Chocolate And Semolina Halwa Recipe,"Sooji, Cocoa Powder, Sugar, Ghee, Cardamom Powder, Hot Water, Mixed Nuts",7,5,25,30,4,South Indian Recipes,Dessert,Vegetarian
Eggless Whole Wheat Banana Bread Recipe-Vegan Options,"Baking Powder, Salt, Canola Oil, Butter, Brown Sugar, Whole Wheat Flour, All Purpose Flour, Ripe Bananas  Mashed, Flax Seed Powder, Chilled Water",10,15,60,75,6,Continental,Dessert,Vegetarian
Pan Grilled Balsamic Chicken Breast And Mushrooms Recipe,"Chicken Breasts, Dried Oregano, Garlic Powder, Garlic, Paprika Powder, Balsamic Vinegar, Fresh Cream, Butter, Extra Virgin Olive Oil, White Pepper Powder, Salt, Parsley Leaves, Button Mushrooms",13,15,15,30,6,Continental,Main Course,High Protein Non Vegetarian
Himachal Pahari Style Teliah Mah Recipe (Brown Horse Gram Curry),"Horse Gram Dal, Bay Leaf, Cardamom, Black Cardamom, Cinnamon Stick, Cumin Seeds, Asafoetida, Ginger, Black Pepper Powder, Coriander Powder, Red Chilli Powder, Turmeric Powder, Curd, Fresh Cream, Ghee, Salt",16,120,25,145,4,Himachal,Lunch,Vegetarian
Arbi Ajwain Ki Sabzi Recipe (Roasted Colocasia Stir Fry With Ajwain),"Colocasia Root, Ajwain, Onion, Garlic, Turmeric Powder, Red Chilli Powder, Curry Leaves, Coriander",8,10,30,40,4,Rajasthani,Lunch,Vegetarian
Barnyard Millet Mushroom Biriyani Recipe,"Barnyard Millet, Button Mushrooms, Curry Leaves, Onion, Tomato, Garlic, Ginger, Red Chilli Powder, Turmeric Powder, Coriander Powder, Garam Masala Powder, Salt, Bay Leaves, Cinnamon Stick, Cloves, Cardamom, Star Anise, Stone Flower, Green Chilli, Coriander, Mint Leaves",21,10,30,40,4,Indian,Lunch,Vegetarian
High-Protein Peanut Chutney Recipe-Indian Style Peanut Chutney Without Coconut,"Ghee, Roasted Peanuts, White Urad Dal, Chana Dal, Curry Leaves, Green Chilli, Ginger, Salt, Ghee, Mustard Seeds, White Urad Dal, Curry Leaves, Dry Red Chilli",13,15,15,30,5,Indian,Side Dish,High Protein Vegetarian
Delicious Methi Chicken Curry - Murgh Methi Curry Recipe,"Boneless Chicken, Methi Leaves, Onion, Tomato, Curd, Garlic, Ginger, Green Chilli, Coriander, Turmeric Powder, Red Chilli Powder, Garam Masala Powder, Coriander Powder, Kasuri Methi, Sunflower Oil Fry The Onion, Sunflower Oil, Cloves, Cinnamon Stick, Cardamom, Whole Black Peppercorns, Bay Leaves, Coriander",22,50,50,100,4,North Indian Recipes,Dinner,Non Vegeterian
Mexican Fiesta Soup With Roasted Tomatillo Pesto Recipe,"Tomato, Garlic, Rajma, Sweet Corn, Leek, Yellow Bell Pepper, Red Bell Pepper, Green Bell Pepper, Onion, Cumin Powder, Paprika Powder, Lemon Juice, Tortillas, Coriander, Coriander, Extra Virgin Olive Oil, Salt",17,10,15,25,4,Mexican,Dinner,Vegetarian
North Indian Sooji Halwa Recipe,"Sooji, Ghee, Sugar, Milk, Water, Cardamom Powder, Saffron Strands, Ghee, Cashew Nuts, Raisins",10,10,30,40,4,North Indian Recipes,Dessert,Vegetarian
Mustard Green Chilli Pickle Recipe,"Green Chilli, Mustard Seeds, Asafoetida, Sunflower Oil, Salt, Jaggery, Lemon Juice, Turmeric Powder",8,10,0,10,4,Indian,Side Dish,Vegetarian
Mint & Coriander Chilli Potato Salad Recipe - No Mayo Salad,"Potato, Butter, Coriander, Mint Leaves, Green Chilli, Garlic, Lemon Juice, Extra Virgin Olive Oil, Salt And Pepper",9,15,15,30,4,Continental,Appetizer,Vegetarian
Orange Peel Kuzhambu Recipe - Orange Peel Tamarind Based Curry,"Orange Peel, Ginger, Green Chilli, Tamarind Paste, Sambar Powder, Jaggery, Turmeric Powder, Asafoetida, Water, Salt, Sesame, Mustard Seeds, Curry Leaves",13,10,20,30,4,South Indian Recipes,Main Course,Vegetarian
Spicy Mixed Vegetables Rice Cutlet Recipe,"Rice, Potato, Onion, Green Chili, Carrot, Coriander, Turmeric Powder, Red Chilli Powder, Cumin Powder, Coriander Powder, Garam Masala Powder, Bread Crumbs, Salt, Flour, Water, Oil",16,20,15,35,4,Indian,Snack,Vegetarian
Aloo Took Recipe - Sindhi Style Double Baked Crispy Potatoes,"Potato, Sunflower Oil Butter, Turmeric Powder, Red Chilli Powder, Coriander Powder, Amchur, Salt",7,10,60,70,4,Sindhi,Side Dish,Vegetarian
Puliyodharai / Puliyogare Recipe (using Millets),"Foxtail Millet, Salt, Sesame, Tamarind, Jaggery, Roasted Peanuts, Salt, Water, Chana Dal, Dry Red Chilli, Methi Seeds, Whole Black Peppercorns, Mustard Seeds, Dry Red Chilli, Chana Dal, Asafoetida, Turmeric Powder, Curry Leaves, Sesame",19,15,40,55,4,South Indian Recipes,Lunch,Vegetarian
Andhra Style Kandi Attu Recipe (Toor Dal Dosa Recipe),"Arhar Dal, Green Chilli, Ginger, Coriander, Whole Wheat Flour, Kala Jeera, Salt",7,150,25,175,4,Andhra,South Indian Breakfast,Vegetarian
Quinoa Chocolate Carrot Cake Recipe,"Quinoa Flour, Cocoa Powder, Instant Coffee Powder, Sunflower Oil, Brown Sugar, Whole Eggs Flaxseed Egg Replacer), Vanilla Extract, Baking Powder, Carrot, Salt, Butter, Icing Sugar, Milk, Salt, Almond Essence",15,15,65,80,6,Continental,Dessert,Eggetarian
Easy Homemade Sugar Free Dates Flavored Yogurt Recipe,"Milk, Milk Powder, Dates, Curd",4,10,10,20,4,Indian,Dessert,Vegetarian
Kancha Peper Kofta Curry Recipe-Bengali Green Papaya Kofta Sabzi,"Raw Papaya, Ginger, Coriander Powder, Red Chilli Powder, Cumin Powder, Garam Masala Powder, Gram Flour, Salt, Sunflower Oil Cook, Onion  Groundpaste, Homemade Tomato Puree, Garlic, Ginger, Turmeric Powder, Coriander Powder, Red Chilli Powder, Bay Leaf, Garam Masala Powder, Dry Red Chilli, Sugar, Curd, Kasuri Methi, Mustard Oil, Salt",24,15,30,45,4,Bengali Recipes,Side Dish,Vegetarian
Crepes Stuffed with Nutella and Seasonal Fruits Recipe,"All Purpose Flour, Whole Eggs, Butter, Milk, Water, Sugar, Salt, Nutella Spread, Mango, Ripe Bananas, Fresh Pomegranate Fruit Kernels, Badam, Pistachios, Vanilla Ice Cream, Chocolate Sauce Drizzle",15,10,20,30,2,Continental,World Breakfast,Vegetarian
Easy Homemade Queso Dip Recipe,"Butter, Red Onion, Green Chilli, Spring Onion, Milk, Cheddar Cheese",6,5,5,10,4,Continental,Side Dish,Vegetarian
Motichoor Modak ,"Flour, Salt, Orange Color, Ghee, Cooking Soda, Oil, Water, Sugar, Water, Saffron, Cardamom Powder, Salt, Rose Water, Melon Seeds, Almonds, Ghee",16,15,45,60,10,Indian,Dessert,Vegetarian
Ragi & Oats Rava Idli Recipe-Finger Millet and Oats Idli,"Ragi Flour, Sooji, Instant Oats, Curd, Green Chilli, Ginger, Enos Fruit Salt, Sunflower Oil, Curry Leaves, Mustard Seeds, Salt, Coriander",12,10,30,40,4,South Indian Recipes,South Indian Breakfast,Diabetic Friendly
Scrambled Tofu Noodles Recipe,"Hakka Noodles, Tofu, Mixed Vegetables, Onion, Green Chilli, Ginger, Chilli Vinegar, Dijon Mustard, Black Pepper Powder, Sesame, Salt, Sweet And Spicy Red Chilli Sauce",12,10,10,20,2,Asian,Dinner,High Protein Vegetarian
Methi & Soya Chunks Dry Sabzi Recipe,"Soya Chunks, Fenugreek, Tomato, Onion, Oil, Rye, Turmeric Powder, Red Chilli Powder, Cumin Powder, Coriander Powder, Garam Masala Powder, Salt",12,30,20,50,2,North Indian Recipes,Side Dish,Vegetarian
Avocado Mint Soup Recipe,"Avocados, Garlic, Ginger, Onion, Mint Leaves, Extra Virgin Olive Oil, Fresh Red Chilli",7,5,20,25,2,Continental,Appetizer,Vegetarian
Roasted Beet Salad Recipe With Pearl Barley & Spinach,"Barley, Spinach Leaves, Fresh Pomegranate Fruit Kernels, Beetroot, Apple Cider Vinegar, Black Pepper Powder, Honey, Lemon Juice, Salt, Extra Virgin Olive Oil",10,15,20,35,4,Continental,Appetizer,Diabetic Friendly
Chinese Egg Drop Soup Recipe (With Vegetarian Option),"Whole Eggs, Chicken Stock, Corn Flour, Ginger, Soy Sauce, Stalks Spring Onion Greens, White Pepper Powder, Button Mushrooms, Lemon, Thai Red Chilli",10,10,15,25,4,Chinese,Appetizer,Eggetarian
Braided Almond Roll Recipe,"All Purpose Flour, Active Dry Yeast, Butter, Water, Salt, Sugar, Sooji, Ghee, Milk, Saffron Strands, Sugar, Water, Badam, Raisins, Honey Drizzle",15,40,30,70,4,Continental,Snack,Vegetarian
Maharashtrian Masale Baath Recipe - Spicy Vegetable Rice with Goda Masala,"Rice, Carrot, Green Beans, Cauliflower, Potato, Onion, Curd, Bay Leaf, Maharashtrian Goda Masala, Mustard Seeds, Sunflower Oil, Asafoetida, Salt, Cashew Nuts, Ghee, Fresh Coconut, Cashew Nuts, Ghee",18,35,30,65,4,Indian,Dinner,Vegetarian
Salted Caramel Sauce Recipe,"Sugar, Butter, Heavy Whipping Cream, Vanilla Extract, Sea Salt",5,10,25,35,4,Continental,Dessert,Vegetarian
Karnataka Style Badanekai Yennegai Gojju Recipe (Stuffed Brinjal Recipe),"Small Brinjal, Onion, Mustard Seeds, Sunflower Oil, Salt, Coriander, Pearl Onion, Kala Jeera, Ajwain, Cloves, Cinnamon Stick, Dry Red Chilli, Sesame Seeds, Coriander, Poppy Seeds, Raw Peanuts, Fresh Coconut, Tamarind, Jaggery, Tamarind",20,10,45,55,4,North Karnataka,Lunch,Vegetarian
Niramish Aloo Dum Sabzi ,"Potato, Cumin Seeds, Dry Red Chilli, Ginger Powder, Turmeric Powder, Red Chili Powder, Garam Masala Powder, Asafoetida, Green Coriander",9,15,30,45,4,Indian,Lunch,Vegetarian
Murg Anardana Recipe - Pomegranate Chicken In Yogurt Gravy,"Boneless Chicken, Ginger Garlic Paste, Salt, Red Chilli Powder, Sunflower Oil, Ghee, Cashew Nuts, Khuskhus, Curd, Homemade Tomato Puree, Onion, Fresh Cream, Garam Masala Powder, Cumin Powder, Fresh Pomegranate Fruit Kernels",15,20,20,40,4,North Indian Recipes,Side Dish,Non Vegeterian
Bell Pepper & Cheese Macaroni Recipe,"Del Monte Chifferi Rigati Pasta, Red Bell Pepper, Green Bell Pepper, Onion, Green Chilli, Salt, Dried Oregano, Dried Basil Leaves, Black Pepper Powder, Extra Virgin Olive Oil, Mozzarella Cheese",11,10,30,40,2,Italian Recipes,Dinner,Vegetarian
Udupi Style Sannappa Recipe (Brown Rice and Banana Fritters Recipe),"Brown Rice, Puffed Rice, Ripe Bananas, Jaggery, Fresh Coconut, Salt, Sunflower Oil",7,70,30,100,4,Udupi,Snack,Vegetarian
Hariyali Tawa Fish Fry Recipe,"Fish, Turmeric Powder, Garam Masala Powder, Tablespoon Red Chilli Powder, Tablespoon Coriander, Mint Leaves, Lemon Juice, Green Chilli, Garlic, Onion, Tablespoon Curd, Gram Flour, Sunflower Oil Shallow Fry, Salt",14,15,15,30,4,North Indian Recipes,Appetizer,High Protein Non Vegetarian
Tomato Shorba Recipe,"Tomato, Onion, Carrot, Butter, Garlic, Cumin Powder, Sugar, Salt, Red Chilli Powder, Bay Leaf, Whole Black Peppercorns, Fried Bread Cubes",12,10,30,40,4,Middle Eastern,Appetizer,Vegetarian
Iyengar Bakery Khara Biscuit Recipe,"All Purpose Flour, Butter, Sugar, Salt, Green Chilli, Coriander, Few Curry Leaves, Curd",8,20,40,60,6,South Indian Recipes,Snack,Vegetarian
Cabbage Thoran/Poriyal Recipe,"Cabbage, Green Peas, Curry Leaf, Rye, Red Chili, White Urad Dal, Turmeric Powder, Salt, Oil, Coconut, Small Onion, Garlic, Green Chili, Curry Leaves",14,15,30,45,4,Kerala Recipes,Lunch,Vegetarian
Grilled Hummus Paneer Bhurji Sandwich Recipe,"Of Chickpea Chanachickpeas, Sesame Seeds, Of Garlic, Lemon Juice, Cumin Powder, Cup Olive Oil, Onion, Capsicum, Carrot, Cottage Cheese, Cheese, Cumin Powder, Red Chili Powder, Salt, Olive Oil, Brown Bread",16,15,15,30,6,Fusion,Indian Breakfast,High Protein Vegetarian
Fruit-Chia Rice paper rolls in a Mango Tahini Dipping sauce Recipe,"Rice Paper Rolls, Fresh Figs, Strawberries, Kiwi, Mint Leaves, Chia Seeds, Coconut Milk Almond Milk, Vanilla Extract, Maple Syrup Honey, Badam, Mango, Tahini, Fresh Red Chilli, Lemon Juice, Salt, Coconut Milk, Sriracha Sauce, Spring Onion, Black Sesame Seeds White Sesame Seeds, Red Chilli Powder",20,10,120,130,4,Indian,Dessert,Vegetarian
Carrot and Beans Thoran ,"Carrots, Green Beans, Onion, Green Chilli, Cumin Powder, Turmeric Powder, Salt, Tablespoon Oil, Mustard, Curry Leaves",10,15,35,50,4,Kerala Recipes,Dinner,Vegetarian
Masoor Dal Aur Rajma Masala Recipe,"Masoor Dal, Rajma, Onion, Tomato, Green Chilli, Ginger, Coriander Powder, Red Chilli Powder, Garam Masala Powder, Cinnamon Stick, Cumin Seeds, Ginger, Ghee Clarified Butter, Salt",14,15,20,35,4,North Indian Recipes,Dinner,High Protein Vegetarian
Watermelon Margarita Granita Recipe,"Watermelon, Sugar Syrup, Lemon Juice, Mint Leaves, Tequila, Triple Sec, Lemon Wedges",7,15,0,15,4,Continental,Side Dish,Vegetarian
Andhra Red Chilli Chutney Recipe,"Red Chili, Tamarind Paste, Sesame Oil, Rye, Asafoetida, Fenugreek Powder, Salt",7,10,10,20,4,Andhra,Side Dish,Vegetarian
Thai Baked Chicken Satay Recipe With Thai Peanut Sauce,"Chicken Breasts, Coconut Milk, Fish Sauce, Brown Sugar, Thai Red Curry Paste, Salt, Coconut Milk, Peanut Butter, Fish Sauce, Brown Sugar, Thai Red Curry Paste, Garlic, Green Chilli, Lemon Juice",14,30,20,50,10,Thai,Appetizer,Non Vegeterian
Mutton Keema Samosa Recipe-Mangsher Singara,"Mutton, Onion, Garlic, Ginger, Green Chilli, Mint Leaves, Coriander, Turmeric Powder, Kashmiri Red Chilli Powder, Coriander, Garam Masala Powder, Cumin Powder, Salt, Sunflower Oil, All Purpose Flour, Butter, Salt, Water Knead",18,30,30,60,6,Indian,Appetizer,Non Vegeterian
Dhaba Style Green Moong Dal Tadka Recipe,"Green Moong Dal, Ginger, Tomato, Green Chilli, Turmeric Powder, Salt, Garam Masala Powder, Coriander, Lemon Juice, Ghee, Cumin Seeds, Dry Red Chilli",12,10,40,50,3,North Indian Recipes,Lunch,High Protein Vegetarian
Carrot And Orange Loaf Cake Recipe,"All Purpose Flour, Sunflower Oil, Sugar, Whole Eggs, Carrot, Orange Zest, Fresh Orange Juice, Lemon Juice, Raisins, Baking Powder, Baking Soda, Salt",12,20,40,60,3,Continental,Snack,Eggetarian
Orange Kulfi Recipe In Orange Shells,"S Milk, Sugar, Orange Pulp, Orange Marmalade Jam",4,25,45,70,6,Indian,Dessert,Vegetarian
Banana And Mango Smoothie Recipe,"Mango, Ripe Bananas, Curd, Rolled Oats, Vanilla Extract, Sugar, Ice Cubes",7,10,5,15,2,Continental,World Breakfast,Vegetarian
Tandoori Paneer Samosa Recipe - With Baked Option,"All Purpose Flour, Salt, Water, Sunflower Oil, Onion, Green Bell Pepper, Red Chilli Powder, Salt, Turmeric Powder, Cumin Seeds, All Purpose Flour, Paneer, Curd, Ginger Garlic Paste, Red Chilli Powder, Coriander Powder, Amchur, Black Pepper Powder, Garam Masala Powder, Turmeric Powder, Salt",21,180,40,220,4,Indian,Snack,Vegetarian
Goan Pumpkin Sabzi Recipe,"Kaddu, Onion, Red Chilli Powder, Garam Masala Powder, Turmeric Powder, Fresh Coconut, Water, Salt",8,10,20,30,4,Goan Recipes,Lunch,Vegetarian
Pumpkin Halwa (Kaddu Ka Halwa) Recipe,"Kaddu, Sugar, Milk, Khoya, Ghee, Badam, Raisins, Cashew Nuts, Cardamom",9,10,45,55,4,Indian,Dessert,Vegetarian
Spicy Schezwan Vegetable Noodles Recipe,"Veg Hakka Noodles, Water, Salt, Sunflower Oil, Sesame, Onion, Garlic, Ginger, Green Chilli, Green Bell Pepper, Carrot, Cabbage, Schezwan Sauce, Red Chilli Sauce, Tomato Ketchup, Soy Sauce, Salt, Stalks Spring Onion",18,25,25,50,6,Indo Chinese,Main Course,Vegetarian
Maharashtrian Style Kakdichi Amti (Cucumber Gravy Recipe),"Cucumber, Green Chilli, Tamarind Water, Sugar, Salt, Ghee, Fresh Coconut, Coriander, Mustard Seeds, Rice, Turmeric Powder",11,10,25,35,4,Maharashtrian Recipes,Lunch,Vegetarian
No Onion And No Garlic Aloo Gajar Matar Ki Sabzi Recipe,"Potato, Carrot, Green Peas, Mustard Seeds, Cumin Seeds, Curry Leaves, Turmeric Powder, Red Chilli Powder, Asafoetida, Green Chilli, Salt, Sunflower Oil, Coriander",13,10,20,30,4,North Indian Recipes,Lunch,Vegetarian
Tomato Chickpea and Coconut Soup Recipe,"Extra Virgin Olive Oil, Garlic, Kabuli Chana, Tomato, Coconut Milk, Water More, Red Chilli Powder, Sugar, Red Chilli Flakes, Salt",10,480,20,500,4,Continental,Appetizer,Vegetarian
Pakki Mutton Biryani Recipe,"Mutton, Basmati Rice  Washed And Soaked In Water For  Minutes, Onion, Onion, Biryani Masala, Red Chilli Powder, Cumin Seeds, Mixed Spices   Bay Leaves, Coriander, Green Chilli, Lemon, Curd, Ginger Garlic Paste, Saffron Strands  Soaked In  Of Warm Milk, Ghee, Sunflower Oil, Salt",17,20,45,65,4,Indian,One Pot Dish,Non Vegeterian
Veg Chilli Milli Recipe,"Cabbage, Carrot, Green Bell Pepper, Tomato, Green Peas, Cashew Nuts, Sunflower Oil, Bay Leaf, Cardamom, Black Cardamom, Cloves, Cinnamon Stick, Onion, Ginger Garlic Paste, Turmeric Powder, Kashmiri Red Chilli Powder, Coriander Powder, Green Chilli, Water, Garam Masala Powder, Coriander, Sugar, Fresh Cream, Salt",24,20,30,50,4,North Indian Recipes,Dinner,Vegetarian
Kathal Biryani Recipe- Raw Jackfruit Biryani Topped with Caramelised Onions,"Basmati Rice, Jackfruit Raw, Curd, Onion, Ginger, Garlic, Ghee, Bay Leaves, Cardamom, Black Cardamom, Cloves, Whole Black Peppercorns, Cinnamon Stick, Star Anise, Mace, Nutmeg Powder, Green Chilli, Red Chilli Powder, Coriander Powder, Salt, Mint Leaves, Coriander, Lemon Juice, Few Saffron Strands, Caramelized Onion, Cashew Nuts, Raisins, Ghee",28,45,45,90,4,Indian,Lunch,Vegetarian
Strawberry and Avocado Caprese Salad Recipe,"Strawberries, Avocado, Cherry Tomato, Balsamic Vinegar, Basil Leaves, Black Pepper Powder, Extra Virgin Olive Oil, Sesame Seeds, Salt",9,10,0,10,2,Italian Recipes,Side Dish,Vegetarian
Malai Chickpea Kebab Recipe,"Kala Chana, Instant Oats, Onion, Green Chilli, Garlic, Lemon, Sunflower Oil, Coriander, Salt",9,480,45,525,4,North Indian Recipes,Snack,Vegetarian
Aloo Poha Recipe - Batata Poha,"Poha, Potato, Green Peas, Mustard Seeds, Cumin Seeds, Curry Leaves, Onion, Green Chilli, Ginger, Turmeric Powder, Asafoetida, Sugar, Lemons, Roasted Peanuts, Sunflower Oil, Coriander, Fresh Pomegranate Fruit Kernels Serve, Salt, Sweet Corn, Green Moong Sprouts",20,20,30,50,4,Indian,Indian Breakfast,Vegetarian
Penne Pasta Recipe In Spinach Pesto Sauce,"Del Monte Penne Rigate Pasta, Cherry Tomato, Milk, Salt And Pepper, Spinach, Basil Leaves, Garlic, Badam, Cumin Powder, Red Chilli Powder, Salt And Pepper",11,20,30,50,4,Italian Recipes,Dinner,Vegetarian
Arhar Ki Dal with Lahsun Tadka ,"Arhar Dal, Onion, Ginger, Turmeric Powder, Tomato, Lentil Sugar, Salt, As Per, Coriander, Ghee, Garlic, Cumin Seeds, Dry Red Chilli",13,10,40,50,3,Awadhi,Lunch,High Protein Vegetarian
No Onion No Garlic Aloo Gajar Ki Sabzi ,"Potato, Carrots, Coriander Powder, Lemon Juice, Salt, Coriander",6,10,30,40,4,Indian,Lunch,Vegetarian
Instant Garlic Pickle Recipe,"Garlic, Sesame, Red Chilli Powder, Methi Powder, Turmeric Powder, Salt, Curry Leaves",7,20,10,30,4,Indian,Side Dish,Vegetarian
Bhoplyache Gharge Recipe (Maharashtrian Style Sweet Pumpkin Puris),"Kaddu, Whole Wheat Flour, Jaggery, Sooji, Nutmeg, Salt, Sunflower Oil Deep Fry",7,30,20,50,4,Maharashtrian Recipes,Lunch,Vegetarian
Little Millet Payasam Recipe- Kutki/Sama Payasam,"Barnyard Millet, Jaggery, Ghee, Cardamom Powder, Milk, Water, Salt, Mixed Nuts",8,10,15,25,6,South Indian Recipes,Dessert,Vegetarian
Brown Rice & Quinoa Risotto Recipe,"Quinoa, Brown Rice, Garlic, Button Mushrooms, Green Bell Pepper, Broccoli, Vegetable Stock, Butter, Cheddar Cheese, Fresh Cream, Salt, Black Pepper Powder",12,10,45,55,4,Italian Recipes,Lunch,Vegetarian
Sama Khichdi Recipe - Barnyard Millet Khichdi -Navratri Fasting - Vrat Recipe,"Barnyard Millet, Green Chilli, Potato, Carrot, Tomato, Bay Leaves, Cinnamon Stick, Lemon Juice, Coriander, Whole Black Peppercorns, Salt, Sunflower Oil",12,15,30,45,4,Indian,Lunch,Vegetarian
Gulab Jamun Recipe With Khoya,"Khoya, All Purpose Flour, Cooking Soda, Ghee, Milk Waterknead, Sugar, Water, Cardamom Powder, Rose Essence",9,15,40,55,6,Indian,Dessert,Vegetarian
Bakery Style Baked Nippattu Recipe,"All Purpose Flour, Lukewarm Water, Sunflower Oil, Butter, Baking Soda, Milk Powder, Sesame Seeds, Onion, Green Chilli, Black Pepper Powder, Few Coriander, Few Curry Leaves, Sugar, Salt",14,30,30,60,2,Indian,Snack,Vegetarian
Besan Bread Toast Recipe On Tawa - Vegetarian French Toast,"Whole Wheat Brown Bread, Onion, Tomato, Green Chilli, Coriander, Gram Flour, Turmeric Powder, Sunflower Oil, Salt",9,10,10,20,2,Indian,North Indian Breakfast,Vegetarian
Baby Corn Capsicum Masala ,"Baby Corn, Capsicum, Onion, Ginger, Bud Garlic, Green Chili, Tomato, Cumin Seeds, Fennel, Turmeric Powder, Coriander Powder, Cardamom Powder, Red Chili Powder, Salt  As Per  Coriander  Little, Oil",15,20,40,60,2,North Indian Recipes,Side Dish,Vegetarian
Paneer Kulcha Recipe-Cottage Cheese Stuffed Leavened Flatbread,"All Purpose Flour, Sooji, Curd, Sunflower Oil, Baking Soda, Sugar, Salt, Kalonji, Butter, Sunflower Oil, Green Chilli, Onion, Paneer, Cumin Powder, Salt",15,140,30,170,2,North Indian Recipes,Dinner,Vegetarian
Crunchy Ragi And Oats Breakfast Bowl Recipe,"Ragi Flour, Oats, Water, Milk, Honey, Ragi Cookies, Almonds, Pistachios",8,5,15,20,1,Continental,World Breakfast,Vegetarian
Pudina Moong Dal ,"Yellow Moong Dal, Red Chilli Powder, Turmeric Powder, Cumin Seeds, Asafoetida, Ghee, Peppermint, Water, According",9,10,25,35,2,North Indian Recipes,Lunch,High Protein Vegetarian
Red Poha And Flax Seeds Ladoo Recipe,"Red Poha, Flax Seeds, Brown Sugar, Cardamom, Ghee, Cashew Nuts, Raisins",7,10,20,30,10,Indian,Dessert,Vegetarian
Homemade Soft Idli Recipe - Steamed Rice and Lentil Cake,"Idli Rice, White Urad Dal, Methi Seeds, Salt, Water",5,480,20,500,4,South Indian Recipes,South Indian Breakfast,High Protein Vegetarian
Moong Dal Sookhi Sabzi ,"Yellow Moong Dal, Red Chili Powder, Turmeric Powder, Garam Masala Powder, Salt, Oil, Green Chili, Lemon Juice, Green Coriander",9,10,20,30,2,North Indian Recipes,Dinner,High Protein Vegetarian
Goan Style Bebinca/ Bebik/ Bebinka Recipe,"Coconut Milk, Vivatta Maida, Whole Eggs, Confectioners Sugar, Date Syrup, Nutmeg, Vanilla Extract, Ghee, Salt",9,20,60,80,4,Goan Recipes,Dessert,Eggetarian
Vegan Chocolate Fudgesicles Recipe,"Kabuli Chana, Peanut Butter Almond Butter, Soy Milk, Vanilla Extract, Date Syrup, Cocoa Powder, Ripe Bananas  Fully Ripe, Salt",8,40,0,40,16,Continental,Snack,Vegan
Dhaba Style Green Moong Dal Tadka ,"Green Moong Dal, Ginger, Tomato, Green Chili, Turmeric Powder, Sugar, Salt, Coriander, Lemon Juice, Ghee, Cumin Seeds, Dry Red Chilli",12,10,40,50,3,North Indian Recipes,Lunch,High Protein Vegetarian
Chicken Malai Kabab Recipe,"Chicken, Ginger Garlic Paste, Turmeric Powder, Salt, Red Chilli Powder, Fresh Cream",6,10,30,40,2,North Indian Recipes,Appetizer,Non Vegeterian
Bengali Style Mangsher Jhol Recipe-Mutton Curry,"Mutton, Potato, Onion, Onion, Garlic, Ginger, Cumin Powder, Coriander Powder, Turmeric Powder, Red Chilli Powder As Per Your Heat Tolerance, Vinegar, Mustard Oil, Curd, Ghee, Garam Masala Powder, Sugar, Salt, Bay Leaf, Dry Red Chilli, Black Cardamom, Cardamom, Cloves, Cinnamon Stick",23,180,45,225,5,Bengali Recipes,Dinner,Non Vegeterian
Methi Matar Pulao ,"Rice, Green Peas, Fenugreek, Cumin Seeds, Ginger, Green Chilli, Coconut Milk, Small Spoon Turmeric Powder, , Cardamom, Lentil Sugar, Bay Leaf, Ghee Sesame Oil, Salt",14,20,45,65,4,Indian,Lunch,Vegetarian
Badam Sharbat Recipe - Almond Milk With Nuts & Spices,"Badam, Melon Seeds, Jaggery, Cardamom Powder, Kewra Essence, Saffron Strands",6,10,30,40,2,Indian,Snack,High Protein Vegetarian
Spicy Rice Stuffed Paratha Recipe,"Whole Wheat Flour, Cooked Rice, Onion, Coriander, Green Chilli, Cumin Powder, Red Chilli Powder, Chaat Masala Powder, Lemon Juice, Salt, Sunflower Oil Ghee For Cooking Paratha, Water",12,20,25,45,4,Indian,Lunch,Vegetarian
Maharashtrian Style Dashmi Roti Recipe (Jaggery Flatbread),"Whole Wheat Flour, Jaggery, Sunflower Oil, Milk, Salt, Ghee",6,20,30,50,4,Maharashtrian Recipes,Side Dish,Vegetarian
Broccoli Paneer And Peanut Masala ,"Broccoli, Cheese, Peanuts, Green Chilies, Onion, Tomato, Cumin Seeds, Whole Pepper, Cashmere Red Chilli Powder, Garam Masala Powder, Biryani Masala, Turmeric Powder, Butter, Kasuri Methi, Salt",15,15,45,60,4,Indian,Dinner,High Protein Vegetarian
Stuffed Yellow Moong Dal And Onion Paratha Recipe,"Whole Wheat Flour, Salt, Sunflower Oil, Ghee Cook, Sunflower Oil, Yellow Moong Dal, Green Bell Pepper, Onion, Ginger, Garlic, Green Chilli, Salt, Red Chilli Powder, Cumin Powder, Turmeric Powder",15,20,20,40,2,North Indian Recipes,North Indian Breakfast,Vegetarian
Baked Banana Chips Recipe,"Raw Banana, Paprika Powder, Black Pepper Powder, Salt, Extra Virgin Olive Oil Toss",5,10,35,45,2,Kerala Recipes,Snack,Vegetarian
Tamil Nadu Style Ulundhu Kuzhambu Recipe - Black Lentil Curry,"Black Urad Dal, Brinjal, Drumstick   Into   Pieces, Tamarind, Garlic, Turmeric Powder, Red Chilli Powder, Coriander Powder, Sesame, Asafoetida, Salt, Water Cook, Fresh Coconut, Cumin Seeds, Shallots, Mustard Seeds, Shallots, Dry Red Chilli, Curry Leaves",19,20,40,60,4,South Indian Recipes,Lunch,High Protein Vegetarian
Potato And Paneer Reuben Sandwich Recipe,"Honey Mustard Dressing, Tomato Ketchup, Lemon Juice, Paneer, Onion, Extra Virgin Olive Oil, Hash Browns, Rye Bread, Butter, Swiss Cheese, Sauerkraut, Salt",12,15,20,35,4,Continental,World Breakfast,Vegetarian
Mangalorean Chana Gassi Recipe,"Kabuli Chana, Salt, Dry Red Chilli, Garlic, Coriander, Fresh Coconut, Tamarind Paste, Turmeric Powder, Salt, Water, Coconut Oil, Mustard Seeds, Methi Seeds, Asafoetida, Curry Leaves",15,20,15,35,3,Mangalorean,Side Dish,High Protein Vegetarian
Tisrayanche Suke Recipe (Goan Clams Dry),"Clams, Fresh Coconut, Onion, Green Chilli, Kokum, Red Chilli Powder, Turmeric Powder, Salt, Water",9,30,20,50,3,Goan Recipes,Side Dish,Non Vegeterian
Eggless Spiced Carrot Olive Cake Recipe,"All Purpose Flour, Cinnamon Stick, Salt, Baking Powder, Brown Sugar, Extra Virgin Olive Oil, Carrots, Walnuts, Curd, Flax Seed Powder, Chilled Water, Icing Sugar, Water",13,25,60,85,4,Continental,Dessert,Vegetarian
Stuffed Capsicum With Sweet Potato Recipe,"Green Bell Pepper, Sweet Potato, Garlic, Cumin Seeds, Turmeric Powder, Red Chilli Powder, Black Pepper Powder, Garam Masala Powder, Methi Leaves, Salt, Extra Virgin Olive Oil, Coriander",12,10,35,45,4,Indian,Appetizer,Vegetarian
Kumbakonam Filter Coffee Recipe,"Instant Coffee Powder, Hot Water, Milk, Sugar",4,10,25,35,4,Tamil Nadu,South Indian Breakfast,Vegetarian
Assamese Fish Fried Rice Recipe,"Basmati Rice, Fish, Onion, Dry Coconut, Coriander Powder, Turmeric Powder, Cumin Powder, Ginger, Green Peas, Carrot, Bay Leaf, Lemon Juice, Sunflower Oil, Salt",14,10,15,25,2,Assamese,Dinner,High Protein Non Vegetarian
Chettinad Style Puliyogare Gojju Recipe,"Dry Red Chilli, Whole Black Peppercorns, Cumin Seeds, Chana Dal, White Urad Dal, Sesame Seeds, Dry Coconut, Mustard Seeds, Curry Leaves, Asafoetida, Jaggery, Tamarind Paste, Roasted Peanuts, Sunflower Oil",14,20,30,50,4,Chettinad,Main Course,Vegetarian
Moong Sprouts Pulao Recipe,"Basmati Rice, Cumin Seeds, Onion, Tomato, Green Moong Sprouts, Ginger, Cloves, Cardamom, Cinnamon Stick, Bay Leaves, Whole Black Peppercorns, Green Chilli  Sliced, Coriander, Sunflower Oil, Salt",15,15,35,50,4,Indian,Lunch,Vegetarian
Grated Cucumber Raita Recipe,"Cucumber, Curd, Cumin, Red Chilli Powder, Salt, Coriander",6,5,0,5,4,Indian,Side Dish,Vegetarian
Suran Fodi Recipe,"G Suran, Tamarind Paste, Salt, Red Chilli Powder, Turmeric Powder, Oil, Semolina, Rice Flour, Red Chilli Powder, Turmeric Powder, Salt",11,10,90,100,4,Goan Recipes,Side Dish,Vegetarian
Whole Wheat Stuffed Breadsticks Recipe,"Whole Wheat Flour, Active Dry Yeast, Sugar, Salt, Extra Virgin Olive Oil, Green Bell Pepper, Carrots, Mozzarella Cheese, Red Chilli Flakes, Dried Oregano, Dried Thyme Leaves",11,50,35,85,4,Continental,Appetizer,Vegetarian
Andhra Style Makka Garelu Recipe (Corn Vada Recipe),"Sweet Corn, Gram Flour, Onion, Green Chilli, Curry Leaves, Garlic, Kalonji, Salt, Sunflower Oil",9,10,30,40,4,Andhra,Snack,Vegetarian
Pineapple Cucumber Salad Recipe With Lemon Dressing,"Pineapple, Cucumbers, Coriander, Lemon Zest, Lemon, Salt, Black Pepper Powder",7,15,10,25,4,Indian,Side Dish,Vegetarian
Pull Apart Bread With Basil Pesto Recipe,"Whole Wheat Flour, Instant Oats, Extra Virgin Olive Oil, Active Dry Yeast, Sugar, Salt, Honey, Milk, Homemade Basil Pesto",9,60,45,105,4,Continental,Appetizer,Eggetarian
Bajra Kaddu Ki Roti Recipe - Bajra Pumpkin Roti Recipe,"Bajra Flour, Whole Wheat Flour, Kaddu, Ginger, Green Chilli, Ajwain, Turmeric Powder, Asafoetida, Lemon Juice, Coriander, Ghee",11,20,20,40,4,North Indian Recipes,Lunch,No Onion No Garlic (Sattvic)
Methi Namak Pare Recipe,"Whole Wheat Flour, All Purpose Flour, Methi Leaves, Green Chilli  Crushed, Turmeric Powder, Cumin Seeds, Butter, Water, Salt",9,20,20,40,4,Indian,Snack,Vegetarian
Mooli Ki Sabzi ,"Radishes, Radish Leaves, Oil, Mustard, Curry Leaves, Dry Red Chilli, Tamarind Paste, Red Chili Powder, Salt, Coconut",10,10,20,30,6,Indian,Lunch,Vegetarian
Vegetables In Coconut Gravy ,"Mixed Vegetables, Arhar Dal, Turmeric Powder, Coconut, White Urad Dal, Mustard, Dry Red Chilli, Small Spoon Cumin Seeds, Coconut Oil, Mustard, Dry Red Chilli, Curry Leaves",12,15,30,45,4,South Indian Recipes,Lunch,Vegetarian
Easy Sabudana Vada With Arrowroot Powder Recipe,"Sabudana, Potato, Arrowroot Flour, Cumin Seeds, Green Chilli Paste, Salt, Sugar, Roasted Peanuts, Lemon Juice, Sunflower Oil",10,10,20,30,4,Maharashtrian Recipes,Snack,Vegetarian
Cheese Balls With Capsicum Recipe,"Potato, Cheese, Green Bell Pepper, Ginger Garlic Paste, Dried Oregano, Red Chilli Flakes, Black Pepper Powder, Corn Flour, All Purpose Flour, Water, Whole Wheat Bread Crumbs",11,10,40,50,4,Continental,Appetizer,Vegetarian
Andhra Style Pulihora Recipe (Spicy & Tangy Tamarind Rice),"Cooked Rice, Tamarind Water, Jaggery, Raw Peanuts, Salt, Mustard Seeds, Cumin Seeds, Chana Dal, Dry Red Chilli, Green Chilli  Deseeded And Slit Lengthwise, Turmeric Powder, Asafoetida, Curry Leaves, Sesame",14,20,30,50,4,Andhra,Lunch,Vegetarian
Achappam Recipe | Kerala Style Fried Rose Cookies,"Rice Flour, Icing Sugar, Fennel Seeds, Salt, Coconut Milk, Whole Eggs, Sunflower Oil",7,20,15,35,10,Kerala Recipes,Snack,Vegetarian
Kerala Style Mutton Stew Recipe,"Mutton, Fresh Coconut, Onion, Potato, Tomato, Green Chilli, Garlic, Ginger, Poppy Seeds, Cinnamon Stick, Cloves, Coriander, Coriander, Sunflower Oil",14,15,25,40,2,Kerala Recipes,Lunch,Non Vegeterian
Vazhaipoo Vadai Recipe (Banana Flower Fried Savoury Snack),"Chana Dal, Arhar Dal, Banana Flower, Green Chilli, Fennel Seeds, Asafoetida, Pearl Onion, Garlic  Pound, Curry Leaves, Coriander, Salt, Sunflower Oil",12,20,45,65,4,South Indian Recipes,Snack,Vegetarian
Khira Gaintha Recipe - Rice Dumplings In Sweetened Milk,"Rice Flour, Water, Sugar, Cashew Nuts, Salt, Cardamom Powder, Milk, Mixed Nuts",8,30,30,60,6,Indian,Dessert,Vegetarian
Foxtail Millet Nucchina Unde Recipe (Foxtail Millet and Lentil Dumplings),"Foxtail Millet, Arhar Dal, Chana Dal, Yellow Moong Dal, Fresh Coconut, Green Chilli, Asafoetida, Onion, Coriander, Salt",10,0,15,15,5,South Indian Recipes,Snack,Vegetarian
Senai Pachadi Recipe (Elephant Yam Raita),"Elephant Yam, Green Chilli, Ginger, Coriander, Salt, Curd, Sunflower Oil, Asafoetida, Mustard Seeds, Black Urad Dal",10,15,25,40,4,Indian,Side Dish,Vegetarian
Punjabi Style Tinda Sabzi Recipe,"Tinda, Onion, Garlic, Tomato, Tomato, Coriander Powder, Cumin Powder, Spoon Garam Masala Powder, Red Chilli Powder, Oil, Cumin Seeds, Turmeric Powder, Asafoetida, Salt",14,5,15,20,4,Punjabi,Lunch,Vegetarian
Pumpkin Stew With Chickpeas Recipe,"Kabuli Chana, Kaddu, Carrot, Onion, Garlic, Ginger, Homemade Tomato Puree, Cumin Powder, Coriander Powder, Cinnamon Powder, Red Chilli Flakes, Coriander, Lemon, Extra Virgin Olive Oil, Salt",15,10,30,40,4,African,Main Course,Vegetarian
Schezwan Style Chinese Veg Samosa Recipe - Roz Ka Khana with Figaro Olive Oil,"Whole Wheat Flour, Sooji, Ajwain, Salt, Figaro Pure Olive Oil, Carrot, Green Bell Pepper, Cabbage, Ginger, Garlic, Green Chilli, Spring Onion Greens, Schezwan Sauce, Salt, Black Pepper Powder",15,10,45,55,4,North Indian Recipes,Snack,Vegetarian
Mexican Sizzler Recipe,"Cooked Rice, Green Bell Peppers, Black Pepper Powder, Garlic, Carrots, Broccoli, Green Beans, Quinoa, Onion, Green Chilli, Ginger Garlic Paste, Green Bell Peppers, Broccoli, Baby Corn, Onion, Tomato, Butter, Salt, Worcestershire Sauce, Roasted Tomato Pasta Sauce, Paprika Powder, Cabbage",22,15,45,60,2,Mexican,Lunch,Vegetarian
Pudina Rasam Recipe - Mint Leaves Rasam,"Tamarind, Mint Leaves, Pearl Onion, Tomato, Garlic, Cumin Seeds, Whole Black Peppercorns, Mustard Seeds, Curry Leaves, Dry Red Chilli, Turmeric Powder, Asafoetida, Salt, Sunflower Oil",14,5,15,20,4,Tamil Nadu,Lunch,Vegetarian
Sookhi Moong Palak Dal ,"Green Moong Dal, Spinach, Tomato, , Cumin Seeds, Onion, Garlic, Ginger, Green Chilli, Salt, Onion, Green Chili, Coriander",13,20,45,65,4,North Indian Recipes,Side Dish,High Protein Vegetarian
Ceylon Egg Parotta Recipe,"All Purpose Flour, Whole Wheat Flour, Curd, Salt, Sunflower Oil, Whole Eggs, Onion, Tomato, Green Bell Peppers, Ginger, Garlic, Red Chilli Powder, Turmeric Powder, Salt, Sunflower Oil",15,20,30,50,4,Sri Lankan,Snack,Eggetarian
Tomato Tarts Recipe,"All Purpose Flour, All Purpose Flour, Salted Butter, Paprika Powder, Chilled Water, Cherry Tomato Heirloom Tomato, Goat Cheese, Dried Thyme Leaves, Mustard Greens",9,5,60,65,4,Continental,Lunch,Vegetarian
Eggless Saffron Laced Almond Cookies Recipe,"Butter, Caster Sugar, All Purpose Flour, Cardamom Powder, Almond Meal, Saffron Strands, Salt, Badam",8,15,30,45,4,Continental,Snack,Vegetarian
Aubergine Layered Baked Corn Cheese Quinoa Pasta Recipe,"Brinjal, Sweet Corn, Mozzarella Cheese, Penne Pasta, Homemade Tomato Puree, Dried Oregano, Red Chilli Flakes, Basil Leaves, Parsley Leaves, Milk, Corn Flour, Black Pepper Powder, Extra Virgin Olive Oil, Salt, Garlic",15,35,10,45,4,Italian Recipes,Lunch,Vegetarian
Makai Wali Bhindi Recipe,"Bhindi, Makki Ka Atta, Onion, Cumin Seeds, Coriander Powder, Red Chilli Powder, Turmeric Powder, Garam Masala Powder, Amchur, Sunflower Oil, Salt",11,15,20,35,4,Punjabi,Lunch,Vegetarian
Broccoli Paneer Mayo Sandwich Recipe,"Whole Wheat Brown Bread, Broccoli, Paneer, Eggless Mayonnaise, Garlic, Red Chilli Sauce, Salt, Butter, Sunflower Oil",9,10,30,40,4,Continental,Snack,High Protein Vegetarian
Pesto Pizza With Mushroom And Bell Pepper Recipe,"Whole Wheat Pizza Dough, Button Mushrooms, Cheddar Cheese, Red Bell Pepper, Walnuts, Basil Leaves, Garlic, Salt, Whole Black Peppercorns, Extra Virgin Olive Oil, Parmesan Cheese",11,60,25,85,4,Italian Recipes,Lunch,Vegetarian
Broccoli Capsicum Pulao Recipe,"Basmati Rice, Broccoli, Green Bell Pepper, Red Bell Pepper, Onion, Green Chilli, Garlic, Coriander, Salt, Ghee",10,20,40,60,4,Indian,Lunch,Vegetarian
Maple Roasted Cinnamon Spiced Latte Recipe,"Instant Oats, Instant Coffee Powder, Maple Syrup, Vanilla Extract, Cinnamon Powder, Dates, Milk, Ice Cubes",8,0,10,10,4,Continental,Appetizer,Vegetarian
Raw Mango Coconut Chutney Recipe,"Fresh Coconut, Mango, Green Chilli, Salt, Water, Sunflower Oil, Mustard Seeds, Dry Red Chilli, Curry Leaves, Mango",10,15,10,25,4,South Indian Recipes,Side Dish,Vegetarian
Nolen Chawal Bhog Recipe (Rice Pudding With Nolen Jaggery),"Milk  Full Cream Milk Â   Litter, Nolen Gur, Basmati Rice Any Fragrant Rice, Salt, Slivered Almonds, Glazed Cherries",6,5,30,35,6,Bengali Recipes,Dessert,Vegetarian
Makhana Aloo Tikki Recipe (Spiced Lotus Seed Patties Recipe),"Potato, Phool Makhana, Green Chilli, Fennel Seeds, Roasted Peanuts, Coriander, Chaat Masala Powder, Garam Masala Powder, Red Chilli Powder, Black Salt, Sunflower Oil",11,15,15,30,4,North Indian Recipes,Snack,Vegetarian
Peanut Chutney Podi Recipe,"Roasted Peanuts, Dry Red Chilli, Garlic, Cumin Seeds, Coriander, Curry Leaves, Tamarind, Salt",8,5,5,10,1,Karnataka,Side Dish,Vegetarian
Chicken Pasanda Recipe,"Coriander, Cumin Seeds, Whole Black Peppercorns, Cinnamon Stick, Cardamom, Dry Red Chilli, Bay Leaf, Chicken Breasts, Curd, Garlic, Ginger, Sunflower Oil, Onion, Tomato, Turmeric Powder, Salt",16,10,45,55,4,Mughlai,Lunch,Non Vegeterian
Udupi Style Sambar Recipe - Masala Huli With Mixed Vegetables,"Arhar Dal, Turmeric Powder, Asafoetida, Fresh Coconut, Coriander, Cumin Seeds, Methi Seeds, Chana Dal, White Urad Dal, Byadagi Dried Chilli, Curry Leaves A Few S, Sunflower Oil, Onion, Tomato, Drumstick, Kaddu, Tamarind Paste, Jaggery, Turmeric Powder, Red Chilli Powder, Salt, Mustard Seeds, Methi Seeds, White Urad Dal, Dry Red Chilli, Curry Leaves, Asafoetida",27,20,30,50,6,Udupi,Side Dish,Vegetarian
Tandoori Potato Wedges Recipe,"Potato, Hung Curd, Red Chilli Powder, Coriander Powder, Cumin Powder, Chaat Masala Powder, Garam Masala Powder, Black Pepper Powder, Sunflower Oil, Kasuri Methi, Salt, Coriander",12,20,30,50,4,Fusion,Appetizer,Vegetarian
Hariyali Chicken Tikka Recipe,"Chicken Breasts, Red Chilli Powder, Turmeric Powder, Garam Masala Powder, Amchur, Cumin Powder, Curd, Salt, Coriander, Mint Leaves, Green Chilli",11,80,30,110,4,North Indian Recipes,Appetizer,High Protein Non Vegetarian
Homemade Low Fat Strawberry Frozen Yogurt Recipe,"Strawberries, Hung Curd, Honey, Basil Leaves",4,60,10,70,6,Continental,Dessert,Vegetarian
Chemba Arisi Thengai Paal Payasam Recipe- Red Rice Payasam,"Red Matta Rice, Water, Jaggery, Cardamom, Coconut Milk, Water, Ghee, Cashew Nuts, Dry Coconut",9,30,40,70,4,Kerala Recipes,Dessert,Vegetarian
Badam Milk Recipe - Almond Milk,"Almond Milk, Milk, Sugar, Cardamom, Saffron Strands",5,5,30,35,4,Indian,Side Dish,Vegetarian
Spicy Potato Chutney Sandwich Recipe,"Whole Wheat Brown Bread, Green Chutney, Potato, Cucumber, Beetroot, Tomato, Onion, Salted Butter, Chaat Masala Powder, Green Chilli, Coriander, Mint Leaves, Lemon Juice, Salt, Water",15,20,10,30,4,Fusion,Snack,Vegetarian
Andhra Style Urlugadda Munagakaya Charu Recipe - Potato And Drumstick Gravy,"Potato, Drumstick, Onion, Tomato, Green Chilli, Turmeric Powder, Red Chilli Powder, Coriander Powder, Methi Seeds, Curry Leaves, Mustard Seeds, Sunflower Oil, Coriander, Salt",14,10,20,30,4,Andhra,Side Dish,Vegetarian
Shredded Mutton With Caramelized Onions Recipe,"Mutton, Onion, Green Chilli, Ginger Garlic Paste, Salt, Water, Turmeric Powder, Coconut Oil",8,20,40,60,3,Indian,Dinner,Non Vegeterian
Buttered Broccoli Poriyal Sabzi Recipe - Finger Food For Babies And Toddlers,"Broccoli, Butter, Garlic",3,2,10,12,2,Continental,Side Dish,High Protein Vegetarian
Kathirikai Poondu Pirattal Recipe - South Indian Style Brinjal Stir Fry With Garlic,"Long Green Brinjal, Onion, Garlic, Tomato, Turmeric Powder, Sambar Powder, Salt, Sunflower Oil, Mustard Seeds, White Urad Dal, Ssp Asafoetida, Curry Leaves, Dry Red Chilli",13,15,30,45,4,Chettinad,Lunch,Vegetarian
Roasted Carrot & Green Pepper Hummus Recipe,"Kabuli Chana, Carrots, Green Bell Pepper, Lemon Juice, Tahini, Garlic, Cumin Powder, Fresh Red Chilli, Extra Virgin Olive Oil, Coriander, Salt",11,10,30,40,1,Middle Eastern,Side Dish,Vegetarian
Broken Wheat and Mixed Millet Upma Recipe,"Broken Wheat, Bajra, Ragi Seeds, Jowar Seeds, Foxtail Millet, Barley, Cumin Seeds, Green Peas, Carrot, Green Chilli, Onion, Ginger, Salt, Ghee, Water, Coriander, Lemon Juice",17,20,30,50,4,South Indian Recipes,South Indian Breakfast,Diabetic Friendly
Herb & Cheese Mushroom Omelette Recipe,"Butter, Button Mushrooms  Sliced, Clove Garlic, Spring Onion, Parsley Leaves, Parmesan Cheese, Salt And Pepper, Whole Eggs, Milk, Extra Virgin Olive Oil, Salt And Pepper",11,10,30,40,5,Continental,World Breakfast,Eggetarian
Quick And Easy Baked Beans Shakshuka Recipe,"Baked Beans, Onion, Green Bell Pepper, Green Chilli, Garlic, Cumin Powder, Garam Masala Powder, Cayenne Pepper, Sugar, Whole Eggs, Coriander, Extra Virgin Olive Oil, Butter",13,10,25,35,4,Middle Eastern,Dinner,Eggetarian
Bengali Aloo Jhinge Posto Curry Recipe (Potato and Ridge Gourd Curry),"Ridge Gourd, Potato, Kalonji, Turmeric Powder, Sugar, Salt, Mustard Oil, Poppy Seeds, Dry Red Chilli, Green Chilli",10,15,30,45,4,Bengali Recipes,Lunch,Vegetarian
Bhogichi Bhaji Recipe (Maharashtrian Mixed Vegetable Stir Fry),"Carrots, Potato, Brinjal, Hara Chana, Avarekai, Ber, Green Chilli, Groundnut Powder, Sesame Powder, Sunflower Oil, Maharashtrian Goda Masala, Cumin Seeds, Mustard Seeds, Asafoetida, Turmeric Powder, Salt, Coriander, Lemon Juice",18,10,30,40,4,Maharashtrian Recipes,Lunch,Vegetarian
Sweet Corn And Raw Mango Salad Recipe,"Mango, Sweet Corn, Green Chilli, Kasundi Mustard Sauce, Honey, Coriander, Black Salt",7,15,0,15,5,Indian,Side Dish,Vegetarian
Crunchy Creamy Coleslaw Recipe,"Cabbage, Carrots, Green Bell Pepper, Red Onion, Green Chilli Jalapeno, Vinegar Lemon Juice, Classic Mayonnaise, Black Pepper Powder",8,5,15,20,4,Continental,Side Dish,Vegetarian
Maharastrian Style Bharli Bhindi Recipe - Stuffed Bhindi With Coconut,"Bhindi, Salt, Mustard Seeds, Turmeric Powder, Roasted Peanuts, Coriander, Garlic, Green Chilli, Fresh Coconut, Maharashtrian Goda Masala Garam Masala, Red Chilli Powder, Turmeric Powder, Cumin Powder, Coriander Powder, Lemon Juice, Sugar",16,5,35,40,4,Maharashtrian Recipes,Side Dish,Vegetarian
Mixed Vegetable Akki Roti Recipe,"Rice Flour, Carrot, Chayote, Cucumber, Green Bell Pepper, Curry Leaves, Tomato, Green Amaranth Leaves, Cumin Seeds, Green Chilli, Salt, Sunflower Oil",12,25,60,85,10,North Karnataka,South Indian Breakfast,Gluten Free
Bitter Gourd Peel Puri Recipe,"Whole Wheat Flour, Gram Flour, Karela, Ajwain, Red Chilli Powder, Turmeric Powder, Coriander Powder, Salt, Sunflower Oil",9,10,25,35,4,North Indian Recipes,Side Dish,Vegetarian
"Green Apple, Radish & Pepper Salad Recipe","Green Apple, Red Radish, Mooli Mullangi, Tomato, Tomato, Red Cabbage, Onion, Broccoli, Red Bell Pepper, Green Bell Pepper, Yellow Bell Pepper, Lemon Juice, Lemon Zest, Fresh Thyme Leaves, Green Chilli Red, Ginger, Coriander, Sesame, Clove Garlic, Salt, Black Pepper Powder",21,10,20,30,4,Continental,Appetizer,Vegetarian
Mangalore Cucumber Chana Dal Subzi Recipe,"Mangalorean Cucumber, Chana Dal, Cumin Seeds, Bay Leaf, Ginger, Tomato, Coriander Powder, Turmeric Powder, Red Chilli Powder, Sugar, Coriander, Sunflower Oil, Cumin Seeds, Dry Red Chilli, Salt",15,10,30,40,4,Mangalorean,Lunch,Vegetarian
Pavakkai Poriyal Recipe ,"Bitter Gourd, Mustard Seeds, Cumin Seeds, Turmeric Powder, Asafoetida, Red Chilli Powder, Coriander Powder, Cumin Powder, Amchur Powder, Curry Leaves, Jaggery, Peanuts, Oil  Coriander  Little, Salt",14,10,40,50,4,South Indian Recipes,Side Dish,Vegetarian
Bengali Dhokar Dalna Recipe,"Chana Dal, Ginger, Cumin Seeds, Cumin Powder, Salt, Sugar, Green Chilli, Asafoetida, Sunflower Oil, Potato, Bay Leaves, Cumin Seeds, Ginger, Tomato, Green Chilli, Cumin Powder, Coriander Powder, Turmeric Powder, Red Chilli Powder, Salt, Sugar, Garam Masala Powder, Mustard Oil",23,30,60,90,4,Bengali Recipes,Side Dish,No Onion No Garlic (Sattvic)
Mushroom Curry Recipe,"Button Mushrooms, Onion, Green Bell Pepper, Garlic, Ginger, Tomato, Turmeric Powder, Red Chilli Powder, Garam Masala Powder, Sunflower Oil, Mint Leaves, Salt",12,10,35,45,3,North Indian Recipes,Dinner,Vegetarian
Vagharela Chawal Recipe,"Rice  Wash, Onion, Cardamom, , Cinnamon, Salt, As Per",7,5,20,25,4,Parsi Recipes,Main Course,Vegetarian
Pudina Sooji & Oats Dhokla Recipe - Steamed Semolina Cake With Oats & Mint Leaves,"Sooji, Rolled Oats Or Instant Oats, Mint Leaves, Curd, Enos Fruit Salt, Asafoetida, Ginger, Sunflower Oil, Red Chilli Powder, Salt, Mustard Seeds, Sesame Seeds, Sunflower Oil, Curry Leaves",14,15,30,45,4,Gujarati Recipesï»¿,North Indian Breakfast,Vegetarian
Rajma and Corn Salad Recipe,"Kashmiri Rajma Regular Rajma, Sweet Corn, Mint Leaves, Pickled Jalapenos, Salt, Black Pepper Powder, Lemon Juice, Sugar, Vinegar, Cumin Powder, Red Chilli Powder, Garlic, Extra Virgin Olive Oil",13,15,10,25,5,Indian,Side Dish,High Protein Vegetarian
Awadhi Style Taheri ,"Rice, Potato, Carrot, Green Peas, Cauliflower, Green Beans, Onion, Onion, Green Chilli, Ginger, Garlic, Curd, S Of Mint, S Of Coriander, Of Red Chili Powder, Coriander Powder, Turmeric Powder, Salt, Oil, Bay Leaf, Big Cardamom, Whole Black Pepper, Cardamom, , Lentil Sugar",25,15,35,50,4,Awadhi,Lunch,Vegetarian
Besan Katli Ki Sabzi Recipe,"Gram Flour, Green Chilli, Garlic, Turmeric Powder, Salt, Water, Ghee, Onion, Ginger Garlic Paste, Turmeric Powder, Red Chilli Powder, Coriander Powder, Coriander, Garam Masala Powder, Homemade Tomato Puree, Cumin Seeds",16,15,35,50,4,Uttar Pradesh,Lunch,Vegetarian
Bengali Style Khichuri Aar Labra Recipe-Khichdi And Mixed Vegetables,"Govind Bhog Rice, Yellow Moong Dal, Cauliflower, Potato, Green Peas, Dry Red Chilli, Methi Seeds, Kalonji, Cumin Seeds, Mustard Seeds, Fennel Seeds, Ginger, Green Chilli, Turmeric Powder, Bhaja Masala, Mustard Oil, Ghee, Salt, Sugar, Methi Seeds, Cumin Seeds, Kalonji, Mustard Seeds, Fennel Seeds, Potato, Small Brinjal, Mooli Mullangi, Sweet Potato, Kaddu, White Broad Beans, Drumstick, Spinach Leaves, Dry Red Chilli, Ginger, Coriander Powder, Green Chilli, Bhaja Masala, Mustard Oil Cook, Salt, Sugar, Bay Leaves, Dry Red Chilli, Cumin Seeds",43,15,70,85,4,Bengali Recipes,Main Course,Vegetarian
Parwal Ki Mithai Recipe -Pointed Gourd Sweet,"Pointed Gourd, Sugar, Water, Khoya, Sugar, Badam, Pistachios, Cardamom",8,10,60,70,4,North Indian Recipes,Dessert,Vegetarian
Chicken & Bell Pepper Skewers Recipe,"Chicken Breasts, Yellow Bell Pepper, Red Bell Pepper, Onion, Soy Sauce, Honey, Dry Ginger Powder, Pineapple Juice, Extra Virgin Olive Oil, Whole Black Peppercorns, Cloves, Salt",12,60,30,90,4,Continental,Appetizer,Non Vegeterian
Broken Wheat And Apple Porridge Recipe,"Broken Wheat, Instant Oats, Water, Milk, Cinnamon Powder, Apples, Butter, Honey Brown Sugar, Apple, Strawberries, Muesli",11,10,45,55,3,Continental,World Breakfast,Diabetic Friendly
Chocolate Banana Smoothie Bowl Recipe,"Bananas, Milk, Peanut Butter, Oats, Cocoa Powder, Dates, Walnuts, Banana, Cranberries Raisins",9,10,0,10,2,Continental,World Breakfast,High Protein Vegetarian
Classic Banana Walnut Steamed Bread Recipe in Preethi Electric Pressure Cooker,"All Purpose Flour, Baking Powder, Salt, Brown Sugar, Walnuts, Whole Eggs, Vanilla Extract, Butter, Milk, Ripe Bananas",10,15,20,35,2,Continental,Dessert,Eggetarian
Pathare Prabhu Roath Recipe (Semolina Cake),"Sooji, Sugar, Milk, Ghee, Baking Powder, Cardamom Powder, Nutmeg, Pistachios, Raisins, Saffron Strands",10,75,25,100,2,Maharashtrian Recipes,Snack,Vegetarian
Mee Bakso Recipe - Indonesian Meatball Noodle Soup,"Hakka Noodles, Water, Garlic, Ginger, Fresh Red Chilli, Carrots, Red Bell Pepper, Green Bell Peppers, Salt, Black Pepper Powder, Soy Sauce, Spring Onion Greens, Chicken Breasts, Dry Red Chilli, Garlic",15,10,25,35,4,Asian,Appetizer,Non Vegeterian
Zesty Fish Quiche Recipe Flavored With Cheesy Garlic Mayo,"All Purpose Flour, Butter, Dried Oregano, Salt, Chilled Water, Fish Fillet, Del Monte Cheesy Garlic Mayo, Italian Seasoning, Red Chilli Flakes, Whole Eggs, Spring Onion, Extra Virgin Olive Oil, Salt, Black Pepper Powder",14,40,60,100,4,French,Appetizer,Non Vegeterian
Ice Cream Cake Recipe With Chocolate Mocha Frosting,"Whole Wheat Flour, Cocoa Powder, Instant Coffee Powder, Baking Soda, Brown Sugar, Salt, Sunflower Oil, Vanilla Extract, Vinegar, Chilled Water, Black Currant Ice Cream, Tutti Frutti Ice Cream, Chocolate Ganache, Butter, Icing Sugar, Instant Coffee Powder, Salt, Vanilla Extract, Milk",19,20,35,55,12,Continental,Dessert,Vegetarian
Spinach & Apple Salad Recipe With Orange Dressing,"Spinach Leaves, Orange, Apple, Sunflower Seeds, Orange, Lemon Juice, Tabasco Original, Salt And Pepper",8,10,10,20,4,Continental,Appetizer,Vegan
Homemade Roasted Bell Pepper Pasta Sauce Recipe,"Red Bell Pepper, Tomato, Extra Virgin Olive Oil, Garlic, Red Chilli Powder, Salt And Pepper, Dried Oregano, Red Chilli Flakes, Fresh Cream",9,5,30,35,4,Italian Recipes,Dinner,Vegetarian
Kacche Aam Ki Launji Recipe,"Mango, Mustard Oil, Asafoetida, Jaggery, Dates, Mustard Seeds, Fennel Seeds, Coriander, Methi Seeds, Kalonji, Turmeric Powder, Red Chilli Powder, Salt",13,10,30,40,6,Rajasthani,Side Dish,Vegetarian
Lemongrass Tomato Corn Soup Recipe,"Tomato, Tomato, Sweet Corn, Vegetable Stock, Red Onion, Ginger, Garlic, Extra Virgin Olive Oil, Lemongrass, Dried Oregano, Black Pepper Powder, Curry Powder, Basil Leaves, Salt And Pepper, Butter",15,15,35,50,4,Continental,Appetizer,Vegetarian
Mulangi Thoran Recipe - Radish Stir Fry With Coconut,"Mooli Mullangi, Coconut Oil, Mustard Seeds, Cumin Seeds, Curry Leaves, Turmeric Powder, Fresh Coconut, Green Chilli, Curry Leaves, Ginger, Salt, Sunflower Oil",12,10,30,40,4,Kerala Recipes,Lunch,Vegetarian
Bellada Coffee Recipe With Milk (Karnataka Style Filter Coffee With Jaggery),"Milk, Filter Coffee Powder, Water, Jaggery",4,5,10,15,2,Karnataka,Vegetarian,Vegetarian
Kadhi Pakoras ,"Flour, Green Chilli, Onion, Potato, Celery, Cooking Soda, Salt, Water, Oil, Gm Curd, Flour, Turmeric Powder, Green Chilli, Ginger, Cup Water, Salt, Ghee, Mustard, Curry Leaves, Kashmiri Red Chilli Powder, Red Chili Powder, Asafoetida, Green Coriander",23,5,10,15,2,Punjabi,Dinner,Vegetarian
Spicy Potato Wraps Recipe,"Tortillas, Potato, Dried Oregano, Dried Thyme Leaves, Black Pepper Powder, Sunflower Oil, Mint Leaves, Salt, Red Bell Pepper, Hung Curd, Red Chilli Flakes, Salt",12,5,30,35,4,Fusion,Lunch,Vegetarian
Bitter Gourd Chips Recipe,"Bitter Gourd, Rice Flour, Flour, Corn Flour, Coriander Powder, Cumin Powder, Fennel, Small Tablespoon Raw Mango, Red Chilli Powder, Turmeric Powder, Salt, Oil",12,10,10,20,4,Indian,Snack,Vegetarian
Beetroot Rosti Recipe,"Beetroot, Potato, Dill Leaves, Whole Egg, Salt, Black Pepper Powder, Whole Wheat Flour Maida, Butter Oil As Needed, Sour Cream, Dill Leaves, Spring Onion Greens",11,10,15,25,4,European,Brunch,Vegetarian
Stuffed Mushrooms With Spinach & Parmesan Recipe,"Button Mushrooms, Spinach, Onion, Garlic, Extra Virgin Olive Oil, Whole Wheat Bread Crumbs, Dried Oregano, Red Bell Pepper, Parmesan Cheese, Mozzarella Cheese, Salt",11,15,40,55,20,Continental,Appetizer,Vegetarian
Broccoli Malai Kofta Recipe,"Broccoli, Paneer, Gram Flour, Cumin Powder, Turmeric Powder, Salt, Ginger, Homemade Tomato Puree, Turmeric Powder, Coriander Powder, Red Chilli Powder, Cardamom Powder, Garam Masala Powder, Hung Curd, Honey, Kasuri Methi, Sunflower Oil, Salt",18,20,40,60,20,Lucknowi,Side Dish,No Onion No Garlic (Sattvic)
Sweet Potato Flatbread Recipe - Sweet Potato Chapati,"Sweet Potato, Ajwain, Whole Wheat Flour, Red Chilli Powder, Cumin Seeds, Salt",6,25,15,40,4,Indian,Indian Breakfast,Vegetarian
Kerala Style Appam Recipe Without Yeast,"Rice, Methi Seeds, Fresh Coconut, Cooked Rice, Sugar, Baking Soda, Salt",7,600,20,620,8,Kerala Recipes,South Indian Breakfast,Gluten Free
Senai Kizhangu Varuval Recipe,"G Suran, Turmeric Powder, Red Chilli Powder, Coriander Powder, Curry Leaves, Salt, Oil",7,15,30,45,4,South Indian Recipes,Lunch,Vegetarian
Eggless Peach Cobbler Recipe,"Peaches, Caster Sugar, Brown Sugar, Lemon Juice, Corn Flour, Cinnamon Powder, Nutmeg, All Purpose Flour, Brown Sugar, Sugar, Baking Powder, Salt, Butter, Water, Sugar, Cinnamon Powder",16,30,45,75,4,Continental,Dinner,Vegetarian
Chicken And Egg Soup Recipe,"Chicken Breasts, Leek, Button Mushrooms, Carrot, Broccoli, Chicken Stock, White Vinegar, Whole Egg, Salt And Pepper, Sunflower Oil",10,10,30,40,4,Chinese,Appetizer,Eggetarian
Tamatari Chole Recipe,"Cup Kabuli Chana, Onion, Tomato, Ginger, Garlic, Cinnamon Stick, Cardamom, Bay Leaf, Turmeric Powder, Red Chilli Powder, Garam Masala Powder, Coriander Powder, Sunflower Oil, Salt, Coriander, Onion, Tomato, Green Chilli",18,15,45,60,4,North Indian Recipes,Lunch,High Protein Vegetarian
Horsegram Dal Recipe - Kulith/Kollu Dal,"Horse Gram Dal, Water, Turmeric Powder, Salt, Ghee, Mustard Seeds, Cumin Seeds, Asafoetida, Ginger Garlic Paste, Onion, Tomato, Red Chilli Powder, Coriander Powder, Coriander",14,480,30,510,4,Indian,Lunch,High Protein Vegetarian
Herbed Muffins With Cheese Recipe,"All Purpose Flour, Sooji, Baking Powder, Baking Soda, Mixed Herbs, Pizza Seasoning, Salt, Red Chilli Flakes, Butter, Buttermilk, Mozzarella Cheese",11,10,30,40,4,Continental,Snack,Vegetarian
Broccoli Rava Idli Recipe,"Polenta, Semolina, Broccoli, Cashews, Yogurt, Water, Ginger, Asafoetida, Sprig Curry Leaves, Rye, White Urad Dal, Green Chilli, Ino Fruit Salt, Oil, Salt",15,20,10,30,4,South Indian Recipes,South Indian Breakfast,Vegetarian
Kobbari Charu Recipe - Coconut Milk & Dal Sambar Recipe,"Coconut Milk, Water, Roasted Gram Dal, Green Chilli, Sunflower Oil, Mustard Seeds, Cumin Seeds, Turmeric Powder, Curry Leaves, Salt, Coriander",11,10,40,50,4,South Indian Recipes,Lunch,High Protein Vegetarian
Eggless Dark Chocolate Cookies With Almonds Recipe,"Butter, Dark Chocolate, Condensed Milk, Almond Meal, Cocoa Powder, All Purpose Flour, White Chocolate",7,20,60,80,4,Continental,Snack,Vegetarian
Super Food Green Smoothie Recipe With Greek Yogurt Papaya Spirulina & Wheat Grass,"Soy Milk, Hung Curd, Papaya, Spirulina, Alfalfa Powder, Wheat Grass Powder, Honey, Flax Seeds, Tulsi",9,10,0,10,4,Continental,Snack,High Protein Vegetarian
Sweet Lime Soda Recipe,"Lemon Juice, Sugar, Water, Aerated Water, Cumin Powder, Black Salt, Black Pepper Powder, Mint Leaves, Ice Cubes",9,10,0,10,2,Indian,Snack,Vegetarian
Konaseema Kodi Kura Recipe - Andhra Style Chicken Curry,"Kg Chicken, Onion, Tablespoon Ginger Garlic Paste, Homemade Tomato Puree, Green Chilli, Dry Red Chilli, Poppy Seeds, Raw Peanuts, Curry Leaves, Cumin Powder, Coriander Powder, Red Chilli Powder, Garam Masala Powder, Coconut Milk, Salt, Coriander, Sunflower Oil",17,10,30,40,2,Andhra,Dinner,High Protein Non Vegetarian
Malai Kofta Curry Recipe - Creamy and Healthy Paneer Aloo Kofta Curry,"Potato, Paneer, Garam Masala Powder, Red Chilli Powder, Gram Flour, Coriander, Raisins, Salt, Sunflower Oil, Ghee, Ginger, Garlic, Onion, Homemade Tomato Puree, Coriander Powder, Garam Masala Powder, Turmeric Powder, Red Chilli Powder, Cardamom Powder, Honey, Fresh Cream, Kasuri Methi, Salt",23,20,40,60,4,North Indian Recipes,Main Course,Vegetarian
Achari Masala Powder Recipe,"Coriander, Methi Seeds, Mustard Seeds, Kalonji, Cumin Seeds, Fennel Seeds, Dry Red Chilli",7,10,5,15,4,North Indian Recipes,Main Course,Vegetarian
Konkani Style Alasande Randayi Recipe-Black Eyed Beans and Yam Gravy,"Black Eyed Beans, Elephant Yam, Turmeric Powder, Jaggery, Salt, Coriander, Dry Red Chilli, Tamarind, Fresh Coconut, Mustard Seeds, Curry Leaves, Asafoetida, Sunflower Oil",13,150,30,180,4,Konkan,Lunch,Vegetarian
Sweet And Spicy Tofu Salad With Beetroot Recipe,"Tofu, Beetroot, Onion, Tomato  Deseeded And Finely, Coriander, Green Chilli, Light Soy Sauce, Maple Syrup Honey, Balsamic Vinegar, Red Chilli Flakes",10,0,35,35,3,Continental,Dinner,High Protein Vegetarian
Madras Lamb Curry Recipe,"Coriander, Poppy Seeds, Mustard Seeds, Cumin Seeds, Fennel Seeds, Yellow Fenugreek Seeds, Cloves, Cinnamon Stick, Dry Red Chilli, Green Chilli, Garlic, Ginger, Lamb, Onion, Tomato, Mustard Seeds, Curry Leaves, Tamarind Water, Curd, Turmeric Powder, Sugar, Salt, Mustard Oil",23,30,35,65,4,South Indian Recipes,Lunch,Non Vegeterian
Moolangi Tovve Recipe - Radish Curry,"Mooli Mullangi, Yellow Moong Dal, Turmeric Powder, Green Chilli, Ginger, Fresh Coconut, Ghee, Mustard Seeds, Dry Red Chilli, Asafoetida, Coriander, Lemon Wedges",12,10,30,40,4,South Indian Recipes,Lunch,Vegetarian
Aloo Simla Mirch Ki Sabzi ,"Potato, Capsicum, Onion, Ginger, Coriander Powder, Turmeric Powder, Garam Masala Powder, Salt, Red Chili Powder, Oil, Coriander",11,10,40,50,4,Gujarati Recipesï»¿,Lunch,Vegetarian
Carrot And Broccoli Poriyal Recipe,"Carrot, Broccoli, Curry Leaves, Mustard Seeds, Cumin Seeds, Fresh Coconut, Red Chilli Powder, Turmeric Powder, Coriander Powder, Black Pepper Powder, Salt",11,10,30,40,4,Tamil Nadu,Lunch,Vegetarian
Cabbage & Buttermilk Curry Recipe,"Cabbage, Green Chilli, Mustard Seeds, Asafoetida, Turmeric Powder, Salt, Sunflower Oil, Curd, Gram Flour, Water, Salt",11,15,20,35,3,Indian,Lunch,Gluten Free
Kheel Paniyaram Recipe (Puffed Rice Paniyaram),"Puffed Rice, Sooji, Salt, Curd, Green Chilli, Green Beans, Carrot, Red Chilli Powder, Onion, Curry Leaves, Mustard Seeds, Extra Virgin Olive Oil",12,90,15,105,4,South Indian Recipes,Snack,Vegetarian
Dhaba Style Dal Fry Recipe,"Ghee, Asafoetida, Cumin Seeds, Mustard Seeds, Bay Leaf, Green Chilli, Cloves, Black Cardamom, Star Anise, Cardamom, Onion, Tomato, Ginger Garlic Paste, Red Chilli Powder, Coriander Powder, Green Chilli, Coriander, Arhar Dal, Chana Dal, Masoor Dal, White Urad Dal, Yellow Moong Dal, Water, Salt, Turmeric Powder",25,10,20,30,2,North Indian Recipes,Lunch,Vegetarian
Ragi Onion Uttapam Recipe - Wholesome Breakfast Recipe,"Ragi Dosa Batter, Carrots, Onion, Green Chilli, Coriander, Salt",6,20,30,50,6,South Indian Recipes,South Indian Breakfast,High Protein Vegetarian
Sabudana Vada Recipe - Deep Fried Sago Patties/Cutlets,"Sabudana, Potato, Roasted Peanuts, Green Chilli, Cumin Seeds, Sugar, Lemon Juice, Coriander, Salt, Sunflower Oil, Curd, Potato, Roasted Peanuts, Green Chilli, Sugar, Salt",16,15,30,45,4,Indian,Snack,Vegetarian
"Ragi, Wheat & Oat Waffles Recipe With Maple Syrup","Whole Eggs Flax Seed Egg Replacer, Milk, Sunflower Oil, Sugar, Baking Powder, Salt, Vanilla Extract, Whole Wheat Flour, Ragi Flour, Oats Flour, Maple Syrup Nutella For Serving",11,15,20,35,4,Continental,World Breakfast,Eggetarian
Oats and Vegetable Kebab Recipe,"Elephant Yam, Raw Banana, Carrots, Onion, Ginger, Garlic, Red Chilli Powder, Turmeric Powder, Cumin Powder, Coriander Powder, Amchur, Instant Oats, Milk, Salt And Pepper, Sunflower Oil",15,15,35,50,4,North Indian Recipes,Snack,Vegetarian
Chana Methi Dal ,"Chana Dal, Fenugreek, Asafoetida, Cumin Seeds, Onion, Tomato, Coriander Powder, Turmeric Powder, Red Chilli Powder, Salt, Oil",11,15,30,45,4,North Indian Recipes,Side Dish,High Protein Vegetarian
Creamy Alfredo Cauliflower Pasta Recipe,"Cauliflower, Garlic, Butter, Milk, Salt, Tagliatelle Pasta, Garlic, Rosemary, Red Chilli Flakes, Basil Leaves, Salt, Extra Virgin Olive Oil, Parsley Leaves",13,10,30,40,4,Italian Recipes,Lunch,Vegetarian
Nolen Gurer Payesh Recipe,"Basmati Rice, Milk, Bay Leaf, Cardamom, Nolen Gur, Mixed Nuts",6,30,30,60,4,Bengali Recipes,Dessert,Vegetarian
Akuri Recipe (Parsi Style Seasoned Scrambled Eggs),"Whole Eggs, Onion, Tomato, Green Chilli, Garlic, Butter, Fresh Cream, Salt, Coriander",9,10,20,30,4,Parsi Recipes,North Indian Breakfast,Eggetarian
Gujarati Mooli Bajra Muthia Recipe - Radish And Bajra-Besan Dmplings,"Mooli Mullangi, Mooli Ke Patte, Bajra Flour, Whole Wheat Flour, Gram Flour, Ajwain, Coriander Powder, Cumin Powder, Asafoetida, Turmeric Powder, Green Chilli Paste Red Chilli Powder, Ginger Garlic Paste, Coriander, Sunflower Oil, Lemon Juice, Sugar, Salt, Sunflower Oil, Cumin Powder, Fennel Seeds, Sesame Seeds, Curry Leaves",22,15,30,45,4,Gujarati Recipesï»¿,Snack,Vegetarian
Spicy Chana Chaat Frankie Recipe,"Whole Wheat Flour, Salt, Kabuli Chana, Ginger, Garlic, Red Chilli Powder, Turmeric Powder, Cumin Powder, Chaat Masala Powder, Sugar, Salt, Onion, Tomato, Green Chilli, Coriander",15,10,45,55,4,North Indian Recipes,Snack,Vegetarian
Chow Chow Milagu Kootu Recipe-Chayote Squash Cooked in Peppery Lentil Curry,"Chow Chow, Mustard Seeds, Curry Leaves, Dry Red Chilli, Yellow Moong Dal, Asafoetida, Turmeric Powder, Whole Black Peppercorns, Cumin Seeds, White Urad Dal, Fresh Coconut, Sunflower Oil, Salt",13,10,15,25,4,South Indian Recipes,Dinner,Vegetarian
Panjiri Recipe - Healthy Punjabi Dry Fruit Snack,"Ghee, Whole Wheat Flour, Chiroti Rava, Sugar, Gond, Phool Makhana, Badam, Cashew Nuts, Pistachios, Dry Coconut, Melon Seeds, Flax Seeds, Poppy Seeds, Dry Ginger Powder, Nutmeg Powder, Cardamom Powder",16,10,25,35,6,Punjabi,Snack,Vegetarian
Overnight Oats Recipe (No Cook Blueberry Vanilla and Chia seeds Oatmeal),"Rolled Oats, Milk, Blueberries, Chia Seeds, Honey, Badam, Drops Vanilla Extract, Salt",8,370,5,375,1,Continental,World Breakfast,Gluten Free
Matar Poha ,"Poha, Green Peas, Onion, Green Chilli, Turmeric Powder, Mustard, Cumin Seeds, Curry Leaves, Asafoetida, Salt, Coriander, Lemon Juice",12,15,10,25,4,North Indian Recipes,North Indian Breakfast,Vegetarian
Baked Lebanese Pumpkin Kibbi Recipe,"Kaddu, Bulgur Wheat, Whole Wheat Flour, Sea Salt, Black Pepper Powder, Tablespoons Extra Virgin Olive Oil, Extra Virgin Olive Oil, Spinach Leaves, Onion, Walnuts Pine Nuts, Lemon Juice, Red Chilli Flakes, All Spice Powder, Salt",14,20,40,60,4,Middle Eastern,Appetizer,Vegetarian
Cheese Garlic Naan Recipe,"All Purpose Flour, Whole Wheat Flour, Curd, Active Dry Yeast, Salt, Garlic, Coriander, Butter, Sunflower Oil, Cheese, Garlic, Butter Smear On The Naans",12,30,15,45,4,North Indian Recipes,Main Course,Vegetarian
Andhra Style Green Chilli Chicken Recipe,"Chicken, Curd, Ginger, Garlic, Green Chilli Paste, Turmeric Powder, Salt, Coriander, Curry Leaves, Onion, Ghee, Green Chilli, Curry Leaves, Soy Sauce, Salt",15,60,15,75,2,Andhra,Dinner,High Protein Non Vegetarian
Paneer Biryani Recipe,"Basmati Rice, Paneer, Onion, Tomato, Ginger, Garlic, Green Chilli, Red Chilli Powder, Turmeric Powder, Coriander Powder, Cloves, Cinnamon Stick, Cardamom, Bay Leaves, Whole Black Peppercorns, Mint Leaves, Ghee, Salt, Sunflower Oil",19,10,45,55,4,Indian,Lunch,High Protein Vegetarian
Ilish Pulao Recipe - Bengali Style Hilsa Fish Pilaf,"Hilsa Fish, Onion, Onion, Ginger Garlic Paste, Red Chilli Powder, Green Chilli, Mishti Doi, Coconut Milk, Ghee, Salt, Rice, Coconut Milk, Green Chilli, Ghee, Salt, Lukewarm Water, Bay Leaf, Cinnamon Stick, Cardamom, Cloves",20,5,45,50,4,Bengali Recipes,Main Course,High Protein Non Vegetarian
Nihari Gosht Recipe,"Mutton, Onion, Ginger, Garlic, Turmeric Powder, Homemade Tomato Puree, Bay Leaf, Water, Curd, Sunflower Oil, Ghee, Ginger, Nutmeg Powder, Mace Powder, Cinnamon Stick, Black Pepper Powder, Bay Leaf, Black Cardamom, Red Chilli Powder",19,15,40,55,3,Awadhi,Lunch,High Protein Non Vegetarian
Nankhatai Recipe - A Spiced Eggless Indian Cookie,"All Purpose Flour, Sooji, Gram Flour, Baking Powder, Salt, Caster Sugar, Ghee, Cardamom Powder, Curd, Ghee",10,20,30,50,4,Indian,Snack,Vegetarian
Chickpea Flour Crepes Recipe With Salad And Chutney Spread,"Gram Flour, Hung Curd, Ajwain, Red Chilli Powder, Garam Masala Powder, Salt, Green Bell Pepper, Carrot, Yellow Zucchini, Onion, Sunflower Oil, Dried Oregano, Salt, Coriander, Mint Leaves, Garlic, Lemon Juice, Green Chilli, Salt",19,10,20,30,4,Continental,World Breakfast,Gluten Free
Tamil Nadu Style Paneer Kurma Recipe,"Bay Leaves, Fennel Seeds, Cinnamon Stick, Cloves, Cardamom, Star Anise, Fresh Coconut, Poppy Seeds, Ginger, Tomato, Pearl Onion, Green Chilli, Turmeric Powder, Garam Masala Powder, Red Chilli Powder, Coriander Powder, Salt, Sunflower Oil",18,10,35,45,4,Tamil Nadu,Lunch,High Protein Vegetarian
Pudina Buttermilk Recipe,"Curd, Mint Leaves, Ginger, Cumin Seeds",4,10,0,10,4,North Indian Recipes,Appetizer,Vegetarian
Mushroom And Quail Egg Gougere Recipe,"All Purpose Flour, Whole Eggs, Butter, Water, Cheddar Cheese, Button Mushrooms, Butter, Onion, Garlic, Salt, Soy Sauce, Balsamic Vinegar, Spring Onion, Red Chilli Flakes, Coriander, Quail Eggs",16,10,75,85,2,French,World Breakfast,Eggetarian
Kashmiri Paneer Gravy Recipe,"Paneer, Tomato, Kashmiri Dry Red Chilli, Asafoetida, Cumin Seeds, Fennel Seeds, Dry Ginger Powder, Turmeric Powder, Garam Masala Powder, Ghee, Bay Leaf, Black Cardamom, Cardamom Powder, Cinnamon Stick, Mustard Oil Oil Of Your Choice, Water",16,10,15,25,4,Kashmiri,Main Course,Vegetarian
Spicy Onion Tomato Masala Sandwich Recipe,"Whole Wheat Brown Bread, Butter, Extra Virgin Olive Oil, Onion, Tomato, Green Chilli, Salt, Chaat Masala Powder, Red Chilli Powder, Lemon Juice",10,10,30,40,4,Fusion,Snack,Vegetarian
Chickpea Soup Recipe,"Of Chickpea Chickpeachickpeas, Onion, Ginger Garlic Paste, Basil Powder Oregano, Red Chili Flakes, Black Pepper Powder, Turmeric Powder, Oil, Lemon Juice, Salt",10,15,20,35,4,North Indian Recipes,Dinner,High Protein Vegetarian
Crispy Oven Roasted Curried Chickpeas Recipe,"Kabuli Chana, Cumin Powder, Kashmiri Red Chilli Powder, Turmeric Powder, Garam Masala Powder, Coriander Powder, Garlic Powder, Dry Ginger Powder, Salt, Extra Virgin Olive Oil",10,20,160,180,4,Indian,Snack,High Protein Vegetarian
Rose Flavoured Shahi Tukda Recipe,"Whole Wheat Brown Bread, Ghee, Sugar, Water, Rose Water, Milk, Sugar, Cardamom Powder, Rose Essence, Rose Petals Garnish, Pistachios",11,10,20,30,2,Hyderabadi,Dessert,Vegetarian
Watermelon Rasam Recipe,"Watermelon, Tamarind Water, Arhar Dal, Garlic, Rasam Powder, Turmeric Powder, Red Chilli Powder, Asafoetida, Whole Black Peppercorns, Cumin Seeds, Ghee, Mustard Seeds, Curry Leaves, Coriander, Lemon, Salt",16,5,15,20,4,South Indian Recipes,Lunch,Vegetarian
Bannada Saute Majjige Huli Recipe (Malabar Cucumber Mor Kuzhambu),"Fresh Coconut, Poha, Green Chilli, Curd, Mangalorean Cucumber Bannada Sautekaisambar Cucumber, Sunflower Oil, Methi Seeds, Mustard Seeds, Dry Red Chilli, Curry Leaves",10,10,30,40,4,Malabar,Lunch,Vegetarian
Papaya Sorbet Recipe,"Papaya, Fresh Cream, Honey, Chia Seeds, Fresh Pomegranate Fruit Kernels",5,630,0,630,4,Continental,Dessert,Vegetarian
Tamatar Gosht Recipe-Mutton In Tomato Curry,"Mutton, Onion, Garlic  Paste, Ginger, Green Chilli, Tomato, Coriander Powder, Red Chilli Powder, Turmeric Powder, Salt, Mustard Oil, Coriander, Bay Leaf, Cinnamon Stick, Cloves, Whole Black Peppercorns, Cardamom, Black Cardamom, Ajwain, Mace",20,10,40,50,4,North Indian Recipes,Dinner,Non Vegeterian
Masala Chaas Recipe,"Curd, Cumin Powder, Chaat Masala Powder, Black Saltrock Salt, Ginger, Green Chili, Asafetida, Salt, Mint Leaves, Coriander Leaves, Water  Cold",11,10,0,10,4,Indian,Snack,Vegetarian
Karnataka Style Harive Soppu Bendi Recipe (Amaranth Leaves Cooked in Coconut Broth),"Green Amaranth Leaves, Fresh Coconut, Cumin Seeds, Green Chilli, Jaggery, Mustard Seeds, White Urad Dal, Dry Red Chilli, Asafoetida, Curry Leaves, Sunflower Oil, Salt",12,10,10,20,4,Karnataka,Side Dish,High Protein Vegetarian
Matar Masala Recipe,"Green Peas, Oil, Cumin, Turmeric Powder, , Coriander Powder, Kasoori Methi, Salt, Garam Masala Powder, Onion, Tomato, Green Chilli, Bud Garlic, Ginger, Cashews, Almond Milk Water",16,20,30,50,3,Indian,Lunch,Vegetarian
Pesara Pappu Pulusu Recipe,"Yellow Moong Dal, Water, Tamarind Paste, Tomato, Green Chilli, Curry Leaves, Sunflower Oil, Mustard Seeds, Cumin Seeds, Dry Red Chilli, Asafoetida, Turmeric Powder, Salt",13,5,20,25,2,Andhra,Side Dish,Vegetarian
Moong Bhajji Recipe-Moong Fritters,"Yellow Moong Dal, Onion, Garlic, Cumin Seeds, Asafoetida, Ginger, Green Chilli, Coriander, Salt, Sunflower Oil",10,10,30,40,3,Indian,Snack,High Protein Vegetarian
à¤à¤¿à¤à¥à¥ à¤°à¥à¤à¥ ,"Khichdi  Premade, Rice Flour, Oil, Onion, Salt",5,0,15,15,4,Indian,Indian Breakfast,Vegetarian
Kumror Chokka Recipe - Kaddu Kala Chana Sabzi | Pumpkin Chickpea Curry,"Mustard Oil, Asafoetida, Mustard Seeds, Kalonji, Bay Leaf, Ginger, Green Chilli, Dry Red Chilli, Kala Chana, Potato, Kaddu, Tomato, Turmeric Powder, Panch Phoran Masala, Salt, Jaggery",16,120,30,150,6,Bengali Recipes,Lunch,High Protein Vegetarian
Spicy Jalapeno Scrambled Eggs Recipe,"Whole Eggs, Sunflower Oil, Onion, Cherry Tomato, Pickled Jalapenos, Whole Black Peppercorns, Salt, Coriander",8,10,15,25,2,Mexican,World Breakfast,Eggetarian
"Oats, Peas & Tofu Stuffed Paratha Recipe","Tofu, Red Bell Pepper, Green Peas, Instant Oats, Onion, Ginger, Garlic, Green Chilli, Turmeric Powder, Red Chilli Powder, Amchur, Coriander Powder, Salt, Whole Wheat Flour, Salt, Sunflower Oil, Water",17,10,35,45,4,North Indian Recipes,Lunch,High Protein Vegetarian
Plum Galette Recipe With A Flaky Whole Wheat Pie Crust,"Whole Wheat Flour, All Purpose Flour, Butter, Salt, Chilled Water, Plums, Corn Flour, Caster Sugar, Vanilla Ice Cream Whipped Creamserve With",9,15,90,105,4,French,Dessert,Vegetarian
Vadyancho Ross Recipe (Ash Gourd Chips Curry),"Ash Gourd Chips, Coconut Oil, Cup Fresh Coconut, Whole Black Peppercorns, Coriander, Turmeric Powder, Dry Red Chilli, Tamarind",8,10,10,20,2,Goan Recipes,Lunch,Vegetarian
Kadale Chutney Recipe - Fried Gram Chutney,"Fresh Coconut, Coriander, Roasted Gram Dal, Green Chilli, Tamarind Paste, Sugar, Salt, Sunflower Oil, Mustard Seeds, Asafoetida, White Urad Dal, Dry Red Chilli, Curry Leaves",13,15,5,20,5,South Indian Recipes,Side Dish,Vegetarian
Spicy Potato Roast Recipe ,"Potato, Asafoetida, Rye, Cumin Seeds, Turmeric Powder, Red Chilli Powder, Curry Leaves, Oil",8,10,30,40,4,South Indian Recipes,Lunch,Vegetarian
Roasted Tomato And Mozzarella Caprese Salad With Basil Balsamic Vinegar Recipe,"Tomato, Mozzarella Cheese, Basil Leaves, Rosemary, Garlic, Lemon Juice, Black Pepper Powder, Paprika Powder, Tablespoon Balsamic Vinegar, Extra Virgin Olive Oil, Sea Salt",11,5,10,15,2,Italian Recipes,Side Dish,Vegetarian
Sichuan Dan-Dan Noodles Recipe (Sesame Noodles With Crispy Tofu Recipe),"Egg Noodles, Garlic, Ginger, Stalks Spring Onion Greens, Dry Red Chilli, Red Bell Pepper, Onion, Tofu, Red Chilli Sauce, Soy Sauce, Vinegar, Peanut Butter, Sesame, Honey, Sesame Seeds",15,10,30,40,4,Sichuan,Main Course,Vegetarian
Spaghetti Pasta Recipe in Basil Pesto Sauce,"Spaghetti Pasta Any Other Pasta, Extra Virgin Olive Oil, Red Chilli Flakes, Black Olives, Fresh Cream, Milk, Salt, Garlic, Basil Leaves, Walnuts, Extra Virgin Olive Oil, Cumin Powder, Red Chilli Powder, Salt",14,20,40,60,4,Italian Recipes,Dinner,Vegetarian
Chicken Xacuti Recipe - Goan Chicken Gravy,"Chicken, Tamarind Water, Salt, Sunflower Oil, Onion, Ginger  Finely, Garlic, Kashmiri Dry Red Chilli, Fresh Coconut, Poppy Seeds, Cloves, Cinnamon Stick, Black Pepper Corns, Cumin Seeds, Coriander Seeds, Fennel Seeds, Turmeric Powder, Sesame Seeds, Methi Seeds, Sunflower Oil",20,10,45,55,4,Goan Recipes,Lunch,High Protein Non Vegetarian
Punjabi Mixed Vegetable Kadai Recipe,"Potato, Baby Corn, Carrot, Green Beans, Cauliflower, Green Peas, Green Bell Pepper, Onion, Bay Leaf, Cumin Seeds, Garam Masala Powder, Kasuri Methi, Turmeric Powder, Sugar, Salt, Fresh Cream, Butter, Tomato, Onion, Ginger, Green Chilli, Garlic, Coriander, Dry Red Chilli, Cinnamon Stick, Cloves, Cardamom",27,20,15,35,4,Punjabi,Dinner,High Protein Vegetarian
Soya Chunks Sabzi ,"Soy Chunks, Water, Onion, Garlic, Ginger, Tomato, Red Chili Powder, Garam Masala Powder, Chaat Masala Powder, Salt, Lemon Juice, Green Coriander",12,10,20,30,3,Indian,Lunch,High Protein Vegetarian
Veg Makhanwala Recipe,"Butter, Salt, Carrots, Capsicum, Green Beans, Baby Corn, Cabbage, Butter, , Cardamom, Cinnamon, Dry Kashmiri Chilli, Coriander Seeds, Whole Black Pepper, Cashew Nuts, Garlic, Ginger, Green Chilli, Onion, Salt, Kashmiri Red Chilli Powder, Turmeric Powder, Cumin Powder, Hot Masala Powder, Tomato Puree, Cream, Butter",27,15,30,45,4,North Indian Recipes,Lunch,Vegetarian
Goan Vegetable Curry Recipe,"Mixed Vegetables, Onion, Salt, Turmeric Powder, Green Chilli, Coconut Oil, Fresh Coconut, Kashmiri Dry Red Chilli, Whole Black Peppercorns, Onion, Garlic, Coriander, Cumin Seeds, Tamarind",14,15,20,35,4,Goan Recipes,Lunch,Vegetarian
Chicken Rendang Recipe - Malaysian-Indonesian Chicken Stew,"Chicken Breasts, Sunflower Oil, Cinnamon Stick, Cardamom, Cloves, Star Anise, Stalk Lemon Grass, Coconut Milk, Salt, Fresh Coconut, Onion, Garlic, Ginger Galangal, Stalk Lemon Grass, Dry Red Chilli",15,10,20,30,4,Malaysian,Main Course,High Protein Non Vegetarian
Chocolate And Oats Christmas Cookie Cake Recipe,"Instant Oats, Chocolate Chips, Butter, Raisins, Pitted Cherries, Milk, Vanilla Extract, Condensed Milk, Pitted Cherries, Kiwi, Chocolate Chips",11,45,15,60,8,Continental,Dessert,Vegetarian
Nepalese Mutton Curry Recipe,"Mutton, Onion, Tomato, Cloves, Ginger Garlic Paste, Cardamom, Cinnamon Stick, Bay Leaves, Meat Masala, Garam Masala Powder, Methi Seeds, Red Chilli Powder, Turmeric Powder, Sunflower Oil, Salt",15,15,40,55,4,Nepalese,Dinner,Non Vegeterian
Beetroot Stew with Coconut Milk Recipe (With a South Indian Flavor),"Beetroot, Ginger, Green Chilli, Cinnamon Stick, Coriander Powder, Coconut Milk, Mustard Seeds, White Urad Dal, Curry Leaves, Sunflower Oil",10,20,30,50,4,South Indian Recipes,Side Dish,Vegetarian
Stuffed Jacket Potatoes Recipe,"Potato, Cheese, Black Olives, Sweet Corn, Italian Seasoning, Black Pepper Powder, Parsley Leaves, Salt",8,15,20,35,4,Continental,Snack,Vegetarian
Palak Puri Recipe (Crispy Spinach Puri Snack),"Whole Wheat Flour, Spinach Leaves, Ginger, Green Chilli, Ghee Butter, Salt",6,10,20,30,10,North Indian Recipes,Snack,Vegetarian
Guilt Free Fruit Cream Recipe,"Hung Curd, Coconut Milk, Honey, Apple, Ripe Bananas, Mango, Guava, Lemon Juice, Pistachios",9,15,10,25,2,Continental,Dessert,Vegetarian
Greek Style Gigantes Plaki Recipe-Oven Baked Broad Beans with Vegetables,"White Broad Beans, Yellow Zucchini, Carrot, Onion, Celery, Garlic, Homemade Tomato Puree, Sugar, Dried Oregano, Cinnamon Powder, Bay Leaf, Parsley Leaves, Parsley Leaves",13,260,45,305,4,Greek,Dinner,Vegetarian
Laal Maas Biryani Recipe,"Mutton, Curd, Cumin Powder, Coriander Powder, Ginger Garlic Paste, Salt, Kashmiri Dry Red Chilli, Cumin Seeds, Black Cardamom, Cardamom, Cinnamon Stick, Cloves, Bay Leaf, Ghee, Onion, Garam Masala Powder, Salt, Coriander, Charcoal, Ghee, Bay Leaf, Kashmiri Dry Red Chilli, Black Cardamom, Cardamom, Cinnamon Stick, Cloves, Onion, Ginger, Garlic, Salt, Green Chilli, Coriander, Kashmiri Red Chilli Powder, Turmeric Powder, Basmati Rice, Coriander, Mint Leaves",37,30,60,90,8,Rajasthani,Main Course,Non Vegeterian
Makhana Badam Mixture Recipe - Healthy Snack/ Trail Mix,"Badam, Phool Makhana, Sunflower Seeds, Ghee, Salt, Jaggery",6,5,25,30,4,Fusion,Snack,High Protein Vegetarian
Ridge Gourd Pachadi Recipe - Ridge Gourd Chutney,"Ridge Gourd, Green Chilli, Tamarind Paste, Garlic, Cumin Seeds, Salt, Sunflower Oil",7,15,15,30,5,South Indian Recipes,Side Dish,Vegetarian
Kashmiri Style Rista Recipe - Mutton Kofta Curry,"Mutton Kheema, Onion, Green Chilli, Garlic, Ginger, Cardamom Powder, Cloves, Cinnamon Stick, Fennel Seeds, Salt, Onion, Tomato, Cumin Seeds, Garlic, Ginger, Green Chilli, Red Chilli Powder, Turmeric Powder, Salt",19,10,60,70,4,Kashmiri,Lunch,Non Vegeterian
Ayala Fish Fry Recipe,"Fish, Red Chilli Powder, Turmeric Powder, Fennel Powder, Black Pepper Powder, Ginger Garlic Paste, Lemon Juice, Salt, Sunflower Oil",9,15,20,35,2,South Indian Recipes,Side Dish,High Protein Non Vegetarian
Irish Cream Bundt Cake Recipe,"All Purpose Flour, Butter, Caster Sugar, Whole Eggs, Baking Powder, Instant Coffee Powder, Vanilla Extract, Baileys Irish Cream, Milk, Icing Sugar, Baileys Irish Cream",11,15,60,75,4,Dessert,Vegetarian,High Protein Non Vegetarian
Aubergine in Spicy Peanut Sauce Recipe,"Brinjal, Raw Peanuts, Fresh Coconut, Galangal Ginger, Ginger, Coriander, Green Chilli, Sunflower Oil, Salt",9,15,20,35,4,Thai,Dinner,Vegetarian
Paneer Cheese Puffs Recipe,"All Purpose Flour, Butter, Salt, Chilled Water, Paneer, Cheese, Onion, Salt And Pepper, Coriander, Milk, Sesame Seeds",11,50,10,60,4,Fusion,Appetizer,Vegetarian
Rajasthani Kadhi Recipe,"Ghee, Mustard Seeds, Methi Seeds, Asafoetida, Dry Red Chilli, Curry Leaves, Gram Flour, Curd, Turmeric Powder, Red Chilli Powder, Water, Garlic, Green Chilli, Salt",14,10,30,40,4,Rajasthani,Lunch,Vegetarian
Matkiche Vade Recipe - Moth Beans Fritters,"Moth Dal, Onion, Coriander, Green Chilli, Ginger, Cumin Seeds, Asafoetida, Gram Flour, Rice Flour, Salt, Lemon, Sunflower Oil Deep Fry",12,20,30,50,4,Maharashtrian Recipes,Snack,Vegetarian
Halloumi Bruschetta Recipe with Tomato and Roasted Red Capsicum,"Halloumi Cheese, Tomato, Red Bell Pepper, Extra Virgin Olive Oil, Parsley Leaves, Salt, Black Pepper Powder, Clove Garlic, French Loaf",9,10,30,40,2,Fusion,Appetizer,Vegetarian
Egg Kothu Paratha Recipe,"Leftover Roti, Sunflower Oil, Mustard Seeds, Ssp Asafoetida, Onion, Garlic, Ginger, Green Chilli, Curry Leaves, Tomato, Turmeric Powder, Red Chilli Powder, Black Pepper Powder, Garam Masala Powder Egg Curry Masala, Whole Eggs, Coriander, Salt, Lemon",18,10,30,40,4,Indian,Indian Breakfast,Eggetarian
Moru Kachiyathu Recipe - Kerala Style Seasoned Buttermilk,"Curd, Water, Shallots, Ginger, Garlic, Green Chilli, Turmeric Powder, Mustard Seeds, Methi Seeds, Curry Leaves, Dry Red Chilli, Coconut Oil, Salt",13,10,10,20,4,Kerala Recipes,Side Dish,Vegetarian
Dal Vada with Oats and Vegetable Recipe,"Chana Dal, White Urad Dal, Instant Oats, Green Chilli, Onion, Carrot, Cabbage, Garlic, Curry Leaves, Coriander, Salt",11,20,30,50,4,Tamil Nadu,Appetizer,Vegetarian
Maharastrian Varan Phal Recipe,"Wheat Flour, Oil, Celery, Salt, Arhar Dal, Red Chilli Powder, Coriander Powder, Turmeric Powder, Rye, Oil, Kokum, Sugar, Water   Onion, As Per Use",14,10,40,50,4,Maharashtrian Recipes,Lunch,Vegetarian
Asian Style Bean Sprout & Corn Salad Recipe,"Bean Sprouts, Star Fruit, Sweet Corn, Red Bell Pepper, Spring Onion, Iceberg Lettuce, Lemon, Mustard Sauce, Sesame, Soy Sauce, Honey, Sesame Seeds, Red Chilli Flakes, Dry Red Chilli, Garlic Powder, Salt",16,30,0,30,3,Continental,Appetizer,High Protein Vegetarian
Tres Leches Recipe - Mexican Three Milk Cake,"All Purpose Flour, Baking Powder, Salt, Caster Sugar, Whole Eggs, Sunflower Oil, Vanilla Extract, Milk, Milk, Condensed Milk, Fresh Cream, Double Cream, Icing Sugar, Vanilla Extract",14,20,50,70,8,Mexican,Dessert,Eggetarian
Vegan Chocolate Mocha Banana Cake Recipe,"Whole Wheat Flour, Brown Sugar, Cocoa Powder, Baking Soda, Instant Coffee Powder, Salt, Sunflower Oil, Vanilla Extract, Vinegar, Water, Ripe Bananas, Chocolate Chips",12,15,40,55,8,Continental,Dessert,Vegan
Baked Jaggery Rasgulla Recipe,"Rasgulla, Paneer, Milk, Palm Jaggery, Condensed Milk, Saffron Strands, Pistachios, Brown Sugar",8,10,30,40,4,Oriya Recipes,Dessert,Vegetarian
Crispy Corn And Bell Peppers Chaat Recipe,"Sweet Corn, All Purpose Flour, Corn Flour, Rice Flour, Black Pepper Powder, Salt, Sunflower Oil Deep Fry, Green Bell Pepper, Onion, Green Chilli, Sweet Chutney, Green Chutney, Chaat Masala Powder, Red Chilli Powder, Black Salt, Lemon Juice, Coriander",17,15,15,30,2,Indian,Snack,Vegetarian
Aloo Gobi Methi Tuk ,"à¤à¤²à¥, à¤à¤ª à¤à¥à¤­à¥, à¤à¤ª à¤®à¥à¤¥à¥, à¤¤à¥à¤², à¤à¥à¤à¤¾ à¤à¤®à¤à¥à¤ à¤à¥à¤°à¤¾, à¤¹à¥à¤à¤, à¤à¥à¤à¤¾ à¤à¤®à¤à¥à¤ à¤à¤¦à¤°à¤, à¤à¥à¤à¤¾ à¤à¤®à¤à¥à¤ à¤¹à¤°à¥ à¤®à¤¿à¤°à¥à¤, à¤à¥à¤à¤¾ à¤à¤®à¤à¥à¤ à¤à¤¾à¤ à¤®à¤¸à¤¾à¤²à¤¾ à¤ªà¤¾à¤à¤¡à¤°, à¤¨à¤®à¤",10,15,20,35,4,Sindhi,Appetizer,Vegetarian
"Gujarati Badshahi Pulao Recipe - A Rich Preparation Of Rice, Vegetables, Nuts And Spices","Basmati Rice, Carrots, Green Beans, Cauliflower, Green Peas, Tomato, Onion, Ginger, Garlic, Green Chilli, Turmeric Powder, Cardamom, Cloves, Cinnamon Stick, Bay Leaf, Whole Black Peppercorns, Badam, Cashew Nuts, Raisins, Ghee, Mint Leaves, Salt",22,20,30,50,4,Gujarati Recipesï»¿,Lunch,Vegetarian
Homemade Sev Recipe - Gram Flour Vermicelli Snack,"Gram Flour, Asafoetida, Turmeric Powder, Sunflower Oil, Water, Salt, Sunflower Oil",7,20,40,60,6,Indian,Snack,Vegetarian
Masala French Toast Recipe,"Whole Wheat Brown Bread, Whole Eggs, Milk, Red Chilli Powder, Butter, Salt And Pepper, Tomato, Onion, Green Chilli, Chaat Masala Powder, Coriander",11,10,30,40,4,Fusion,World Breakfast,Eggetarian
Raw Banana Thoran Recipe,"Raw Banana, Coconut Oil, Mustard Seeds, Dry Red Chilli, Curry Leaves, Pearl Onion, Garlic, Turmeric Powder, Fresh Coconut, Green Chilli, Coriander, Salt",12,10,15,25,4,Kerala Recipes,Lunch,Vegetarian
Hunan Style Smacked Cucumber Pickles Recipe,"Cucumber, Garlic, Caster Sugar, Light Soy Sauce, Vinegar, Chilli Oil, Red Chilli Sauce, Salt",8,5,15,20,5,Chinese,Side Dish,Vegetarian
Creamy Kulfi Kebab Recipe With Tandoori Mayo Recipe,"Chicken Wings, Del Monte Tandoori Mayo, Cheese, Fresh Cream, Ginger, Garlic, Lemon Juice, Curd, Mustard Oil, Salt, Banana Leaf",11,30,30,60,4,North Indian Recipes,Appetizer,Vegetarian
Spinach Sun Dried Tomato Pasta Recipe,"Conchiglie Pasta, Spinach Leaves, Sun Dried Tomato, Green Zucchini, Tomato, Garlic, Salt, Red Chilli Flakes, Mixed Herbs, Fresh Cream, Parsley Leaves",11,10,25,35,4,Italian Recipes,Dinner,High Protein Vegetarian
Moong Dal Sookhi Sabzi Recipe,"Yellow Moong Dal, Red Chilli Powder, Turmeric Powder, Garam Masala Powder, Salt, Sunflower Oil, Green Chilli, Lemon Juice, Coriander",9,10,20,30,2,North Indian Recipes,Dinner,High Protein Vegetarian
Gajar Vadi Recipe,"Carrots, , Wheat Flour, Turmeric Powder, Cumin Powder, Curd, Small Tablespoon Oil, Lemon Juice, Sugar, Salt, Oil, Sesame Seeds, Mustard, Cumin Seeds, Asafoetida, Curry Leaves, Green Chili",17,15,20,35,2,Maharashtrian Recipes,Side Dish,Vegetarian
Broccoli And Aloo Poriyal Recipe ,"Broccoli, Potato, Mustard, Clove Curry Leaves, Red Chilli Powder, Turmeric Powder, Salt",7,20,15,35,4,South Indian Recipes,Lunch,Vegetarian
Frozen Strawberry Yogurt With Honey Recipe,"Strawberries, Hung Curd, Honey",3,10,360,370,3,Continental,Dessert,Vegetarian
"Roasted Cauliflower, Celery And Carrot Creamy Vegetable Soup Recipe","Cauliflower, Carrots, Stalks Celery, Extra Virgin Olive Oil, Butter, Onion, Garlic, Cumin Powder, Paprika Powder, Red Chilli Flakes, Palm Sugar, Vegetable Stock, Milk, Salt And Pepper",14,15,20,35,4,Continental,Appetizer,Vegetarian
Bengali Chapor Ghonto Recipe-Moong Dal With Vegetables,"Yellow Moong Dal, Dry Red Chilli, Ginger, Salt, Mustard Oil, Ghee, Panch Phoran Masala, Bay Leaves, Dry Red Chilli, Potato, Small Green Brinjal, Bottle Gourd, Carrot, Sugar, Turmeric Powder, Chana Dal, Salt, Coriander",18,180,45,225,4,Bengali Recipes,Dinner,Vegetarian
Simple Steamed Indian Beet Salad Recipe,"Beetroots, Salt, Black Pepper Powder Sprinkle, Cumin Powder, Lemon Juice, Chaat Masala Powder Sprinkle",6,5,20,25,4,Indian,Appetizer,Vegetarian
Bhindi And Paneer Masala Recipe,"Bhindi, Paneer, Onion, Bay Leaf, Red Chilli Powder, Turmeric Powder, Coriander Powder, Sugar, Salt, Sunflower Oil, Tomato, Cloves, Cinnamon Stick, Cardamom, Garlic, Ginger, Hung Curd",17,10,30,40,4,North Indian Recipes,Side Dish,Vegetarian
Caramelized Onion Tart with Ricotta Cheese Recipe,"All Purpose Pie Crust, Onion, Ricotta Cheese, Red Chilli Flakes, Salt And Pepper, Extra Virgin Olive Oil",6,120,30,150,6,French,Appetizer,Vegetarian
Assamese Machor Tenga Anja Recipe - Fish Curry With Kokum,"Rohu Fish Any Fresh Water Fish Like Catla, Kokum, Methi Seeds, Mustard Oil, Turmeric Powder, Hot Water, Salt, Tomato, Elephant Yam, Green Chilli, Garlic",11,15,25,40,2,Assamese,Side Dish,High Protein Non Vegetarian
Quick Chocolate Pudding Recipe,"Milk, Sugar, Cocoa Powder, Corn Flour, Egg Yolks, Vanilla Extract, Chocolate Shavings",7,0,30,30,4,Continental,Dessert,Eggetarian
Kerala Thenga Chammanthi Recipe- Coconut Onion Chutney,"Fresh Coconut, Shallots, Tamarind, Dry Red Chilli, Ginger, Dry Red Chilli, Curry Leaves, Salt",8,5,0,5,4,Kerala Recipes,Side Dish,Vegetarian
Potato Onion Cheela Recipe,"Potato, Onion, Gram Flour, Whole Wheat Flour, Red Chilli Powder, Salt, Cumin Powder, Black Pepper Powder, Water, Nutralite Garlic & Oregano Spread",10,10,15,25,4,Indian,North Indian Breakfast,Vegetarian
Pumpkin Dal With Garlic Tadka ,"Arhar Dal, Yellow Moong Dal, Masoor Dal, Ginger, Green Chilli, Lentil Sugar, Bay Leaf, Tomato  Finely  Take  Of Pumpkin, Peel And Chop, Salt, Oil, Turmeric Powder, Ghee, Cumin Seeds, Bud Garlic, Dry Red Chilli",16,15,30,45,4,North Indian Recipes,Dinner,Diabetic Friendly
Nawabi Mixed Vegetable Gravy Recipe,"Cauliflower, Green Beans, Carrots, Green Peas, Bay Leaf, Cloves, Cinnamon Stick, Onion, Tomato, Green Chilli, Coriander Powder, Red Chilli Powder, Garam Masala Powder, Coriander, Ghee, Cashew Nuts, Onion, Tomato, Garlic, Ginger, Cumin Seeds",21,30,30,60,4,North Indian Recipes,Lunch,Vegetarian
Cauliflower Leaves Chutney Recipe,"Cauliflower Leaves, Tomato, Tamarind, White Urad Dal, Dry Red Chilli, Salt, Asafoetida, Garlic, Turmeric Powder, Sunflower Oil, Mustard Seeds, Cumin Seeds, Curry Leaves",13,5,20,25,4,South Indian Recipes,Side Dish,Vegetarian
Lobia Kebabs Recipe (Black Eyed Bean Patties),"Black Eyed Beans, Instant Oats, Onion, Red Bell Pepper, Green Chilli, Mint Leaves, Coriander, Clove Garlic, Red Chilli Powder, Cumin Powder, Garam Masala Powder, Salt, Extra Virgin Olive Oil Aid In The Shallow Frying Process",13,10,45,55,4,North Indian Recipes,Appetizer,Vegetarian
Thai Pineapple Vegetarian Fried Rice Recipe (No Onion No Garlic),"Cooked Rice, Pineapple, Green Beans, Carrot, Green Bell Pepper, Green Peas, Tomato, Butter, Green Chilli, Sugar, Soya Sauce, Garam Masala Powder, Black Pepper Powder, Salt, Dry Fruits",15,15,20,35,4,Thai,Dinner,Vegetarian
Chinese Vegetable Dry Manchurian Balls Recipe (No Onion No Garlic),"Cabbage, Carrot, Ginger, Soy Sauce, Salt, All Purpose Flour, Corn Flour, Sunflower Oil Deep Fry, Sunflower Oil, Red Bell Pepper, Green Bell Pepper, Yellow Bell Pepper, Green Beans, Carrot, Green Chilli, Ginger, Salt, Soy Sauce, Tomato Ketchup, Sugar, Chilled Water, Corn Flour, Coriander",23,10,25,35,4,Indo Chinese,Side Dish,No Onion No Garlic (Sattvic)
Peshawari Kala Chana Recipe,"Kala Chana, Onion, Tomato, Ginger, Green Chilli, Cinnamon Stick, Black Cardamom, Coriander Powder, Red Chilli Powder, Chana Masala Powder, Anardana Powder, Coriander, Ghee, Salt",14,30,30,60,4,Pakistani,Lunch,Vegetarian
Peas Pulao Recipe -  North Indian Matar Pulao,"Basmati Rice, Ghee, Cumin Seeds, Bay Leaf, Star Anise, Cardamom, Cloves, Cinnamon Stick, Salt, Onion, Green Peas",11,10,25,35,4,Indian,Main Course,Vegetarian
Creamy Mushroom Mini Pie Recipe,"Recipe Pastry Dough, Onion, Garlic, Button Mushrooms, Fresh Cream, Black Pepper Powder, Basil Leaves, Sunflower Oil, Whole Eggs, Sesame Seeds",10,10,360,370,2,Continental,Snack,Vegetarian
Hara Dhania Paratha Recipe,"Wheat Flour, Cumin Powder, Turmeric Powder, Coriander Leaves, Green Chilli, Ginger, Salt, Pepper Powder, Oil Ghee",9,20,20,40,4,Indian,Lunch,Vegetarian
Watermelon Seeds And Pumpkin Seeds Podi Recipe,"Watermelon Seeds, Pumpkin Seeds, White Urad Dal, Dry Red Chilli, Curry Leaves, Asafoetida, Salt",7,15,20,35,4,South Indian Recipes,Side Dish,High Protein Vegetarian
Gulachi Poli Recipe (Jaggery And Poppy Seeds Stuffed Paratha),"Whole Wheat Flour, Gram Flour, Sunflower Oil, Salt, Jaggery, Sesame Seeds, Poppy Seeds, Gram Flour, Dry Coconut, Cardamom Powder, Nutmeg Powder, Milk As Required, Ghee",13,30,20,50,8,Maharashtrian Recipes,Lunch,Vegetarian
Dubki Wale Aloo Recipe - Potatoes In A Spicy North Indian Gravy,"Potato, Tomato, Coriander, Red Chilli Powder, Turmeric Powder, Amchur, Ginger, Methi Seeds, Cumin Seeds, Dry Red Chilli, Kasuri Methi, Asafoetida",12,15,30,45,6,North Indian Recipes,Lunch,Vegetarian
Paruppu Urundai Rasam Recipe - Dal Dumpling Rasam,"Arhar Dal, Dry Red Chilli, Asafoetida, Salt, Sesame, Ghee, Mustard Seeds, Cumin Seeds, Curry Leaves, Asafoetida, Tamarind Water, Tomato, Cumin Powder, Coriander, Turmeric Powder, Black Pepper Powder, Red Chilli Powder, Jaggery, Salt",19,30,20,50,4,South Indian Recipes,Lunch,High Protein Vegetarian
Chinna Vengaya Puli Kuzhambu Recipe (Spicy Tangy Baby Onion Curry),"Shallots, Sambar Powder, Jaggery, Tamarind Water, Mustard Seeds, Methi Seeds, Sesame, Curry Leaves, Salt",9,10,40,50,4,South Indian Recipes,Dinner,Vegetarian
How To Make Homemade Almond Flour Recipe,Badam,1,10,10,20,100,South Indian Recipes,Dinner,Vegetarian
Arachuvitta Sambar Recipe - Sambar With Fresh Ground Spices,"Arhar Dal, Tamarind Water, Pearl Onion, Mooli Mullangi, Carrot, Tomato, Drumstick, Turmeric Powder, Salt, Coriander, Chana Dal, White Urad Dal, Dry Red Chilli, Methi Seeds, Fresh Coconut, Sesame, Mustard Seeds, Asafoetida, Curry Leaves, Coriander",20,20,40,60,4,Tamil Nadu,Lunch,Vegetarian
Rabodi Ki Sabzi ,"Rabodi, Curd, Onion, Green Chilli, Cumin Seeds, Red Chilli Powder, Turmeric Powder, Coriander Powder, Salt, Oil, Water",11,10,20,30,2,Rajasthani,Lunch,Vegetarian
Sweet and Spicy Pineapple Paneer Tikka Tawa Pizza Recipe,"All Purpose Flour, Salt, Sugar, Active Dry Yeast, Extra Virgin Olive Oil, Milk, Lukewarm Water Knead The Dough, Paneer, Pineapple, Red Bell Pepper, Sunflower Oil, Hung Curd, Gram Flour, Garlic, Ginger, Kasuri Methi, Fennel Seeds, Ajwain, Cumin Powder, Coriander Powder, Turmeric Powder, Red Chilli Powder, Garam Masala Powder, Chaat Masala Powder, Salt, Homemade Pizza And Pasta Sauce, Mozzarella Cheese, Cheese",28,100,35,135,4,Fusion,Dinner,Vegetarian
Healthy Whole Wheat Brown Butter Banana Bread Recipe,"Butter, Caster Sugar Brown Sugar, Whole Eggs, Milk, Vanilla Extract, Ripe Bananas, All Purpose Flour, Whole Wheat Flour, Baking Soda, Salt, Badam",11,20,45,65,6,Continental,Snack,Vegetarian
Maharastrian Batatyachi Bhaji Recipe-Quick and Simple Aloo Sabzi,"Potato, Onion, Ginger, Green Chilli, Turmeric Powder, Coriander, Salt, Sunflower Oil, Mustard Seeds, Cumin Seeds, Asafoetida, Curry Leaves",12,10,45,55,4,Maharashtrian Recipes,Lunch,Vegetarian
Mexican Style Sopa De Frijol Recipe - Red Kidney Beans Soup,"Sunflower Oil, Rajma, Dried Oregano, Cumin Powder, Garlic, Onion, Salt, Black Pepper Powder, Tomato, Hot Water, Fresh Cream Crema Mexicana, Paneer, Tortillas",13,10,90,100,4,Mexican,Appetizer,Vegetarian
Gopalkala Recipe - Janmashtami Special),"Poha, Curd, Cucumber, Fresh Coconut, Ginger, Salt, Coriander, Ghee, Mustard Seeds, Cumin Seeds, Green Chilli",11,10,10,20,4,Indian,Lunch,Vegetarian
Linzer Cookies Recipe,"Butter, Caster Sugar, Milk, Vanilla Extract, Almond Meal, All Purpose Flour, Salt, Jam Preserves, Icing Sugar Dust",9,60,16,76,8,Continental,Snack,Eggetarian
Chinese Style Sweet And Spicy Broccoli Stir Fry With Sausage Recipe,"Broccoli, Chicken Sausage, Vinegar, Sugar, Green Chilli Sauce, Soy Sauce, Lemon Juice, Extra Virgin Olive Oil, Salt, Black Pepper Powder",10,10,15,25,4,Chinese,Side Dish,Eggetarian
Alu Bukhara Murgh Recipe - Chicken With Indian Plums,"Chicken, Alu Bukhara, Alu Bukhara, Curd, Ginger, Garlic, Green Chilli, Green Chilli, Onion, Turmeric Powder, Coriander Powder, Red Chilli Powder, Salt, Sunflower Oil, Bay Leaf, Ajwain, Cloves, Whole Black Peppercorns, Cardamom, Black Cardamom, Cinnamon Stick",21,10,90,100,4,Pakistani,Lunch,Non Vegeterian
Homemade Red Chilli Garlic Sauce Recipe,"Garlic, Thai Red Chilli, Rice Vinegar, Sugar, Sesame, Salt",6,5,10,15,4,Chinese,Lunch,Non Vegeterian
Peach Lassi Recipe - Peach Yogurt Smoothie,"Curd, Peaches, Mint Leaves, Honey, Peaches, Mint Leaves",6,10,5,15,2,Indian,Lunch,Vegetarian
Masala Jowar Methi Roti Recipe,"Jowar Flour, Whole Wheat Flour, Methi Leaves, Red Chilli Powder, Turmeric Powder, Lukewarm Water, Salt, Sunflower Oil",8,10,30,40,4,North Indian Recipes,Side Dish,Vegetarian
"Kesar Mawa Gujiya Recipe- Gujiya Stuffed With Saffron, Khoya & Nuts","All Purpose Flour, Ghee, Water, Khoya, Sugar, Raisins, Chironji, Cardamom Powder, Sunflower Oil, Sugar, Water, Saffron Strands, Pistachios, Saffron Strands, Rose Petals",15,10,40,50,2,Indian,Dessert,Vegetarian
Chocolate Rava Ladoo Recipe,"Sooji, Ghee, Cocoa Powder, Sugar, Badam, Cardamom Powder, Raisins, Cashew Nuts, Dessicated Coconut",9,10,30,40,8,Indian,Dessert,Vegetarian
Hearty Vegetable Tortilla Soup Recipe,"Extra Virgin Olive Oil, Garlic, Onion, Pickled Jalapenos, Cumin Powder, Red Chilli Sauce, Sweet Corn, Green Zucchini, Red Yellow And Green Bell Peppers, Canned Black Beans, Tomato, Vegetable Stock, Water, Salt, Black Pepper Powder, Onion, Tomato  Finely, Garlic, Pickled Jalapenos, Salt, Black Pepper Powder, Tortillas, Avocado, Coriander",24,20,30,50,6,Mexican,Side Dish,High Protein Vegetarian
Boondi Ki Kheer Recipe,"Milk, Sweet Boondi, Cardamom Powder, Rose Water, Saffron Strands, Badam",6,10,20,30,4,North Indian Recipes,Dessert,Vegetarian
Suran Ja Tuk Recipe - Sindhi Deep Fried Yam/Jimikand,"Elephant Yam, Salt, Sunflower Oil, Cumin Powder, Red Chilli Powder Sprinkle, Amchur",6,10,25,35,4,Sindhi,Side Dish,Vegetarian
Tofu Scramble Recipe,"Tofu, Onion, Garlic, Tomato, Green Chilli, Turmeric Powder, Cumin Powder, Garam Masala Powder, Extra Virgin Olive Oil, Parsley Leaves, Salt And Pepper",11,10,15,25,4,Fusion,World Breakfast,High Protein Vegetarian
Soulful Chicken Soup Recipe,"Chicken Drumstick, Onion, Carrot, Garlic, Ginger, Whole Black Peppercorns, Salt, Sweet Corn, Spring Onion Greens, Fresh Cream, Salt, Black Pepper Powder",12,10,25,35,2,Continental,Appetizer,High Protein Non Vegetarian
Malabar Parotta Recipe - Kerala Parotta Recipe,"All Purpose Flour, Ghee, Milk, Sugar, Salt, Lukewarm Water",6,10,45,55,4,Kerala Recipes,Lunch,Vegetarian
Lahori Aloo Recipe,"Baby Potato, Sunflower Oil, Ginger Garlic Paste, Salt, Milk, Coriander, Onion, Bay Leaves, Tomato, Sunflower Oil, Dry Red Chilli, Coriander, Cumin Seeds, Cloves, Poppy Seeds, Fennel Seeds, Cinnamon Stick, Whole Black Peppercorns, Dry Coconut",19,20,45,65,4,Pakistani,Lunch,Vegetarian
Pinacolada Smoothie Recipe,"Ripe Bananas, Pineapple, Instant Oats, Dried Figs, Salt, Dessicated Coconut Fresh Coconut, Pineapple Essence, Coconut Milk, Hung Curd, Dessicated Coconut, Fresh Cherries, Pineapple",12,10,10,20,4,Fusion,World Breakfast,Vegetarian
Tangy Tamarind Pumpkin Curry Recipe,"Kaddu, Sunflower Oil, Mustard Seeds, Cumin Seeds, Ginger Garlic Paste, Green Chilli, Onion, Curry Leaves, Red Chilli Powder, Turmeric Powder, Coriander Powder, Salt, Water, Tamarind Paste, Jaggery",15,20,30,50,4,Indian,Dinner,Vegetarian
Homemade Kit Kat Bars Recipe,"Milk Chocolate, White Chocolate, Chocolate Wafers, Strawberry Wafers",4,15,10,25,6,Continental,Dessert,Vegetarian
Kongunadu Chicken Curry Recipe,"Chicken Breasts, Ginger Garlic Paste, Lemon Juice, Onion, Tomato, Garlic, Red Chilli Powder, Turmeric Powder, Cloves, Cinnamon Stick, Fennel Seeds, Salt, Sunflower Oil, Onion, Fennel Seeds, Cumin Seeds, Poppy Seeds, Whole Black Peppercorns, Fresh Coconut, Coriander Powder, Dry Red Chilli",21,10,35,45,4,Tamil Nadu,Lunch,Non Vegeterian
Stuffed Mooli Paratha Recipe (Radish Flat Bread),"Mooli Mullangi, Figaro Pure Olive Oil, Cumin Powder, Ginger, Gram Flour, Coriander, Green Chilli, Salt, Whole Wheat Flour, Salt, Figaro Pure Olive Oil Gheesmear While Cooking, Salt, Sunflower Oil Gheesmear While Cooking",13,20,45,65,4,North Indian Recipes,Indian Breakfast,Diabetic Friendly
Vegan Hot Chocolate Recipe,"Soy Milk Almond Milk, Cocoa Powder, Salt, Cane Sugar Coconut Sugar, Vanilla Extract, Chocolate Bar",6,0,10,10,4,Continental,Appetizer,Vegan
"Roasted Pumpkin, Orange and Urad Dal Salad Recipe","White Urad Dal, Kaddu, Orange, Coriander, Fresh Orange Juice, Extra Virgin Olive Oil, Salt And Pepper",7,10,20,30,4,Continental,Appetizer,High Protein Vegetarian
Instant Lemon Pickle Recipe,"Lemons, Sugar, Salt, Red Chilli Powder",4,10,30,40,2,Indian,Side Dish,Vegetarian
Kothamalli Thogayal Recipe | Coriander Leaves Chutney,"Coriander, Fresh Coconut, Dry Red Chilli, Sunflower Oil, White Urad Dal, Salt, Jaggery, Tamarind",8,10,5,15,3,South Indian Recipes,Side Dish,Vegetarian
Bottle Gourd & Mint Vegetable Juice Recipe - Lauki Juice,"Bottle Gourd, Ginger, Mint Leaves, Salt Kala Namak, Lemon Juice, Honey Jaggery",6,10,5,15,1,Indian,Indian Breakfast,Vegetarian
Kashmiri Style Noon Chai Recipe - Pink Tea,"Tetley Long Leaf Green Tea, Baking Soda, Salt, Cardamom, Water, Milk",6,10,10,20,4,Kashmiri,Snack,Vegetarian
Karnataka Style Mangrasa Recipe - Raw Mango Chutney Recipe,"Mango, Jaggery, Red Chilli Powder, Methi Seeds, Cumin Seeds, Asafoetida, Water, Coconut Oil, Salt",9,10,15,25,4,Karnataka,Side Dish,Vegetarian
Huli Soppu Saaru Recipe - Karnataka Style Mixed Greens Sambar,"Arhar Dal, Mixed Greens, Tamarind, Onion, Cloves, Jaggery, Salt, Coriander, Chana Dal, White Urad Dal, Fresh Coconut, Methi Seeds, Dry Red Chilli, Cumin Seeds, Whole Black Peppercorns, Sunflower Oil, Onion, Dry Red Chilli, Mustard Seeds, Cumin Seeds, Curry Leaves, Asafoetida, Sunflower Oil",23,10,20,30,4,Karnataka,Side Dish,High Protein Vegetarian
Andhra Style Aratikaya Vepudu Recipe - Raw Banana Dry Sabzi,"Raw Banana, Turmeric Powder, Red Chilli Powder, Rasam Powder, Sesame Powder, Salt, Sunflower Oil, Mustard Seeds, White Urad Dal, Garlic, Curry Leaves",11,10,20,30,4,Andhra,Lunch,Vegetarian
Mumbai Style Spicy Murmura Recipe (Spicy Roasted Puffed Rice),"Puffed Rice, Extra Virgin Olive Oil, Cumin Seeds, Curry Leaves, Turmeric Powder, Red Chilli Powder, Chaat Masala Powder, Sugar, Tomato, Onion, Green Chilli, Cucumber, Lemon Juice",13,10,20,30,2,Maharashtrian Recipes,Snack,Vegetarian
Cheesy Chicken Ala Kiev Recipe,"Chicken Breasts, Sunflower Oil Fry, Whole Eggs, All Purpose Flour, Whole Wheat Bread Crumbs, Butter, Garlic, Red Chilli Flakes, Salt, Black Pepper Powder, Parsley Leaves, Mozzarella Cheese",12,10,30,40,2,European,Appetizer,High Protein Non Vegetarian
Rajasthani Dal Recipe,"Green Moong Dal, Chana Dal, Cumin, Onion, Garlic, Ginger, Green Chilli, Cinnamon Stick, Bay Leaf, Tomato, Turmeric Powder, Red Chilli Powder, Asafoetida, Salt, Coriander, Lemon, Ghee, Cumin, Dry Red Chilli",19,240,30,270,6,Rajasthani,Lunch,High Protein Vegetarian
Mamidikaya Perugu Pachadi Recipe -Raw Mango Yogurt Pachadi,"Mango, Curd, Pearl Onion, Green Chilli, Turmeric Powder, Curry Leaves, Mustard Seeds, White Urad Dal, Dry Red Chilli, Asafoetida",10,10,15,25,4,Andhra,Side Dish,Vegetarian
Bhindi Masala Curry Recipe,"Bhindi, Sambar Powder, Turmeric Powder, Kashmiri Red Chilli Powder, Red Chilli Powder, Salt, Mustard Seeds, Cumin Seeds, Garlic, Onion, Tomato, Sugar, Sunflower Oil, Sesame Seeds",14,15,35,50,4,Indian,Lunch,Vegetarian
Cheesy Aloo Paratha Recipe,"Whole Wheat Flour, Sunflower Oil, Salt, Water, Potato, Sunflower Oil, Dry Red Chilli, Cumin Seeds, Asafoetida, Green Chilli, Ginger, Onion, Turmeric Powder, Coriander Powder, Cumin Powder, Garam Masala Powder, Chaat Masala Powder, Cheese, Coriander, Salt",20,15,15,30,2,North Indian Recipes,North Indian Breakfast,Vegetarian
Segdalu Recipe - Oriya Tea Time Snack,"Sooji, Water, Sesame Seeds, Chana Dal, Yellow Moong Dal, Ssp Asafoetida, Red Chilli Powder, Green Chilli, Turmeric Powder, Coriander, Sunflower Oil, Salt, Sesame Seeds",13,30,30,60,5,Oriya Recipes,Snack,Vegetarian
Matar Masala Tofu Recipe,"Tofu, Homemade Tomato Puree, Green Peas, Cumin Seeds, Red Chilli Powder, Turmeric Powder, Ginger, Garam Masala Powder, Green Peas, Curry Leaves, Water, Sunflower Oil, Salt",13,10,10,20,2,Indian,Lunch,High Protein Vegetarian
Gujarati Style Adadiya Pak Recipe,"Black Urad Dal, Milk, Ghee, Ghee, Khoya, Gond, Mixed Nuts, Sugar, Water, Cardamom Powder, Cloves, Dry Ginger Powder, Peepramul Powder, Cashew Nuts",14,15,45,60,4,Gujarati Recipesï»¿,Indian Breakfast,Vegetarian
Walnut Mushroom Veg Bolognese Recipe With A Twist,"Button Mushrooms, Walnuts, Extra Virgin Olive Oil, Garlic, Onion, Tomato, Homemade Tomato Puree, Salt, Black Pepper Powder, Sugar, Sweet And Spicy Red Chilli Sauce, Habenaro Sauce, Mixed Herbs, Cumin Powder, Apple Cider Vinegar",15,15,20,35,4,Italian Recipes,Main Course,Vegetarian
Creamy Herb Roasted Potato Soup In a Bread Bowl Recipe,"Sourdough Bread, Butter, Potato, Extra Virgin Olive Oil, Lemon Juice, Mixed Herbs, Red Chilli Flakes, Butter, All Purpose Flour, Milk, Cheddar Cheese, Salt, White Pepper Powder, Sour Cream, Spring Onion Greens",15,20,30,50,1,Continental,Appetizer,Vegetarian
Sambal Telor with Nasi Uduk Recipe (Indonesian Style Eggs Cooked in Sambal and Lemongrass Coconut Rice),"Whole Eggs, Onion, Shallots, Garlic, Byadagi Dried Chilli, Red Chilli Powder, Fish Sauce, Palm Sugar, Sunflower Oil, Salt, Rice, Coconut Milk, Water, Lemongrass, Ginger, Bay Leaf, Coriander, Palm Sugar",18,10,30,40,4,Asian,Dinner,Eggetarian
Pasta Primavera With Fresh Basil Recipe,"Spaghetti Pasta, Carrot, Baby Potato, Green Beans, Green Bell Pepper, Sweet Corn, Cherry Tomato, Broccoli, Onion, Garlic, Basil Leaves, Lemon, Extra Virgin Olive Oil, Salt, Red Chilli Flakes, Parmesan Cheese",16,10,30,40,4,Italian Recipes,Dinner,Vegetarian
Assamese Style Dil Pasand Recipe,"All Purpose Flour, Salt, Sugar, Cooking Soda, Water, Sunflower Oil Ghee For Deep Frying, Fresh Coconut, Khoya, Raisins, Sugar, Mixed Nuts",11,15,30,45,4,Assamese,Snack,Vegetarian
Kothavarangai Paruppu Usili Recipe - Gawar Phali Dal Sabzi,"Gawar Phali, Salt, Turmeric Powder, Arhar Dal, Dry Red Chilli, Turmeric Powder, Sesame, Mustard Seeds, White Urad Dal, Asafoetida, Curry Leaves",11,60,20,80,4,South Indian Recipes,Side Dish,High Protein Vegetarian
Broccoli And Aloo Lifafa Paratha Recipe,"Whole Wheat Flour, Sunflower Oil, Water Knead, Salt, Broccoli, Potato, Cumin Seeds, Coriander, Garam Masala Powder, Black Pepper Powder, Lemon, Salt, Corn Flour, Water, Ghee Oilsmear On Paratha",15,20,30,50,4,Indian,Dinner,Vegetarian
Eggless Mango Cheesecake Recipe,"Britannia Cream Cheese, Mango, Sugar, Milk, Gelatin, Water, Digestive Biscuit, Butter, Mango Pulp, Kiwi",10,15,140,155,6,Continental,Dessert,Non Vegeterian
Cheesy Bruschetta With Capsicum And Tomatoes Recipe,"Tomato, French Loaf, Onion, Green Bell Pepper, Basil Leaves, Dried Oregano, Lemon Juice, Salt, Black Pepper Powder, Extra Virgin Olive Oil Butter, Mozzarella Cheese",11,10,40,50,3,Italian Recipes,Appetizer,Vegetarian
Uddina Hittu Recipe (Udnittu) | Urad Dal Flour In Spiced Buttermilk,"Urad Dal Flour, Buttermilk, Green Chilli, Ginger, Salt, Coconut Oil  Coconut Oil, Mustard Seeds, Mor Milagai, Curry Leaves, Asafoetida",10,10,10,20,4,Udupi,Side Dish,Diabetic Friendly
Konkani Style Doddak Recipe-Lentil Pancakes,"White Urad Dal, Sooji, Ginger, Green Chilli, Sunflower Oil Make Dosas, Salt",6,48,20,68,4,Konkan,South Indian Breakfast,Vegetarian
Eggless & Gluten free Oats Banana Brownie Recipe,"Ripe Bananas, Instant Oats, Baking Powder, Baking Soda, Brown Sugar, Flax Seed Powder, Extra Virgin Olive Oil, Vanilla Extract, Walnuts, Chocolate Chips, Cocoa Powder, Sea Salt",12,20,40,60,6,Continental,Dessert,Vegetarian
Turai Aloo Ki Sabzi Recipe - Ridge Gourd Potato Curry,"Ridge Gourd, Potato, Tomato, Onion, Garlic, Ginger, Tablespoon Cumin Powder, Turmeric Powder, Coriander Powder, Garam Masala Powder, Salt, Red Chilli Powder, Tablespoon Sunflower Oil, Cumin Seeds, Mustard Seeds",15,15,20,35,4,Indian,Side Dish,Vegetarian
Pachai Payaru Payasam Recipe - Green Moong Dal Payasam,"Green Moong Dal, Jaggery, Water, Cardamom Powder, Whole Cashews, Ghee, Coconut Milk, Saffron Strands",8,240,20,260,4,South Indian Recipes,Dessert,Vegetarian
Garlic Toasted Beans Salad Recipe,"Green Beans, Garlic, Dry Red Chilli  Deseeded And Roughly Torn, Extra Virgin Olive Oil, Salt",5,10,5,15,2,Continental,Side Dish,Diabetic Friendly
Sri Lankan Chicken Curry Recipe - Kukul Mas Curry,"Coriander, Cumin Seeds, Whole Black Pepper Corns, Mustard Seeds, Cloves, Cardamom, Fennel Seeds, Dry Red Chilli, Cinnamon Stick, Garlic, Ginger, Onion, Dry Red Chilli, Curry Leaves, Turmeric Powder, Coconut Milk, Salt, Chicken, Sunflower Oil",19,10,25,35,4,Sri Lankan,Main Course,High Protein Non Vegetarian
Onion Rava Dosa Recipe - Spiced Semolina Crepe,"Sooji, Rice Flour, All Purpose Flour, Green Chilli, Shallots Onion, Black Pepper Corns, Coriander, Curry Leaves, Buttermilk, Sunflower Oil, Cumin Seeds, Fresh Coconut, Salt",13,15,40,55,4,Tamil Nadu,South Indian Breakfast,Vegetarian
Awadhi Style Nargisi Kofta Recipe (Boiled Egg Wrapped With Spiced Potato Recipe),"Whole Eggs, Potato, Carrot, Cabbage, Onion, Red Chilli Powder, Turmeric Powder, Coriander Powder, Garam Masala Powder, Salt, Sunflower Oil",11,20,30,50,4,Awadhi,Side Dish,Eggetarian
Tawa Tandoori Roti Recipe,"Whole Wheat Flour, Curd, Salt, Sunflower Oil",4,30,30,60,4,North Indian Recipes,Lunch,Vegetarian
Barnyard Millet Jaggery Payasam Recipe,"Barnyard Millet, Milk, Jaggery, Cardamom, Cashew Nuts, Ghee",6,0,25,25,4,South Indian Recipes,Dessert,Vegetarian
Pabda Macher Kalo Jeera Diye Recipe - Bengali Pabda Fish Curry,"Pabda Fish, Potato, Mustard Oil, Turmeric Powder, Salt, Kalonji, Tomato, Ginger, Cumin Seeds, Coriander Powder, Coriander, Red Chilli Powder, Green Chilli, Water",14,30,30,60,3,Bengali Recipes,Lunch,High Protein Non Vegetarian
Strawberry Cheesecake Bars Recipe,"Britannia Cream Cheese, Sugar, Whole Eggs, All Purpose Flour, Vanilla Extract, Strawberry Compote Pie Filling, Digestive Biscuit, Butter",8,20,60,80,4,Continental,Dessert,Eggetarian
Homemade Ghee Recipe,Butter,1,0,0,0,500,Indian,Side Dish,Vegetarian
Stuffed Capsicum Makhani Recipe,"Tomato, Onion, Garlic, Cumin Seeds, Cashew Nuts, Dry Red Chilli, Green Bell Pepper, Potato, Paneer, Chaat Masala Powder, Garam Masala Powder, Red Chilli Powder, Black Pepper Powder, Salt, Sunflower Oil, Coriander, Cardamom, Cinnamon Stick, Bay Leaf, Sunflower Oil, Sugar, Red Chilli Powder, Turmeric Powder, Garam Masala Powder, Fresh Cream",25,25,30,55,4,North Indian Recipes,Lunch,Vegetarian
General Tso's Cauliflower Recipe,"Cauliflower, Green Bell Pepper, Corn Flour, Baking Powder, Black Pepper Powder, Salt, Sesame Seeds, Sunflower Oil, Spring Onion, Garlic, Ginger, Corn Flour, Red Chilli Sauce, Soy Sauce, Honey",15,15,30,45,4,Hunan,Side Dish,Vegetarian
Broken Wheat And Green Moong Khichdi Recipe,"Broken Wheat, Green Moong Dal, Onion, Garlic, Green Beans, Carrot, Ghee, Mustard Seeds, Cumin Seeds, Curry Leaves  Torn With Hands, Ginger, Turmeric Powder, Asafoetida, Green Chilli, Mint Leaves, Lemon Juice",16,20,30,50,4,North Indian Recipes,Dinner,High Protein Vegetarian
Mirchi Ke Tipore Recipe - Green Chilli Stir Fry,"Green Chilli, Mustard Oil, Mustard Seeds, Asafoetida, Cumin Seeds, Fennel Seeds, Coriander Powder, Red Chilli Powder, Turmeric Powder, Amchur, Salt",11,10,8,18,6,Rajasthani,Side Dish,Vegetarian
Peanut Chilli Dipping Sauce Recipe,"Coconut Milk, Ginger, Peanut Butter, Red Chilli Sauce, Brown Sugar, Soy Sauce",6,10,0,10,4,Continental,Side Dish,High Protein Vegetarian
Cheese Garlic Bread Recipe,"Italian Bread, Extra Virgin Olive Oil, Garlic, Dried Oregano, Mozzarella Cheese",5,10,15,25,4,Italian Recipes,Side Dish,Vegetarian
Sriracha Hummus Recipe - Sriracha Flavoured Middle Eastern Dip,"Kabuli Chana, Lemon Juice, Sriracha Sauce, Garlic, Cumin Powder, Red Chilli Powder, Salt, Extra Virgin Olive Oil, Sesame Seeds",9,500,15,515,4,Middle Eastern,Side Dish,Vegetarian
Chocolate Almond Raisin Cookie Recipe,"Brown Sugar, Butter, Whole Eggs, Dark Chocolate, All Purpose Flour, Baking Powder, Salt, Raisins, Badam",9,20,45,65,4,Continental,Snack,Vegetarian
Savory Oatmeal Bowl with Chettinad Mushroom and Green Peas Stir Fry Recipe,"Rolled Oats Or Instant Oats, Water, Onion, Ginger, Garlic, Button Mushrooms, Green Peas, Fennel Seeds, Methi Seeds, Poppy Seeds, Whole Black Peppercorns, Coriander, Cinnamon Stick, Cardamom, Dry Red Chilli",15,10,25,35,4,World Breakfast,Vegetarian,Vegetarian
Lemon Buttermilk Cake Recipe,"Vivatta Maida, Corn Flour, Butter, Baking Powder, Baking Soda, Buttermilk, Caster Sugar, Lemon Zest, Lemons, Caster Sugar, Icing Sugar, Lemon Juice",12,10,30,40,6,Continental,Dessert,Vegetarian
Moroccan Baked Fish Recipe,"Basa Fish, Black Pepper Powder, Salt, Garlic, Coriander, Parsley Leaves, Homemade Tomato Puree, Cumin Powder, Saffron Strands, Paprika Powder, Lemon, Extra Virgin Olive Oil, Onion, Black Olives",14,30,35,65,4,Dinner,Non Vegeterian,Vegetarian
Roasted Red Pepper and Pumpkin Soup Recipe,"Red Bell Pepper, Kaddu, Garlic, Extra Virgin Olive Oil, Milk, Vegetable Stock, Red Chilli Flakes, Salt",8,15,30,45,4,Continental,Appetizer,Vegetarian
Vegetarian Sago Dumpling Recipe,"Sabudana, Shallots, Mixed Vegetables, Coriander, Coriander, Soy Sauce, Black Pepper Powder, Garlic, Sunflower Oil, Water, Garlic, Sunflower Oil",12,40,25,65,5,Thai,Snack,Vegetarian
Pumpkin Raita Recipe,"Kaddu, Curd, Red Chilli Powder, Cumin Powder, Coriander, Salt, Salt",7,15,15,30,4,Indian,Side Dish,Vegetarian
Zoodles Tossed In Cashew Cilantro Pesto Recipe (Vegan),"Green Zucchini, Garlic, Extra Virgin Olive Oil, Salt, Cashew Nuts, Coriander, Garlic, Sea Salt, Black Pepper Powder, Extra Virgin Olive Oil",10,15,5,20,2,Italian Recipes,Dinner,Vegan
Chickpea Tikka Masala Recipe,"Kabuli Chana, Onion, Tomato, Ginger, Garlic, Turmeric Powder, Red Chilli Powder, Cumin Powder, Coriander Powder, Garam Masala Powder, Coconut Milk, Salt",12,20,45,65,4,North Indian Recipes,Lunch,High Protein Vegetarian
Kung Pao Tofu With Vegetables Recipe,"Corn Flour, Soy Sauce, Green Bell Pepper, Honey, Water, Sesame, Garlic, Ginger, Dry Red Chilli, Spring Onion Greens, Red Bell Pepper, Green Bell Pepper, Roasted Peanuts, Black Pepper Corns, Tofu, Salt, Cooked Rice, Green Beans, Green Bell Pepper, Carrots, Spring Onion, Ginger, Black Pepper Powder, Sunflower Oil, Salt",25,20,30,50,4,Chinese,Side Dish,High Protein Vegetarian
Bathua Aloo Paratha Recipe,"Bathua Leaves, Potato, Garlic, Green Chilli, Onion, Ghee, Garam Masala Powder, Amchur, Whole Wheat Flour, Salt, Water Knead The Dough",11,40,30,70,4,North Indian Recipes,North Indian Breakfast,Vegetarian
Vellarikka Kosumalli Recipe- South Indian Style Cucumber Salad,"Cucumbers, Carrot, Green Chilli, Lemon, Coriander, Salt, Sunflower Oil, Cumin Seeds, Chana Dal, White Urad Dal, Dry Red Chilli, Curry Leaves",12,10,5,15,4,Indian,Lunch,Vegetarian
Baked Amritsari Kulcha Recipe (Without Yeast),"All Purpose Flour, Salt, Sugar, Baking Powder, Baking Soda, Sunflower Oil, Curd, Water, Black Sesame Seeds, Sesame Seeds, Coriander, Butter",12,10,10,20,2,Punjabi,Dinner,Vegetarian
Baked Farfalle Pasta With Mushrooms Peas And Lemon White Sauce Recipe,"Pasta, Onion, Garlic, Button Mushrooms, Green Peas, Lemon Juice, All Purpose Flour, Milk, Butter, Extra Virgin Olive Oil, Salt, Black Pepper Powder, Cheddar Cheese, Lemon Juice, Lemon Wedges",15,10,45,55,4,Italian Recipes,Dinner,Vegetarian
Orange Yogurt Cake Recipe,"All Purpose Flour, Sugar, Baking Powder, Baking Soda, Curd, Sunflower Oil, Orange Zest, Fresh Orange Juice, Whole Egg, Vanilla Extract, Caster Sugar, Butter Grease The Pan",12,15,35,50,4,Continental,Snack,Eggetarian
North Indian Chawli ki Sabzi Recipe | Yard Long Beans | Barbati | Karamani,"Green Chawli Beans, Ajwain, Garlic, Tomato, Red Chilli Powder, Turmeric Powder, Garam Masala Powder, Coriander Powder, Amchur, Jaggery, Salt, Mustard Oil",12,10,30,40,4,North Indian Recipes,Lunch,Vegetarian
Roasted Coriander Potatoes With Thyme Recipe,"Potato, Butter, Coriander, Fresh Thyme Leaves, Black Pepper Powder, Salt",6,30,30,60,6,Indian,Appetizer,Vegetarian
"Methi Makhana Mutter Korma Recipe - Methi, Green Pea & Lotus Seeds Curry","Cup Methi Leaves, Cup Green Peas, Cups Lotus Seeds, Ghee, Garlic, Ginger, Green Chilli, Cumin Seeds, Onion, Homemade Tomato Puree, Cumin Powder, Red Chilli Powder, Turmeric Powder, Coriander Powder, Garam Masala Powder, Bay Leaf, Milk, Sunflower Oil, Salt",19,20,20,40,4,North Indian Recipes,Lunch,Diabetic Friendly
Chicken Tikka Recipe,"Boneless Chicken, Ginger Garlic Paste, Lemon Juice, Turmeric Powder, Gram Flour, Ajwain, Red Chilli Powder, Garam Masala Powder, Cumin Powder, Coriander Powder, Curd, Salt",12,120,45,165,4,Punjabi,Appetizer,Non Vegeterian
Amaranth Sooji & Oats Dhokla Recipe,"Sooji, Rolled Oats Or Instant Oats, Green Amaranth Leaves, Curd, Enos Fruit Salt, Asafoetida, Ginger, Sunflower Oil, Red Chilli Powder, Salt, Mustard Seeds, Sesame Seeds, Sunflower Oil, Curry Leaves",14,15,30,45,4,Gujarati Recipesï»¿,North Indian Breakfast,Vegetarian
Foxtail Millet Lemon Rice Recipe-Elumichai Thenai,"Foxtail Millet, Mustard Seeds, White Urad Dal, Raw Peanuts, Carrot, Curry Leaves, Ginger, Green Chilli, Turmeric Powder, Lemon, Salt, Sesame, Coriander",13,20,40,60,4,South Indian Recipes,Lunch,Vegetarian
Banana Bran Muffin Recipe,"Ripe Bananas, Whole Wheat Flour, Instant Oats, Wheat Bran, Baking Powder, Baking Soda, Salt, Milk, Sunflower Oil, Maple Syrup, Vanilla Extract, Whole Egg, Cashew Nuts",13,25,15,40,4,Continental,World Breakfast,Eggetarian
Bengali Special Chocolate Sandesh Recipe (Chocolate Infused Cottage Cheese Dessert),"Milk Chocolate, Butter, Chenna, Sugar, Dates, Pistachios",6,10,45,55,4,Bengali Recipes,Dessert,Vegetarian
Baked Polenta Fries Recipe,"Polenta, Water, Milk, Butter, Mixed Herbs, Extra Virgin Olive Oil",6,30,30,60,4,Continental,Appetizer,Vegetarian
Beer Batter Prawns Recipe,"Prawns, Black Pepper Powder, Red Chilli Powder Paprika, Salt, Beer, All Purpose Flour, Corn Flour, Black Pepper Powder, Red Chilli Powder, Pizza Seasoning, Garlic Powder, Cooking Soda, Salt, Sunflower Oil",14,30,20,50,5,Indian,Appetizer,Non Vegeterian
Menemen Recipe - Turkish Style Egg Scramble With Bell Peppers,"Whole Eggs, Ginger, Garlic, Onion, Tomato, Homemade Tomato Puree, Red Bell Pepper, Yellow Bell Pepper, Paprika Powder, Dried Oregano, Black Pepper Corns, Cumin Powder, Salt, Extra Virgin Olive Oil, Chives",15,10,25,35,2,Middle Eastern,World Breakfast,Eggetarian
Pasta In Spinach Basil Sauce Recipe,"Extra Virgin Olive Oil, Penne Pasta Any Other Pasta Of Your Choice, Mixed Herbs, Extra Virgin Olive Oil, Garlic, Spinach, Cumin Powder, Milk, Basil Leaves, Slices Britannia Cheese Block, Salt And Pepper",11,20,30,50,4,Italian Recipes,Main Course,Vegetarian
Spicy Sweet Corn & Oat Fritters Recipe - Corn Masala Vada,"Sweet Corn, Green Chilli, Ginger, Cumin Seeds, Onion, Coriander, Chives, Instant Oats, Salt, Rice Flour Be Used Only If Required), Sunflower Oil  For Deepfrying",11,10,40,50,4,South Indian Recipes,Appetizer,Vegetarian
Chilli Paneer Recipe -Indo Chinese,"Paneer, Red Bell Pepper, Green Bell Pepper, Spring Onion, Garlic, Ginger, Thai Red Chilli, Corn Flour, Soy Sauce, Tomato Ketchup, Red Chilli Sauce, Sesame, Salt",13,10,30,40,4,North Indian Recipes,Appetizer,High Protein Vegetarian
Beetroot Falafel With Pita Bread Recipe,"Beetroot, Kabuli Chana, Whole Wheat Bread Crumbs, Ginger, Paprika Powder, Extra Virgin Olive Oil, Parsley Leaves, Cumin Powder, Sesame Seeds, Salt, Extra Virgin Olive Oil, Whole Wheat Pita Bread",12,10,30,40,2,Middle Eastern,Dinner,Vegetarian
Dry Fruit Halwa Recipe,"Dates, Dried Figs, Pistachios, Cashew Nuts, Badam, Walnuts, Milk, Ghee",8,30,30,60,4,Indian,Dessert,Vegetarian
Potato Roulade Recipe,"All Purpose Flour, Salt, Sugar, Chilled Butter, Chilled Water, Potato, Garlic, Paneer, Homemade Basil Pesto, Red Chilli Flakes, Salt, Extra Virgin Olive Oil, Egg White",13,30,30,60,4,French,Snack,Vegetarian
"Simple Winter Salad With Beet, Carrots & Feta Recipe","Beetroot, Carrots, Onion, Sunflower Seeds, Mint Leaves, Feta Cheese, Extra Virgin Olive Oil, Dried Oregano, Garlic, Red Wine Vinaigrette, Extra Virgin Olive Oil, Honey, Whole Black Peppercorns, Salt",14,25,10,35,4,Continental,Appetizer,Vegetarian
Chatpata Kala Chana Pakora Roll/ Frankie Recipe,"Tawa Paratha, Green Chutney, Sweet Chutney, Pickled Onion, Chaat Masala Powder, Kala Chana, Onion, Green Chilli, Garlic, Ginger, Coriander, Mint Leaves, Salt, Chaat Masala Powder, Amchur, Cumin Powder, Lemon Juice",17,20,20,40,2,Indian,Lunch,Vegetarian
Seppakizhangu Roast (South Indian Style Arbi Fry) Recipe,"Colocasia Root, Gram Flour, Rice Flour, Red Chilli Powder, Coriander Powder, Turmeric Powder, Sunflower Oil Cook, Salt",8,15,40,55,4,South Indian Recipes,Lunch,Vegetarian
Moong Dal Ghughra Recipe (Gujiya/ Karanji),"Vivatta Maida, Ghee, Salt, Water, Sunflower Oil, Green Moong Dal, Cumin Seeds, Fennel Seeds, Sesame Seeds, Sugar, Asafoetida, Amchur, Turmeric Powder, Red Chilli Powder, Green Chilli, Ginger, Salt",17,60,30,90,4,North Indian Recipes,Snack,Vegetarian
Pyaaz Kachori Recipe,"All Purpose Flour, Ghee, Salt, Water, Onion, Potato, Green Chilli, Garlic, Ginger, Asafoetida, Fennel Seeds, Coriander Powder, Turmeric Powder, Red Chilli Powder, Amchur, Garam Masala Powder, Coriander, Salt, Mustard Oil",19,20,40,60,4,Indian,Snack,Vegetarian
Sitaphal Rabdi Recipe,"Milk  Full Fat, Custard Apple, Badam, Pistachios, Cardamom Powder",5,10,90,100,4,Indian,Dessert,Vegetarian
Tulsi And Betel Leaves Rasam Recipe,"Tulsi, Betel Leaves, Garlic, Ajwain, Black Pepper Powder, Cumin Seeds, Tamarind, Tomato, Curry Leaves, Ginger, Asafoetida, Salt, Turmeric Powder, Water, Rasam Powder, Coriander, Ghee, Mustard Seeds, Dry Red Chilli",19,10,30,40,4,South Indian Recipes,Lunch,Vegetarian
"Kachumber Salad Recipe With Cucumber, Onion & Tomatoes","Cucumber, Onion, Green Chilli, Tomato, Carrot, Fresh Pomegranate Fruit Kernels, Salt, Black Pepper Powder, Cumin Powder, Lemon Juice, Coriander, Mint Leaves",12,10,5,15,4,Indian,Side Dish,Diabetic Friendly
Spaghetti Pasta Alla Puttanesca Recipe,"Spaghetti Pasta Conchiglie Linguine, Ginger, Black Olives, Capers  Optional, Salt, Black Pepper Powder, Dried Oregano, Dried Thyme Leaves, Sunflower Oil, Lukewarm Water, Tomato, Onion, Garlic",13,20,25,45,4,Italian Recipes,Lunch,Vegetarian
Vegetarian Chinese Samosa Recipe,"Whole Wheat Flour, Salt, Ghee, Rice Vermicelli Noodles, Carrots, Green Beans, Green Bell Pepper, Cabbage, Ginger, Garlic, Green Chilli, Spring Onion Greens, Sweet And Spicy Red Chilli Sauce, Salt, Black Pepper Powder",15,10,45,55,4,North Indian Recipes,Snack,Vegetarian
Khichdi With Fresh Spices Recipe,"Rice, Yellow Moong Dal, Water, Ghee, Bay Leaf, Cardamom, Cinnamon Stick, Dry Red Chilli, Cumin Seeds, Asafoetida, Ginger, Turmeric Powder, Salt, Coriander, Green Chilli, Lime Wedges",16,40,20,60,4,Indian,One Pot Dish,Vegetarian
Chettinad Kavuni Arisi Sweet Recipe (Black Rice Pudding),"Black Rice, Water, Palm Sugar Jaggery, Cardamom Powder, Fresh Coconut, Ghee",6,10,30,40,5,Chettinad,Dessert,Vegetarian
Stuffed Masala Aloo Naan Recipe Made Without Oven,"Whole Wheat Flour, Salt, Aerated Water, Ghee, Potato, Onion, Green Chilli, Garam Masala Powder, Amchur, Red Chilli Powder, Ajwain, Salt, Coriander",13,30,40,70,4,North Indian Recipes,Main Course,Vegetarian
Chettinad Mutton Chops Kuzhambu Recipe-Mutton Chops Curry,"Mutton, Onion, Tomato, Ginger Garlic Paste, Green Chilli, Cumin Seeds, Whole Black Peppercorns, Mustard Seeds, Coriander, Dry Red Chilli, Red Chilli Powder, Coriander Powder, Turmeric Powder, Cloves, Cinnamon Stick, Bay Leaf, Salt, Sunflower Oil, Red Chilli Powder, Salt, Mutton, Onion, Cumin Seeds, Coriander",24,10,60,70,4,Chettinad,Lunch,Non Vegeterian
Avengers Cheeseburger Recipe-Aloo Tikki Burger Recipe,"Potato, Onion, Green Bell Pepper, Carrots, Red Chilli Powder, Garam Masala Powder, Mint Leaves, Corn Flour, Salt, Whole Wheat Bread Crumbs, Sunflower Oil, Burger Buns, Britannia Cheese Slice, Britannia Cheese Spread, Onion, Tomato, Iceberg Lettuce",17,10,45,55,6,Fusion,Appetizer,Vegetarian
"Stuffed Tomatoes with Quinoa, Spinach and Cheese Recipe","Tomato, Quinoa, Spinach, Garlic, Black Pepper Powder, Mozzarella Cheese",6,10,30,40,4,Continental,World Breakfast,Vegetarian
Cheesy Baked Spaghetti Pasta Recipe,"Homemade Tomato Puree, Britannia Cheese Spread, Onion, Garlic, Black Olives, Salt, Basil Leaves, Spaghetti Pasta, Britannia Cheese Block, Salt, Extra Virgin Olive Oil",11,20,45,65,4,Italian Recipes,Dinner,Vegetarian
Palak Tambuli Recipe (Udupi Style Spinach Tambli),"Spinach Leaves, Cumin Seeds, Whole Black Peppercorns, Green Chilli, Fresh Coconut, Curd, Ghee, Salt, Ghee, Mustard Seeds, Cumin Seeds, Curry Leaves, Dry Red Chilli",13,10,20,30,4,Karnataka,Lunch,High Protein Vegetarian
Spirulina and Mint Basil Pesto Recipe,"Basil Leaves, Spirulina, Mint Leaves, Badam, Garlic, Tofu, Black Pepper Powder, Salt, Extra Virgin Olive Oil",9,15,0,15,4,Continental,High Protein Vegetarian,Vegetarian
Homemade Spring Roll Wrapper Recipe,"All Purpose Flour, Corn Flour, Water, Salt",4,0,30,30,10,Chinese,High Protein Vegetarian,Vegetarian
Semiya Biryani Recipe,"Semiya, Water, Carrot, Green Peas, Whole Wheat Brown Bread, Sunflower Oil, Onion, Ginger Garlic Paste, Tomato, Mint Leaves, Garam Masala Powder, Red Chilli Powder, Cinnamon Stick, Cloves, Cardamom, Salt",16,5,20,25,4,South Indian Recipes,Dinner,Vegetarian
Chewy Pumpkin Seed Chikki Recipe,"Pumpkin Seeds, Jaggery, Cardamom Powder, Fresh Coconut",4,10,15,25,2,Indian,Snack,Vegetarian
Honey Roasted Sweet Potato With Red Onions Recipe,"Sweet Potato, Onion, Garlic, Red Chilli Flakes, Honey, Tabasco Original, Mustard Sauce, Salt And Pepper, Sunflower Oil",9,10,45,55,4,Continental,Side Dish,Vegetarian
Karwar style Tousali Recipe-Cucumber Steamed Cake,"Cucumber, Rice, Sooji, Fresh Coconut, Ghee, Jaggery, Enos Fruit Salt, Salt",8,130,30,160,4,Karnataka,South Indian Breakfast,Vegetarian
Puffed Rice Bar Recipe,"Puffed Rice, Mixed Nuts, Dry Coconut, Cardamom, Jaggery, Butter",6,10,25,35,4,Indian,Snack,High Protein Vegetarian
Roat Recipe | Uttarakhand Style Sweetened Flatbread,"Whole Wheat Flour, Milk, Ghee, Cardamom Powder, Fennel Seeds, Jaggery",6,30,15,45,4,North Indian Recipes,Dessert,Vegetarian
Penne Pasta Recipe In Roasted Carrot Sauce & Olives,"Penne Pasta, Tomato, Carrots, Garlic, Extra Virgin Olive Oil, Salt, Red Chilli Powder, Red Chilli Flakes, Dried Oregano, Parmesan Cheese, Black Olives Both Green & Black",11,10,45,55,4,Italian Recipes,Dinner,Vegetarian
Apple Puree Recipe (Baby Food - 4 months onwards),"Apple, Water",2,10,30,40,2,Indian,Lunch,Vegetarian
Karamani Sundal Recipe - Spicy Tossed Black Eyed Beans Recipe),"Black Eyed Beans, Coconut Oil, Mustard Seeds, Cumin Seeds, Ginger, Green Chilli, Curry Leaves, Turmeric Powder, Asafoetida, Dry Red Chilli, Curry Leaves, Fresh Coconut, Coriander",13,15,15,30,2,South Indian Recipes,Side Dish,Vegetarian
Spinach Soft Shell Taco Stuffed with Cabbage Slaw Salad Recipe,"Spinach, Makki Ka Atta, Red Chilli Flakes, Sunflower Oil, Salt, Water, Iceberg Lettuce, Red Cabbage, Cherry Tomato, Whole Black Peppercorns, Dried Oregano, Salt, Hung Curd, Lemon Juice, Fresh Cream",15,30,30,60,4,Mexican,Appetizer,Diabetic Friendly
Herbed Brown Rice Recipe,"Brown Rice, Onion, Garlic, Dried Oregano, Rosemary, Red Chilli Flakes, Salt, Sunflower Oil, Water",9,10,20,30,4,Continental,Side Dish,Vegetarian
Oat Olives and Broccoli Sandwich Spread Recipe,"Extra Virgin Olive Oil, Garlic, Broccoli, Instant Oats, Rolled Oats Or Instant Oats, Paneer, Black Olives, Whole Black Peppercorns, Cumin Powder, Walnuts, Salt",11,0,20,20,10,Continental,Side Dish,Vegetarian
Thai Style Sweet Khao Tom Recipe (Coconut Sticky Rice Stuffed with Banana and Steamed),"Cooked Rice, White Broad Beans, Coconut Milk, Sugar, Salt, Nendra Pazham Banana",6,5,30,35,4,Thai,Dessert,Vegetarian
Nawabi Tawa Paratha Recipe,"All Purpose Flour, Sooji, Salt, Sugar, Cardamom Powder, Rose Water, Kewra Water, Saffron Strands, Ghee, Milk, Ghee",11,30,10,40,4,Lucknowi,Lunch,Vegetarian
Sweet Potato Kheer Recipe,"Sweet Potato, Fresh Coconut, Cardamom, Milk, Sugar Jaggery, Sooji, Saffron Strands, Cashew Nuts",8,10,25,35,4,North Indian Recipes,Dessert,Vegetarian
Classic New York Style Cheesecake Recipe,"Britannia Cream Cheese, Fresh Cream, Caster Sugar, All Purpose Flour, Whole Eggs, Vanilla Extract, Digestive Biscuit, Butter",8,20,80,100,6,Continental,Dessert,Vegetarian
Niramish Aloo Dum Recipe,"Potato, Cumin Seeds, Dry Red Chilli, Dry Ginger Powder, Turmeric Powder, Red Chilli Powder, Garam Masala Powder, Asafoetida, Few Coriander",9,15,30,45,4,Indian,Lunch,Vegetarian
Murgh Palak Recipe - Chicken In A Palak Gravy,"Spinach Leaves, Salt, Garlic, Ginger, Green Chilli, Chicken, Sunflower Oil, Curd, Bay Leaf, Cardamom, Cinnamon Stick, Garlic, Methi Seeds, Onion, Ginger Garlic Paste, Tomato, Red Chilli Powder, Turmeric Powder, Coriander Powder, Salt, Garam Masala Powder, Butter, Fresh Cream, Kasuri Methi, Methi Seeds, Ghee, Cumin Seeds, Water, Chilled Water",29,30,45,75,4,North Indian Recipes,Side Dish,Non Vegeterian
Homemade Loaded Chicken Nachos Recipe,"Nachos, Sour Cream, Tomato Salsa, Guacamole, Pickled Jalapenos, Mozzarella Cheese, Black Olives, Chicken Breasts, Extra Virgin Olive Oil, Salt And Pepper Sprinkle",10,15,10,25,4,Mexican,Appetizer,Non Vegeterian
Japanese Style Chicken Katsu Curry Recipe,"Chicken Breasts, Black Pepper Powder, Coriander, Cumin Seeds, Dry Red Chilli, Fennel Seeds, Methi Seeds, Cinnamon Stick, Cloves, Cardamom, Black Pepper Corns, Star Anise, Butter, All Purpose Flour, Sunflower Oil, Ginger, Garlic, Onion, Carrot, Potato, Water, Apple, Turmeric Powder, Nutmeg Powder, Salt, Tomato Ketchup, Honey",27,15,20,35,4,Japanese,Main Course,Non Vegeterian
Kerala Style Tomato Fry Recipe,"Tomato, Sunflower Oil, Mustard Seeds, Dry Red Chilli, Curry Leaves, Onion, Ginger Garlic Paste, Green Chilli, Kashmiri Red Chilli Powder, Turmeric Powder, Salt, Coriander",12,10,20,30,4,Kerala Recipes,Dinner,Vegetarian
Coconut & Ricotta Dip with Banana Chips Recipe,"Ripe Bananas, Lemon Juice, Ricotta Cheese, Fresh Coconut, Clove Garlic, Parsley Leaves, Mint Leaves, Extra Virgin Olive Oil, Lemon Juice, Lemon Zest, Salt, Black Pepper Powder",12,100,20,120,4,Continental,Appetizer,Vegetarian
Fettuccine Pasta Recipe With Roasted Red Bell Pepper Sauce,"Whole Wheat Flour, Water, Salt, Red Bell Pepper, Garlic, Onion, Homemade Tomato Puree, Red Chilli Flakes, Sugar, Cumin Powder, Fresh Cream, Salt, Basil Leaves, Garlic, Carrot, Basil Leaves, Parmesan Cheese",17,10,20,30,4,Italian Recipes,Dinner,Vegetarian
Mangalore Style Nurge Gashie Recipe-Spicy Drumstick Curry,"Drumstick   Them Into   Pieces, Jaggery, Onion, Salt, Fresh Red Chilli, Coriander, Methi Seeds, Black Urad Dal, Whole Black Peppercorns, Cumin Seeds, Tamarind Paste, Garlic, Turmeric Powder, Fresh Coconut, Sesame, Sunflower Oil, Mustard Seeds, Cumin Seeds, Black Urad Dal, Curry Leaves, Coriander",21,10,35,45,4,Mangalorean,Lunch,Vegetarian
Apple Almond Cake Recipe | With Eggless Version,"All Purpose Flour, Baking Powder, Baking Soda, Salt, Cinnamon Powder, Caster Sugar, Sunflower Oil, Whole Eggs, Apples, Vanilla Extract, Badam",11,10,90,100,4,Continental,Dessert,Eggetarian
Sri Lankan Dal Recipe,"Arhar Dal, Mustard Seeds, Curry Leaves, Cinnamon Stick, Onion, Methi Seeds, Whole Black Peppercorns, Red Chilli Flakes, Turmeric Powder, Coconut Milk, Salt",11,5,25,30,4,Sri Lankan,Lunch,High Protein Vegetarian
Kerala Chicken Curry Recipe - Nadan Kozhi Curry,"Chicken  Curry With Bones, Red Chilli Powder, Turmeric Powder, Salt, Onion, Curry Leaves, Green Chilli, Ginger, Garlic, Tomato, Red Chilli Powder, Coriander Powder, Turmeric Powder, Fennel Powder, Garam Masala Powder, Coconut Milk, Salt, Coconut Oil",18,10,30,40,3,Kerala Recipes,Main Course,Non Vegeterian
Roasted Mushroom Recipe,"Button Mushrooms, Cherry Tomato   Into Half, Coriander, Rosemary, Dried Oregano, Red Chilli Flakes, Salt, Black Pepper Powder, Extra Virgin Olive Oil",9,10,25,35,4,Continental,Appetizer,No Onion No Garlic (Sattvic)
Crispy & Spicy Paneer Starter Recipe,"Paneer, Achari Masala, Lemon Juice, Salt, Papads, Corn Flour, Water, Sunflower Oil, Fennel Seeds, Methi Seeds, Turmeric Powder, Red Chilli Powder, Mustard Seeds, Kalonji, Salt",15,60,40,100,4,Indian,Appetizer,High Protein Vegetarian
Prawn Cutlets With Sweet Potatoes Wedges Recipe,"Prawns, All Purpose Flour, Corn Flour, Whole Eggs, Whole Wheat Bread Crumbs, Salt, Black Pepper Powder, Garlic Powder, Red Chilli Powder, Sweet Potato, Extra Virgin Olive Oil, Paprika Powder, Salt, Black Pepper Powder",14,10,60,70,4,Indian,Appetizer,Non Vegeterian
Aloo Amritsari Recipe,"Potato, Ajwain, Onion, Ginger, Garlic, Tomato, Turmeric Powder, Garam Masala Powder, Coriander Powder, Kashmiri Red Chilli Powder, Coriander, Salt Tase, Sunflower Oil",13,15,30,45,4,Punjabi,Lunch,Vegetarian
Carrot Pachadi With Coconut Recipe,"Carrots, Fresh Coconut, Green Chilli, Coriander, Curd, Salt, Sunflower Oil, Mustard Seeds, Black Urad Dal, Asafoetida, Curry Leaves, Dry Red Chilli",12,5,10,15,4,Tamil Nadu,Side Dish,Vegetarian
Parsi Style Paneer Charvela Eda Sathe Recipe-Scrambled Eggs with Paneer Recipe,"Paneer, Whole Eggs, Onion, Green Chilli, Garlic, Whole Black Peppercorns, Salt, Sunflower Oil, Coriander",9,5,15,20,4,Parsi Recipes,North Indian Breakfast,Eggetarian
Crispy Pan Fried Pomfret Recipe,"Pomfret Fish, Sunflower Oil, Cup Sooji, Salt, Coriander, Fennel Seeds, Whole Black Peppercorns, Cloves, Turmeric Powder, Dry Red Chilli, Garlic, Ginger, Tamarind",13,15,10,25,4,Indian,Side Dish,High Protein Non Vegetarian
Chapor Ghonto Recipe (Bengali Mix Vegetable With Lentils Patties),"Potato, Kaddu, Brinjal, Ridge Gourd, Taro Root, Dried Yellowwhite Peas, Ginger, Mustard Seeds, Poppy Seeds, Fresh Coconut, Bay Leaves, Dry Red Chilli, Panch Phoran Masala, Green Chilli, Turmeric Powder, Salt, Sugar, Mustard Oil",18,45,30,75,4,Bengali Recipes,Lunch,Vegetarian
Khao Neeo Mamuang -  Thai Sweet Sticky Rice With Mango,"Mango, Rice, Coconut Milk, Jaggery, Salt, Coconut Milk, Sugar",7,10,30,40,4,Thai,Dessert,Vegetarian
Awadhi Style Chickpea Kofta Biryani Recipe,"Onion, Tomato, Ginger, Turmeric Powder, Red Chilli Powder, Garam Masala Powder, Curd, Mint Leaves, Coriander, Salt, Kala Chana, Onion, Green Chilli, Coriander, Garlic, Salt, Sunflower Oil, Basmati Rice, Cloves, Bay Leaves, Cinnamon Stick, Cardamom, Mace, Salt, Sunflower Oil, Milk",26,20,45,65,4,Awadhi,Lunch,Vegetarian
Tomato and Sunflower Seed Dip Recipe,"Tomato, Sunflower Seeds, Green Chilli, Coriander, Stalks Spring Onion Greens, Salt, Extra Virgin Olive Oil",7,5,15,20,4,Mexican,Appetizer,Vegetarian
Broccoli & Vegetable Coconut Curry Recipe,"Broccoli, Red Bell Pepper, Onion, Dry Red Chilli, Methi Seeds, Coriander, Cumin Seeds, Whole Black Peppercorns, Tamarind, Fresh Coconut, Garlic, Turmeric Powder, Salt, Sunflower Oil",14,20,40,60,4,Mangalorean,Side Dish,Diabetic Friendly
Dry Chilli Baby Corn Recipe (Indian Chinese Style Recipe),"Baby Corn, Onion, Garlic, Ginger, Green Chilli, Green Bell Pepper, Sunflower Oil, Soy Sauce, Vinegar, Corn Flour, Tomato Ketchup, Homemade Tomato Puree",12,10,30,40,4,Indo Chinese,Appetizer,Vegetarian
Murgh Aur Masoor Dal Recipe-Bombay Style Chicken with Dal,"Chicken, Masoor Dal, Onion, Green Chilli, Ginger, Garlic, Turmeric Powder, Cumin Powder, Red Chilli Powder, Garam Masala Powder, Lemon Juice, Salt, Sunflower Oil",13,10,45,55,4,North Indian Recipes,Lunch,High Protein Non Vegetarian
Chipotle Roasted Mushroom Vegetarian Quesadilla Recipe,"Tortillas, Cheddar Cheese, Button Mushrooms, Coriander, Green Chilli, Lemon Juice, Chipotle Sauce, Chipotle Sauce",8,20,30,50,4,Mexican,Appetizer,Vegetarian
Sikkim Style Steamed Chicken Momo Recipe,"Whole Wheat Flour, All Purpose Flour, Water, Chicken, Portobello Mushrooms, Cabbage, Onion, Garlic, Green Chilli, Soy Sauce, Sugar, Sunflower Oil, Salt",13,40,10,50,4,North East India Recipes,Appetizer,High Protein Non Vegetarian
Beetroot and Fig Chutney Recipe,"Figs, Celery, Chakundar, Nutmeg, Red Chili Powder, Garlic, Green Chilli",7,10,25,35,4,North Indian Recipes,Side Dish,Vegetarian
Kela Matar ki Sabzi Recipe - Raw Banana Green Peas Stir Fry,"Raw Banana, Green Peas, Cumin Seeds, Green Chilli, Turmeric Powder, Coriander Powder, Cumin Powder, Amchur, Lemon, Garam Masala Powder, Sunflower Oil, Coriander, Salt",13,15,20,35,4,North Indian Recipes,Lunch,No Onion No Garlic (Sattvic)
Kongunadu Style Kalan kuzhambu Recipe - Mushroom Curry,"Button Mushrooms, Onion, Green Chilli, Curry Leaves, Mustard Seeds, Salt, Sunflower Oil, Coriander, Dry Red Chilli, Cinnamon Stick, Cloves, Cumin Seeds, Fennel Seeds, Whole Black Peppercorns, Onion, Garlic, Ginger, Fresh Coconut, Garam Masala Powder",19,10,30,40,4,Kongunadu,Side Dish,Vegetarian
Buttered Herbed Rice Recipe,"Basmati Rice, Garlic, Basil Leaves  Roughly Torn, Parsley Leaves, Dried Oregano, Red Chilli Flakes, Butter, Salt, Black Pepper Powder",9,20,20,40,4,Continental,Dinner,Vegetarian
Mushroom Quiche Recipe,"All Purpose Flour, Salt, Butter, Parmesan Cheese, Chilled Water, Whole Eggs, Shallots, Portobello Mushrooms, Parsley Leaves, Garlic Powder, Clove Garlic, Sunflower Oil, Salt And Pepper",13,30,90,120,4,French,Lunch,Vegetarian
Paalkatti Chettinad Curry Recipe -Chettinad Style Paneer Kurma Recipe,"Paneer, Pearl Onion, Tomato, Mustard Seeds, Red Chilli Powder, Salt, Sunflower Oil, Curry Leaves, Coriander, Cloves, Cinnamon Stick, Cardamom, Whole Black Peppercorns, Kalpasi Leaves, Star Anise, Dry Red Chilli, Poppy Seeds, Fresh Coconut, Green Chilli, Curry Leaves, Coriander",21,20,30,50,4,Chettinad,Main Course,Vegetarian
Mini Naan Recipe With Pindi Chole,"Whole Wheat Flour, Bajra Flour, Jowar Flour, Curd, Active Dry Yeast, Salt, Sugar, Nutralite Garlic & Oregano Spread, Nutralite Classic Spread, Onion, Ginger, Green Chilli, Homemade Tomato Puree, Cardamom, Cinnamon Stick, Turmeric Powder, Anardana Powder, Coriander Powder, Garam Masala Powder, Amchur, Red Chilli Powder, Salt, Kala Chana, Coriander, Purple Cabbage, Onion, Carrot, Nutralite Cheesy Garlic Mayo, Salt And Pepper, Pudina Dahi Chutney",30,15,40,55,4,Fusion,Appetizer,Vegetarian
Gujarati Tawa Handvo Recipe - Healthy Pan Fried Lentil Cake,"Rice, Arhar Dal, Green Moong Dal, Chana Dal, White Urad Dal, Green Chilli, Ginger, Curd, Enos Fruit Salt, Turmeric Powder, Bottle Gourd, Sunflower Oil Cooking, Salt, Mustard Seeds, Sesame Seeds, Curry Leaves, Asafoetida, Red Chilli Powder, Sunflower Oil, Green Beans, Carrots, Onion",22,20,30,50,4,Gujarati Recipesï»¿,North Indian Breakfast,High Protein Vegetarian
Gola Kebab (Indian Style Meat Balls) Recipe,"Onion, Mutton, Red Chilli Powder, Turmeric Powder, Ginger Garlic Paste, Cloves, Cardamom, Cinnamon Stick, Coriander, Mint Leaves, Salt, Sunflower Oil",12,10,20,30,3,Lucknowi,Appetizer,Non Vegeterian
Churma Ladoo Recipe - Atta/Whole Wheat Ladoo,"Whole Wheat Flour, Ghee, Jaggery, Milk, Cardamom Powder, Nutmeg Powder, Poppy Seeds, Ghee",8,12,40,52,4,Rajasthani,Snack,Vegetarian
Thenga Vada Recipe (Spicy Coconut Fritters),"Rice Flour, All Purpose Flour, Fresh Coconut, Green Chilli, Salt, Sunflower Oil",6,20,40,60,4,Indian,Snack,Vegetarian
Chettinad Pazha Payasam Recipe -  Fruit Payasam Recipe,"Milk, Whole Cashews, Badam, Cardamom Powder, Mango, Sugar, Ripe Bananas, Apple, Orange, Green Grapes, Black Grapes, Fresh Pomegranate Fruit Kernels, Honey",13,60,60,120,6,Chettinad,Dessert,Vegetarian
Mushroom and beet wellington With Red Vinaigrette Sauce Recipe,"Onion, Red Bell Pepper, Button Mushrooms, Garlic, Stalks Celery, Salt And Pepper, Fresh Cream, Extra Virgin Olive Oil, Fresh Thyme Leaves, Beetroot, Red Wine Vinaigrette, Rosemary, Butter, Whole Egg, Puff Pastry Sheet",15,350,60,410,4,Continental,Main Course,Vegetarian
Chinese Savoury Rice Porridge Recipe With Pumpkin,"Rice, Kaddu, Water Vegetable Stock, Salt, Whole Black Peppercorns, Ginger, Spring Onion Greens, Coriander",8,20,20,40,4,Chinese,Dinner,Vegetarian
Mango Shikanji Recipe - Chatpata Mango Spritzer,"Bisleri Fonzo, Chaat Masala Powder, Black Salt, Cumin Powder, Black Pepper Powder, Lemon Juice",6,10,0,10,4,Indian,Appetizer,Vegetarian
Baingan Tamatar Sabzi - Brinjal/ Eggplant Masala Recipe,"Brinjal, Tomato, Onion, Garlic, Turmeric Powder, Garam Masala Powder, Coriander Powder, Red Chilli Powder, Salt, Ghee, Sunflower Oil, Coriander",12,20,30,50,4,Indian,Side Dish,Vegetarian
Cauliflower Kurma (Tamil Nadu Restaurant Style Cauliflower Chops) Recipe,"Cauliflower, Tomato, Shallots, Green Chilli, Garlic, Ginger, Turmeric Powder, Cumin Powder, Salt, Fresh Coconut, Fennel Seeds, Cashew Nuts  Approximately, Poppy Seeds, Coriander, Roasted Gram Dal, Dry Red Chilli, Coconut Oil, Cloves, Cardamom, Star Anise, Bay Leaf, Curry Leaves",22,20,60,80,4,Tamil Nadu,Lunch,Vegetarian
Zucchini Parmesan Fritters Recipe,"Green Zucchini, Whole Wheat Bread Crumbs, Parmesan Cheese, Corn Flour, Black Pepper Powder, Dried Oregano, Salt, Whole Egg, Sunflower Oil",9,15,15,30,4,European,Snack,Vegetarian
Kerala Pumpkin Black Eyed Beans Erissery Recipe,"Kaddu, Black Eyed Beans, Red Chilli Powder, Turmeric Powder, Salt, Fresh Coconut, Cumin Seeds, Green Chilli, Coconut Oil, Mustard Seeds, Curry Leaves, Dry Red Chilli, Fresh Coconut, Pearl Onion",14,10,20,30,4,Kerala Recipes,Lunch,Vegetarian
Mushroom Corn Masala Dosa Recipe Using Ragi Idli Dosa Batter,"White Urad Dal, Methi Seeds, Idli Rice, Ragi Seeds, Ghee Make The Dosas, Onion, Green Bell Pepper, Garlic, Button Mushrooms, Sweet Corn, Homemade Tomato Puree, Pav Bhaji Masala, Red Chilli Powder, Tomato Ketchup, Salt, Mint Leaves",16,10,25,35,4,Fusion,South Indian Breakfast,Vegetarian
Apple Cinnamon French Toast Recipe,"Whole Wheat Brown Bread, Whole Eggs, Milk, Fresh Cream, Brown Sugar, Cinnamon Powder, Butter, Apple, Cinnamon Stick, Brown Sugar, Butter",11,15,15,30,4,French,World Breakfast,Eggetarian
Homemade Vada Pav Recipe With Cheesy Aloo Vada,"Sunflower Oil, Sesame Seeds, Dry Red Chilli, Garlic, Dessicated Coconut, Salt, Gram Flour, Turmeric Powder, Ajwain, Salt, Water, Sunflower Oil, Mustard Seeds, Onion, Ginger, Garlic, Green Chilli, Asafoetida, Potato, Turmeric Powder, Coriander, Britannia Cheese Cubes, Salt, Pav Buns, Butter, Sunflower Oil",26,15,40,55,4,Maharashtrian Recipes,Snack,Vegetarian
Whole Wheat Mushroom Spinach Calzone Recipe,"Whole Wheat Flour, Water, Active Dry Yeast, Sugar, Salt, Extra Virgin Olive Oil, Button Mushrooms, Spinach  Finely, Onion, Garlic, Salt, Black Pepper Powder, Mozzarella Cheese, Ricotta Cheese, Extra Virgin Olive Oil, Milk",16,10,180,190,4,Italian Recipes,Snack,Vegetarian
Cheesy Corn And Onion Toasts Recipe,"Whole Wheat Brown Bread, Onion, Sweet Corn, Green Bell Pepper, Mozzarella Cheese, Dried Thyme Leaves Any Driedfresh Herbs Of Your Choice, Black Pepper Powder, Sunflower Oil, Salt",9,0,10,10,4,Italian Recipes,Snack,Vegetarian
Fennel Turmeric Walnut Soup With Apple And Raw Mango Recipe,"Sunflower Oil, Leek, Fennel Bulb, Mango, Apple, Walnuts, Honey, Fresh Thyme Leaves, Turmeric Powder, Vegetable Stock, Salt, Black Pepper Powder, Walnuts",13,0,50,50,2,Parsi Recipes,Main Course,Vegetarian
South Indian Style Vegetable Kurma Recipe,"Mixed Vegetables, Onion, Tomato, Green Chilli, Red Chilli Powder, Coriander Powder, Turmeric Powder, Black Pepper Powder, Salt, Cinnamon Stick, Cardamom, Cloves, Ginger Garlic Paste, Fresh Coconut, Poppy Seeds, Cashew Nuts, Sunflower Oil, Salt, Coriander",19,15,45,60,4,South Indian Recipes,Lunch,Vegetarian
Maharashtrian Multigrain Thalipeeth Recipe,"Whole Wheat Flour, Ragi Flour, Gram Flour, Bajra Flour, Rolled Oats Or Instant Oats, Methi Leaves, Sesame Seeds, Green Chilli, Ginger, Asafoetida, Curd, Sunflower Oil, Salt",13,25,30,55,4,Maharashtrian Recipes,Indian Breakfast,Vegetarian
Kerala Style Vattayapam Recipe (Steamed Coconut Rice Cakes Recipe),"Rice, Cooked Rice, Fresh Coconut, Cumin Seeds, Active Dry Yeast, Sugar, Salt, Cardamom, Ghee, Raisins",10,500,45,545,4,Kerala Recipes,South Indian Breakfast,Vegetarian
Italian Style Potato And Cucumber Salad Recipe,"Potato, English Cucumber, Onion, Tomato, Basil Leaves, Parsley Leaves, Dried Oregano, Black Olives, Salt, Black Pepper Powder, Extra Virgin Olive Oil",11,10,30,40,3,Italian Recipes,Dinner,Vegetarian
Moong Sprouts Usal Recipe,"Green Moong Sprouts, Onion, Tomato, Carrot, Mustard Seeds, Cumin Seeds, Asafoetida, Green Chilli, Ginger, Lemons, Turmeric Powder, Coriander Powder, Maharashtrian Goda Masala, Sugar, Salt, Sunflower Oil",16,20,20,40,4,South Indian Recipes,Snack,Vegetarian
Apple Empanadas Recipe,"Apples, Cinnamon Powder, Nutmeg Powder, Brown Sugar, Vanilla Extract, Puff Pastry Sheet, All Purpose Flour, Caster Sugar",8,15,30,45,4,Continental,Dessert,Vegetarian
Karnataka Style Bassaru Recipe - Dill flavored Coconut Rasam,"Arhar Dal, Dill Leaves, Poppy Seeds, Whole Black Peppercorns, Onion, Dry Red Chilli, Fresh Coconut, Garlic, Mustard Seeds, Dill Leaves",10,10,45,55,4,Karnataka,Lunch,Vegetarian
Spicy Cabbage Rice Recipe (South Indian Style Mutta Kose Sadham Recipe),"Cooked Rice, Ghee Oil As Required, Cumin Seeds, Onion, Cabbage, Green Chilli, Red Chilli Powder, Turmeric Powder, Sambar Powder, Coriander, Salt",11,20,45,65,4,Indian,Lunch,Vegetarian
Dal Vangi Recipe,"Arhar Dal, Brinjals, Green Chilli, Garlic, Cumin Seeds, Dry Coconut, Kokum, Jaggery, Goda Masala, Asafoetida, Curry Leaves, Rye, Turmeric Powder, Salt, S Of Green Coriander, Oil",16,10,45,55,4,Maharashtrian Recipes,Lunch,High Protein Vegetarian
Creamy Garlic Mashed Potatoes Recipe,"Potato, Heavy Whipping Cream, Garlic, Milk, Butter, Salt, Black Pepper Powder",7,10,30,40,2,Italian Recipes,Side Dish,Vegetarian
Fujian Style Hot Dry Noodle Recipe,"Wheat Noodles, Tahini, Sesame, Light Soy Sauce, Dark Soy Sauce, Water, Chinese  Spice Powder, Honey, Salt, Mooli Mullangi, Garlic, Spring Onion Greens",12,5,25,30,4,Chinese,Main Course,Vegetarian
Mulakootal Recipe (Vegetables In Coconut Gravy),"Yellow Moong Dal, Mixed Vegetables, Turmeric Powder, Water, Salt, Fresh Coconut, Dry Red Chilli, Sunflower Oil, Mustard Seeds, Dry Red Chilli, White Urad Dal, Curry Leaves",12,25,45,70,4,South Indian Recipes,Lunch,Vegetarian
Buckwheat Crepes Stuffed With Spinach And Eggs Recipe,"Buckwheat Flour, Milk, Whole Eggs, Nutmeg, Butter Ghee, Salt, Water, Butter Gheecoat The Pan, Spinach, Whole Eggs, Onion, Ginger Garlic Paste, Green Chilli, Coriander, Salt, Sunflower Oil",16,30,20,50,4,Continental,World Breakfast,Gluten Free
Rosemary Chicken Rice Recipe With Spicy Tomato Garlic Sauce,"Rice, Extra Virgin Olive Oil, Garlic, Onion, Rosemary, Salt, Chicken Breasts, Carrot, Extra Virgin Olive Oil, Garlic, Basil Leaves, Homemade Tomato Puree, Salt, Sugar, Tabasco Original, Paprika Powder, Fresh Cream",17,15,30,45,2,Continental,Main Course,Non Vegeterian
Elaneer Rasam Recipe - Tender Coconut Rasam,"Tomato, Tender Coconut Water, Fresh Coconut, Tamarind, Curry Leaves, Asafoetida, Turmeric Powder, Rasam Powder, Salt, Water, Coriander, Ghee, Mustard Seeds, Cumin Seeds, Mint Leaves",15,10,30,40,4,South Karnataka,Lunch,Vegetarian
Green Beans Fry Recipe,"Green Beans, Asafoetida, Cumin Seeds, Green Chilli, Red Chilli Powder, Turmeric Powder, Coriander Powder, Sunflower Oil, Salt",9,10,30,40,2,Indian,Lunch,Vegetarian
Palak Baingan Ki Sabzi ,"Brinjal, Spinach, Ginger, Garlic, Cumin Seeds, Curry Leaves, Coriander Powder, Teaspoon Red Chilli Powder, Asafoetida, Salt",10,10,30,40,4,Indian,Dinner,Vegetarian
Karwar Style Muga Ambat Recipe (Moong Sprouts in Coconut Curry),"Green Moong Sprouts, Tamarind Paste, Turmeric Powder, Sugar, Salt, Fresh Coconut, Dry Red Chilli, Coriander, Sunflower Oil, Mustard Seeds, Asafoetida, Curry Leaves  Torn",12,10,15,25,4,Karnataka,Side Dish,High Protein Vegetarian
Malvani Kurkuri Bhindi Recipe,"Ladyfinger, Peanuts, Oil, Salt, Coriander Seeds, Dry Red Chilies, Cumin Seeds, Fennel, Rye, Celery, Whole Pepper, Nutmeg Powder, Naga Kesar, Asafoetida, Cinnamon, , Star Anise, Stone Flower, Large Cardamom",19,10,20,30,4,Malvani,Dinner,Vegetarian
Spinach Lemon Spaghetti Recipe,"Chicken Breasts, Tomato, Spinach, Garlic, Butter, Extra Virgin Olive Oil, Lemon Juice, Red Chilli Flakes, Paprika Powder, Spaghetti Pasta, Salt",11,15,15,30,2,Italian Recipes,Dinner,Vegetarian
Nepali Aloo Tareko Recipe,"Potato, Methi Seeds, Ajwain, Dry Red Chilli, Turmeric Powder, Ginger Garlic Paste, Coriander Powder, Red Chilli Powder, Sichuan Peppercorns, Mustard Oil, Salt",11,5,20,25,4,Nepalese,Side Dish,Vegetarian
Mangalore Style Southe Gatti/Southekayi kadubu Recipe (Steamed Cucumber Dumplings),"Idli Rice, Fresh Coconut, Cucumber, Sugar, Salt",5,10,20,30,4,Mangalorean,South Indian Breakfast,Vegetarian
Kashmiri Style Shami Mutsch Recipe - Minced Lamb Cutlets In Yogurt Gravy,"Mutton, Kashmiri Red Chilli Powder, Fennel Powder, Dry Ginger Powder, Garlic, Corn Flour, Garam Masala Powder, Mustard Oil, Salt, Mustard Oil, Bay Leaves, Dry Red Chilli, Turmeric Powder, Garam Masala Powder, Curd, Kashmiri Red Chilli Powder, Coriander Powder, Fennel Powder, Dry Ginger Powder, Black Cardamom, Garam Masala Powder, Sugar, Salt",23,20,60,80,4,Kashmiri,Side Dish,Non Vegeterian
Dhaba Mutton Recipe-Spicy Mutton Gravy,"Mutton, Garlic, Onion, Curd, Cumin Powder, Coriander Powder, Cloves, Sunflower Oil, Green Chilli, Ginger, Coriander, Tomato, Bay Leaves, Cardamom, Red Chilli Powder, Turmeric Powder, Salt",17,10,180,190,4,North Indian Recipes,Dinner,Non Vegeterian
Kathirikai Poondu Pirattal Recipe,"G Brinjal, Onion, Garlic, Tomato, Turmeric Powder, Mustard, Lentils, Asafoetida, Curry Leaves, Dry Red Chili, Oil, Salt, Coriander Seeds, Cumin Seeds, Fennel Seeds, Black Pepper Powder, Dry Red Chilli   Curry Leaves",17,15,30,45,4,Chettinad,Lunch,Vegetarian
Chettinad Style Mixed Vegetable Recipe,"Cabbage, Beans, Carrots, Potato, Onion, Mustard, Curry Leaves, Coconut, Dry Red Chilli, Cumin Seeds, Aniseed",11,15,20,35,4,Tamil Nadu,Lunch,Vegetarian
Bendekayi Puli Koddel Recipe - Lady Finger In Coconut Tamarind Curry,"Bhindi, Salt, Sunflower Oil, Fresh Coconut, Methi Seeds, Cumin, Dry Red Chilli, Coriander, Sesame Seeds, Rice, Garlic, Tamarind Water, Turmeric Powder, Jaggery, Water, Sunflower Oil, Mustard Seeds, Ssp Asafoetida, Dry Red Chilli, Curry Leaves",20,10,20,30,4,Mangalorean,Side Dish,Vegetarian
Eggless Whole Wheat Pineapple Muffins Recipe,"Whole Wheat Flour, Baking Powder, Pineapple Juice, Pineapple, Curd, Sugar, Vanilla Extract, Sunflower Oil",8,20,40,60,6,Continental,Snack,Vegetarian
Vegan Cucumber Semolina Cake Recipe,"Sooji, Cucumbers, Ghee, Sugar, Cardamom Powder, Saffron Strands, Coconut Milk, Badam, Slivered Almonds",9,10,50,60,6,Middle Eastern,Dessert,Vegetarian
Kashmiri Style Gaad T Tamatar Recipe - Fish Curry,"Fish Fillet, Turmeric Powder, Salt, Lemon Juice, Dry Ginger Powder, Fennel Powder, Black Cardamom, Cloves, Kashmiri Red Chilli Powder, Asafoetida, Garam Masala Powder, Homemade Tomato Puree, Salt, Mustard Oil",14,10,45,55,4,Kashmiri,Dinner,Non Vegeterian
Peanut Butter Oat Almond Energy Bar Recipe,"Dates, Peanut Butter, Chocolate Chips, Rolled Oats, Vanilla Extract, Multigrain Digestive Oat Biscuits",6,35,0,35,4,Continental,Snack,Vegetarian
Whole Wheat Cupcakes Recipe,"Whole Wheat Flour, Butter, Whole Eggs, Caster Sugar, Baking Powder, Baking Soda, Vanilla Extract, Buttermilk, Chocolate Ganache",9,20,40,60,6,Continental,Dessert,Vegetarian
Spirulina Protein Energy Balls with Ragi Recipe,"Dates, Apricots, Badam, Pistachios, Ragi Flour, Flax Seed Powder, Peanut Butter, Sunflower Oil, Spirulina",9,15,0,15,4,Continental,Snack,High Protein Vegetarian
Potato Saagu Recipe For Rava Idli,"Potato, Onion, Green Chilli, Ginger, Curry Leaves, Mustard, White Urad Dal, Tablespoon Chana Dal, Asafoetida, Turmeric Powder, Coriander Powder, Green Coriander, Sugar, Lemon Juice, Salt, Oil",16,20,35,55,4,South Indian Recipes,South Indian Breakfast,Vegetarian
Ammani Kozhukkattai Recipe,"Rice, Salt, Turmeric Powder, Sambar Powder, Asafoetida, Coconut Oil, Coconut Oil, Mustard Seeds, Dry Red Chilli, Curry Leaves",10,20,30,50,4,South Indian Recipes,Snack,Vegetarian
Sindhi Tidali Dal Recipe,"Chana Dal, Green Moong Dal, White Urad Dal, Salt, Turmeric Powder, Green Chilli, Tomato, Ginger, Coriander, Ghee, Cumin Seeds, Asafoetida, Garlic, Red Chilli Powder",14,119,30,149,4,Sindhi,Main Course,High Protein Vegetarian
Shahi Paratha Recipe,"Whole Wheat Flour, All Purpose Flour, Sunflower Oil, Salt, Potato, Gram Flour, Salt, Turmeric Powder, Red Chilli Powder, Ajwain, Sweet Chutney, Green Chutney, Curd, Onion, Tomato, Green Chilli, Coriander, Sev",18,40,20,60,4,North Indian Recipes,North Indian Breakfast,Vegetarian
Paneer And Badam Milk Recipe,"Paneer, Badam, Badam, Milk, Saffron Strands, Cardamom Powder, Sugar",7,10,50,60,2,Indian,Snack,Vegetarian
Maachli Jaisamandi Recipe - Rajasthani Style Fish In Creamy Gravy,"Fish Fillet, Salt, Gram Flour, Turmeric Powder, Cumin Powder, Water Make The Batter, Sunflower Oil, Coriander, Mint Leaves, Green Chilli, Lemon Juice, Fresh Cream, Curd, Turmeric Powder, Red Chilli Powder, Cumin Seeds, Sunflower Oil",17,30,15,45,2,Rajasthani,Lunch,Non Vegeterian
Dark Chocolate Sandesh (Shondesh) Dipped In Chocolate Recipe,"Milk, Lemon Juice, Dark Chocolate, Condensed Milk, Cocoa Powder, Vanilla Extract, Raisins, Slivered Almonds",8,15,35,50,10,Bengali Recipes,Dessert,Vegetarian
Beetroot And Tofu Patty Recipe,"Beetroot, Potato, Tofu, Gram Flour, Badam, Green Chilli, Chaat Masala Powder, Cumin Powder, Coriander, Salt, Sunflower Oil Shallowfry",11,30,60,90,4,Indian,Snack,High Protein Vegetarian
Chicken In White Gravy Recipe,"Boneless Chicken, Curd, Butter, Onion, Ginger Garlic Paste, White Pepper Powder, Salt, Cardamom, Cinnamon Powder, Coriander, Tomato, Coriander",12,5,20,25,4,Indian,Lunch,High Protein Non Vegetarian
"Mushroom, Paneer And Soya Chunk Samosa Recipe","Button Mushrooms, Soy Granules, Paneer, Onion, Sunflower Oil, Green Chilli, Fennel Seeds, Spring Roll Wrappers, Black Pepper Powder, Kashmiri Red Chilli Powder, Turmeric Powder, Coriander Powder, Garam Masala Powder, Chaat Masala Powder, Salt, Sunflower Oil",16,10,50,60,4,North Indian Recipes,Appetizer,High Protein Vegetarian
Karwar Style Yerappe Ani Recipe- Rice and Black Split Gram Fried Dumpling,"Rice, Black Urad Dal, Fresh Coconut, Asafoetida, Salt, Sunflower Oil",6,480,30,510,4,Karnataka,South Indian Breakfast,Vegetarian
Vegetarian Chinese Sizzler With Noodles & Momos Recipe,"Veg Hakka Noodles, Onion, Ginger, Carrot, Green Bell Pepper, Cabbage, Green Beans, Spring Onion, Black Pepper Powder, Soy Sauce, Red Chilli Sauce, Chilli Vinegar, Salt, Sunflower Oil, Cabbage, Carrot, Onion, Ginger, All Purpose Flour, Salt, Sunflower Oil, Water, Tofu, Sesame Seeds, Garlic, Spring Onion, Veeba Sweet Chilli Sauce, Sriracha Sauce, Salt, Green Beans, Red Chilli Sauce",31,30,60,90,3,Chinese,Dinner,Vegetarian
Khatte Pudina Aloo Recipe - Tangy Mint Potatoes,"Potato, Mint Leaves, Coriander, Green Chilli, Amchur, Red Chilli Powder, Turmeric Powder, Salt Sendha Namak, Cumin Seeds, Ghee Cooking Oil As Required",10,10,15,25,2,Indian,Lunch,Vegetarian
Red Chilli Thecha - Maharashtrian Style Red Chilli Chutney Recipe,"Fresh Red Chilli, Garlic, Sunflower Oil, Mustard Seeds, Asafoetida, Salt",6,10,20,30,4,Maharashtrian Recipes,Side Dish,Vegetarian
North Kanara Sweet And Sour Raw Mango Chutney Recipe,"Raw Mangoes, Red Chilli, Coconut, Asafoetida, Jaggery, Kashmiri Red Chilli Powder, Salt, Oil",8,25,5,30,4,Coastal Karnataka,Side Dish,Vegetarian
Instant Rava Pizza Uttapam Recipe,"Sooji, Rice Flour, Water, Salt, Tomato, Red Yellowgreen Bell Pepper, Onion, Black Olives, Mozzarella Cheese, Dried Oregano, Red Chilli Flakes, Sunflower Oil Cook",12,15,20,35,4,South Indian Recipes,South Indian Breakfast,Vegetarian
Crispy Amla Gawar Phali Sabzi Recipe,"Gawar Phali, Green Chilli, Mustard Seeds, Amla, Cumin Seeds, Asafoetida, Turmeric Powder, Coriander Powder, Whole Black Peppercorns, Salt, Mustard Oil",11,15,30,45,4,Rajasthani,Dinner,Vegetarian
Narangi Pulao Recipe  - Orange Flavoured Rice,"Rice, Ghee, Star Anise, Cinnamon Stick, Cloves, Cardamom, Fennel Seeds, Fresh Orange Juice, Saffron Strands, Milk, Salt, Sugar",12,10,25,35,4,Awadhi,Main Course,Vegetarian
Healthy Homemade Ragi Dosa Recipe,"Idli Rice, Ragi Seeds, White Urad Dal, Methi Seeds, Salt, Ghee Make Dosas As Needed",6,360,30,390,12,South Indian Recipes,South Indian Breakfast,Vegetarian
The Goan Kelyachyo Fodi Recipe (Spicy & Crispy Pan Fried Banana Recipe),"Raw Banana, Red Chilli Powder, Turmeric Powder, Salt, Sunflower Oil, Red Chilli Powder, Turmeric Powder, Sooji, Salt",9,15,40,55,12,Goan Recipes,Snack,Vegetarian
Crunchy Baked Cheese Crisps Recipe,"Mozzarella Cheese Parmesan Cheese, Cumin Seeds",2,5,6,11,4,Continental,Appetizer,Vegetarian
Veggie Penne Pasta Recipe In Creamy Roasted Carrot Sauce,"Del Monte Penne Rigate Pasta, Basil Leaves, Mozzarella Cheese, Carrot, Red Bell Pepper, Yellow Bell Pepper, Garlic, Milk, Salt, Extra Virgin Olive Oil",10,20,30,50,4,Italian Recipes,Lunch,Vegetarian
Delicious Butter Chicken Pani Puri Recipe,"Chicken Breasts, Hung Curd, Ginger, Garlic, Turmeric Powder, Coriander Powder, Red Chilli Powder, Amchur, Cumin Powder, Garam Masala Powder, Honey, Mustard Oil, Homemade Tomato Puree, Tomato Ketchup, Kasuri Methi, Mint Leaves, Coriander, Lemon Juice, Salt, Butter, Hung Curd, Green Chutney, Puris Used For Pani Puri, Pickled Onion, Coriander, Coriander",26,30,20,50,15,Indian,Appetizer,Non Vegeterian
Vegetarian Wonton Soup Recipe,"Momos  Only Filled And Shaped, Clove Garlic, Ginger, Green Chilli, Spring Onion, Light Soy Sauce, Sesame, Rice Vinegar",8,20,30,50,2,Fusion,Side Dish,Vegetarian
Stuffed Mooli Paratha Recipe With Radish Greens,"Mooli Mullangi, Sunflower Oil, Cumin Seeds, Ginger, Ajwain, Gram Flour, Coriander, Red Chilli Powder Green Chilli Paste, Salt, Whole Wheat Flour, Mooli Ke Patte, Salt, Sunflower Oil Gheesmear While Cooking",13,15,45,60,4,North Indian Recipes,Indian Breakfast,Diabetic Friendly
Parwal Masala Recipe - No Onion No Garlic Recipe,"Parwal, Tomato, Watermelon Seeds, Ginger, Red Chilli Powder, Coriander Powder, Cumin Powder, Garam Masala Powder, Bay Leaf, Salt, Sunflower Oil",11,10,20,30,4,North Indian Recipes,Lunch,Vegetarian
Nadan Meen Kari Recipe (Kerala Style Fish Curry),"Sardine Fish, Shallots, Tomato, Ginger Garlic Paste, Turmeric Powder, Red Chilli Powder, Coriander Powder, Fennel Powder, Black Pepper Powder, Kokum, Coconut Oil, Mustard Seeds, Curry Leaves, Salt, Water",15,10,35,45,4,Kerala Recipes,Lunch,High Protein Non Vegetarian
Green Beans In Pomegranate Cream Sauce Recipe,"Green Beans, Garlic, Honey, Fresh Cream, Fresh Pomegranate Fruit Kernels, Pomegranate Sauce, Salt And Pepper, Spring Onion Greens, Coconut Milk, Extra Virgin Olive Oil",10,15,10,25,4,Continental,Appetizer,Gluten Free
Sweet Mixed Fruits And Granola Breakfast Wraps Recipe,"Whole Wheat Flour Tortilla, Strawberries, Ripe Bananas, Peaches, Fresh Raspberries, Honey, Granola Mixed Nuts, Britannia Cream Cheese",8,15,10,25,2,Continental,World Breakfast,Vegetarian
Vazhaipoo Podimas Recipe  - Banana Flower Poriyal/ Sabzi,"Banana Flower, Curd, Mustard Seeds, White Urad Dal, Pearl Onion, Green Chilli, Curry Leaves, Turmeric Powder, Fresh Coconut, Salt, Sesame",11,25,30,55,4,Tamil Nadu,Lunch,Vegetarian
Paan Gulkand Sharbat Recipe,"Betel Leaves, Gulkand, Honey, Milk, Mixed Nuts, Ice Cubes",6,10,0,10,4,Indian,Snack,Vegetarian
Aloo Chaat Recipe With Baked Beans,"Breads, Baked Beans, Potato, Cumin Powder, Onion, Green Chilli, Chaat Masala Powder, Green Coriander, Save, Green Chutney, Tamarind Chutney, Pomegranate Serve, Salt, Olive Oil Roast Bread",14,30,25,55,4,Indian,Snack,Vegetarian
Doddapatre Tambuli Recipe (Karpooravalli Thayir Pachadi),"Indian Borage, Curd, Cumin Seeds, Whole Black Peppercorns, Dessicated Coconut, Salt, Ghee",7,15,15,30,2,Indian,Side Dish,Vegetarian
Open Burger with Vegetable Patty Recipe,"Burger Buns, Tomato, Onion, Nutralite Cheesy Garlic Mayo, Mustard Sauce, Iceberg Lettuce, Aloo Bhujia, Nutralite Garlic & Oregano Spread, Potato, Green Peas, Carrot, Salt, Red Chilli Powder, Corn Flour, Lemon Juice, Green Chilli, Whole Wheat Bread Crumbs, Nutralite Garlic & Oregano Spread",18,10,90,100,4,Continental,Main Course,Vegetarian
Chow Chow Verkadalai Masala Curry Recipe - Chayote Peanut Poriyal Recipe,"Chow Chow, Raw Peanuts, Tomato, Sambar Powder, Jaggery, Amchur, Turmeric Powder, Mustard Seeds, Curry Leaves, Bay Leaf, Salt, Coriander, Sunflower Oil",13,20,20,40,4,South Indian Recipes,Lunch,Vegetarian
Indian Chicken Keema Sliders Recipe,"Onion, Tomato, Chicken, Curd, Ginger, Garlic, Green Chilli, Red Chilli Powder, Black Pepper Powder, Lemon Juice, Coriander, Salt, Burger Buns, Butter, Cumin Seeds, Cinnamon Stick, Cloves, Black Pepper Corns, Coriander, Star Anise, Kashmiri Dry Red Chilli",21,10,50,60,12,Indian,Appetizer,Non Vegeterian
Pazhutha Manga Pachadi Recipe - Kerala Style Ripe Mango Curry,"Mango, Salt, Turmeric Powder, Red Chilli Powder, Curry Leaves, Mustard Seeds, Fresh Coconut, Jaggery",8,10,25,35,4,Kerala Recipes,Lunch,Vegetarian
Chocolate Espresso Custard Pudding Recipe,"Milk, Caster Sugar, Corn Flour Flour, Cocoa Powder, Espresso Powder, Chocolate Bar, Heavy Whipping Cream, Fresh Cherries, Chocolate Shavings",9,5,45,50,4,Continental,Dessert,Vegetarian
Karnataka Style Utthatthi Payasa Recipe - Dry Dates Kheer,"Dates, Dates, Milk Coconut Milk For Vegan Option, Jaggery, Cardamom Powder, Cashew Nuts, Badam, Pistachios, Ghee",9,10,25,35,3,Coastal Karnataka,Dessert,Vegetarian
Ganne Ke Ras Ki Kheer Recipe - Sugarcane Kheer Recipe,"Sugarcane Juice, Foxtail Millet, Milk, Cashew Nuts, Badam, Ghee",6,30,20,50,4,North Indian Recipes,Dessert,Vegetarian
Kaanole Recipe (Maharashtrian Steamed Wheat Flour Sweet),"Whole Wheat Flour, Jaggery, Sooji, Sunflower Oil, Salt",5,30,20,50,8,Maharashtrian Recipes,Dessert,Vegetarian
"Black Rice, Barley & Flax Seeds Congee Recipe","Black Rice, Barley, Flax Seeds, Congee Powder, Spinach Leaves, Rasam Powder, Garlic, Extra Virgin Olive Oil, Water",9,20,20,40,8,Asian,Dinner,Vegetarian
Prawn Masala Kozhukattai Recipe - Prawn Masala Dumplings,"Prawns, Onion, Tomato, Green Chilli, Ginger, Garlic, Curry Leaves, Coriander, Mustard Seeds, Dry Red Chilli, Turmeric Powder, Fresh Coconut, Coconut Oil, Salt, Water, Rice Flour, Water, Salt",18,50,45,95,4,South Indian Recipes,Appetizer,Non Vegeterian
Goan Style Mushroom Shagoti Recipe,"Button Mushrooms, Whole Black Peppercorns, Cloves, Ajwain, Fennel Seeds, Cumin Seeds, Coriander, Cinnamon Stick, Dry Red Chilli, Poppy Seeds, Fresh Coconut, Sunflower Oil, Onion, Garlic, Salt, Tamarind Paste",16,20,15,35,4,Goan Recipes,Main Course,Vegetarian
Aloo Poha Recipe,"Poha, Potato, Green Peas, Rye, Cumin Seeds, Curry Leaves  Finely, Onion, Green Chilli, Ginger, Turmeric Powder, Asafoetida, Sugar, Lemonjuiced, Peanuts, Oil, Coriander, Pomegranate Serve, Salt, Sweet Corn, Green Mung",20,20,30,50,4,Indian,Indian Breakfast,Vegetarian
Vagharelo Bhaat Recipe - Gujarati Masala Rice,"Cooked Rice, Curd, Gram Flour, Cumin Seeds, Mustard Seeds, Curry Leaves  Finely, Asafoetida, Turmeric Powder, Red Chilli Powder, Sunflower Oil, Coriander, Salt",12,15,20,35,3,Gujarati Recipesï»¿,Dinner,Vegetarian
Chinese Style Stir Fried Water Chest Nut with Vegetables Recipe,"Singhade, Button Mushrooms, Red Bell Pepper, Yellow Bell Pepper, Broccoli, Bok Choy, Bean Sprouts, Stalk Spring Onion Greens, Soy Sauce, Black Pepper Powder, Salt, Sunflower Oil",12,20,35,55,4,Chinese,Appetizer,Diabetic Friendly
No Onion No Garlic Raw Tomato Sabzi Recipe,"Tomato, Green Chilli, Cumin Seeds, Curry Leaves, Turmeric Powder, Red Chilli Powder, Coriander Powder, Salt Sendha Namak As Per Paste, Jaggery, Sunflower Oil, Garam Masala Powder",11,10,20,30,6,Indian,Dinner,Vegetarian
Kumaoni Style Palak & Methi Ka Kapa Recipe,"Spinach, Methi Leaves, Rice Flour, Cumin Seeds, Dry Red Chilli, Red Chilli Powder, Asafoetida, Turmeric Powder, Sugar, Salt, Mustard Oil",11,10,15,25,4,Uttarakhand-North Kumaon,Lunch,Vegetarian
Paka Kela Ki Sabzi ,"Banana, Flour, Asafoetida, Turmeric Powder, Red Chilli Powder, Cumin Seeds, Mustard Seeds, Curry Leaves, Oil, Salt",10,10,20,30,4,Gujarati Recipesï»¿,Dinner,Vegetarian
Soya Chunks Masala in Coconut Milk ,"Soya Chunks, Drain The Water, Tomato, Onion, Green Chilli, Garlic, Cumin Seeds, Curry Leaf, Turmeric Powder, Red Chilli Powder, Coriander Powder, Curry Powder, Coconut Milk, Oil, Salt",15,10,30,40,4,South Indian Recipes,Dinner,High Protein Vegetarian
Kerala Style Egg Roast Curry Recipe,"Eggs, Onion, Tomato, Garlic, Ginger, Curry Leaves, Hot Masala Powder, Black Pepper Powder, Kashmiri Red Chilli Powder, Coriander Powder, Turmeric Powder, Coriander Leaves, Water, Tablespoon Coconut Oil, Salt",15,20,40,60,3,Kerala Recipes,Side Dish,Eggetarian
Chikkudukaya Vepudu Recipe-Broad Beans Masala Poriyal,"Avarekai, Onion, Tomato, Ginger, Garlic, Curry Leaves, Red Chilli Powder, Turmeric Powder, Coriander Powder, Salt, Sunflower Oil",11,15,20,35,4,Andhra,Lunch,Vegetarian
Bendekaayi Gojju (Lady Finger In Coconut Curry) Recipe,"Bhindi, Dry Red Chilli, Mustard Seeds, Fresh Coconut, Mustard Seeds, Green Chilli, Coriander, Chana Dal, Tamarind Paste, Jaggery",10,15,30,45,4,South Indian Recipes,Lunch,Vegetarian
Carrot Methi Pachadi ,"Fenugreek, Carrot, Oil, White Urad Dal, Mustard, Cumin Seeds, Dry Red Chilli, Green Chilli, Turmeric Powder, Tamarind Paste, Jaggery, Salt",12,10,10,20,4,South Indian Recipes,Dinner,Vegetarian
"Kala Chana Salad Recipe With Carrots, Cucumber & Tomatoes ","Kala Chana, Carrots, Cucumber, Tomato, Coriander, Green Chilli, Lemon Juice, Salt",8,15,0,15,4,Indian,Side Dish,High Protein Vegetarian
Kesar Pista Lassi Recipe,"Yogurt, Sugar Honey, Cream, , Pistachios, Ice",6,15,10,25,2,Indian,Side Dish,Vegetarian
Grated Beetroot Chilli Paratha Recipe,"Beetroot, Whole Wheat Flour, Cumin Powder, Red Chilli Powder, Green Chilli, Ghee, Salt, Water",8,20,20,40,4,Indian,Indian Breakfast,Vegetarian
Kale White Bean Hummus Dip Recipe,"White Beans, Kale, Cumin Powder, Garlic Powder, Lemon Juice, Salt, Tahini Greek Yogurt",7,10,10,20,2,Mediterranean,Snack,High Protein Vegetarian
Five Spice Bean Burger Recipe,"Cinnamon Stick, Cloves, Fennel Seeds, Star Anise, Whole Black Peppercorns, Great Northern Beans, Whole Wheat Bread Crumbs, Whole Egg, Black Pepper Powder, Garlic Powder, Coriander, Soy Sauce, Sugar, Lemon Juice, Extra Virgin Olive Oil, Sunflower Oil, Chinese  Spice Powder, Salt, Burger Buns, Cheese Slices, Classic Mayonnaise, Mixed Greens",22,10,20,30,3,Continental,Dinner,Vegetarian
Lemon Poppy Seeds Pancakes recipe,"All Purpose Flour, Sugar, Salt, Baking Powder, Baking Soda, Lemon Zest, Poppy Seeds, Buttermilk, Water, Vanilla Extract, Lemon Juice, Whole Egg, Sunflower Oil, Butter",14,20,15,35,8,Continental,World Breakfast,Eggetarian
Beetroot Halwa Recipe (With Vegan Option),"Beetroot, Ghee Extra Virgin Coconut Oil, Cardamom, Almond Milk, Pistachios, Dates",6,30,30,60,2,Indian,Dessert,Vegetarian
South Indian Style Fish Curry Recipe,"Fish Fillet, Turmeric Powder, Onion, Tomato, Garlic, Ginger, Green Chilli, Tablespoon Coriander, Tablespoon Sunflower Oil, Red Chilli Powder, Mustard Seeds, Methi Seeds, Curry Leaves, Coriander Powder, Cumin Powder, Salt",16,20,20,40,4,South Indian Recipes,Lunch,Non Vegeterian
Almond Butter & Fig Muesli Bar Recipe,"Muesli, Coconut Oil, Badam, Honey, Vanilla Extract, Dried Figs, P Salt",7,30,60,90,4,Continental,Snack,High Protein Vegetarian
Tripura Style Kosoi Bwtwi Recipe - Sauteed Tofu & Green Beans Stir Fry With Garlic,"Green Beans, Onion, Garlic, Green Chilli, Tofu, Sunflower Oil, Salt, Black Pepper Powder",8,10,20,30,3,North East India Recipes,Side Dish,High Protein Vegetarian
Namak Para Recipe (Deep Fried Biscuits),"All Purpose Flour, Ghee, Salt, Ajwain, Chilled Water Knead The Dough, Sunflower Oil",6,15,30,45,5,Indian,Snack,Vegetarian
Basic Homemade Bread Recipe Using Yeast,"All Purpose Flour, Active Dry Yeast, Sugar, Salt, Lukewarm Water, Sunflower Oil Any Oil",6,240,30,270,2,Continental,World Breakfast,Vegetarian
Tomato Quinoa Recipe  - With A South Indian Twist,"Quinoa, Water, Mustard Seeds, Garlic, Ginger, Pearl Onion, Cardamom Powder, Tomato, Red Chilli Powder, Turmeric Powder, Sambar Powder, Garam Masala Powder, Salt, Curry Leaves, Coriander, Ghee",16,10,25,35,4,South Indian Recipes,Lunch,High Protein Vegetarian
Garlic And Pepper Mushroom Stir Fry Recipe,"Button Mushrooms, Pearl Onion, Garlic, Black Pepper Powder, Salt, Sunflower Oil, Coriander",7,10,25,35,4,Indian,Snack,Vegetarian
Homemade Chocolate Sauce Recipe,"Sugar, Cocoa Powder, All Purpose Flour, Salt, Milk, Butter, Vanilla Extract",7,5,10,15,1,Continental,Dessert,Vegetarian
Zafrani Mawa Cake Recipe (Saffron Flavored Milk Cake),"Vivatta Maida, Whole Eggs, Butter, Khoya, Milk, Caster Sugar, Baking Powder, Cardamom Powder, Vanilla Extract, Saffron Strands",10,15,45,60,1,Indian,Snack,Eggetarian
Thecha Paniyaram Recipe,"Idli Dosa Mixture, Semolina, Coriander, Salt, Oil, Garlic, Almonds, Green Chilli, Green Coriander",9,10,20,30,4,Maharashtrian Recipes,Snack,Vegetarian
Chamadumpa Vepudu Recipe - Andhra Style Colocasia Stir Fry,"Colocasia Root, Rice Flour, Red Chilli Powder, Turmeric Powder, Amchur, Salt, Sunflower Oil, White Urad Dal, Mustard Seeds, Dry Red Chilli, Curry Leaves, Sunflower Oil",12,10,25,35,4,Andhra,Lunch,Vegetarian
Savoury Oatmeal Porridge Recipe,"Instant Oats, Water, Onion, Green Chilli, Carrot, Green Beans, Green Bell Pepper, Turmeric Powder, Salt, Coriander, Sunflower Oil, Mustard Seeds",12,10,20,30,2,Indian,One Pot Dish,Diabetic Friendly
Mushroom Masala Cheese Omelette Recipe,"Whole Eggs, Button Mushrooms, Onion, Green Chilli, Tomato, Black Olives, Cheese, Coriander, Salt And Pepper, Sunflower Oil",10,10,10,20,1,Continental,Indian Breakfast,High Protein Non Vegetarian
Carrot Methi Jowar Thepla Recipe,"Carrot, Methi Leaves, Cumin Seeds, Red Chilli Powder, Turmeric Powder, Cumin Seeds, Jowar Flour, Whole Wheat Flour, Salt, Sunflower Oil",10,10,25,35,4,Gujarati Recipesï»¿,North Indian Breakfast,Vegetarian
Roasted Beet Feta Salad Recipe,"Beetroot, Feta Cheese, Onion, Red Wine Vinaigrette, Honey, Garlic, Extra Virgin Olive Oil, Basil Leaves, Salt And Pepper",9,10,30,40,4,Continental,Side Dish,Vegetarian
Karnataka Style Beetroot Palya Recipe,"Beetroot, Fresh Coconut, Garlic, Onion, Sambar Powder, Mustard Seeds, Asafoetida, Dry Red Chilli, Curry Leaves, Sunflower Oil, Salt",11,10,10,20,4,Karnataka,Side Dish,Vegetarian
Mushroom Poha Cutlets Recipe,"Button Mushrooms, Poha, Green Beans, Carrot, Ginger, Green Chilli, Red Chilli Powder, Garam Masala Powder, Chaat Masala Powder, Amchur, Coriander, Whole Wheat Bread Crumbs Semolina, Salt, Sunflower Oil",14,15,5,20,4,Indian,Appetizer,High Protein Vegetarian
Strawberry Mojito Recipe,"Sugar, Strawberries, Mint Leaves, Lemon Juice, Rum, Aerated Water",6,10,20,30,2,Continental,Vegetarian,High Protein Vegetarian
Lab E Shireen Recipe,"Milk, Semiya, Khoya, Rasgulla, Sugar, Jello, Rooh Afza Sharbat, Fresh Cream, Custard Powder, Mixed Fruits",10,20,30,50,2,Arab,Dessert,Vegetarian
Homemade Vegetable Stock Recipe,"Extra Virgin Olive Oil, Carrots, Stalks Spring Onion, Onion, Button Mushrooms, Stalk Celery, Garlic  Peeled, Parsley Leaves, Whole Black Peppercorns, Bay Leaves, Raisins, Water",12,0,30,30,2,Continental,Dinner,Vegetarian
Welsh Apple Cinnamon Scones Recipe,"Whole Wheat Flour, All Purpose Flour, Sugar, Salt, Cinnamon Powder, Baking Powder, Chilled Butter, Apple, Pecans, Curd, Milk, Cinnamon Powder, Honey Glaze",13,10,40,50,2,Continental,Dessert,Vegetarian
Whole Wheat Lachha Paratha Recipe-Multilayered Layered Indian Flat Bread,"Whole Wheat Flour, Salt, Ghee Layer And Cooking Parathas",3,30,40,70,3,Indian,Dinner,Diabetic Friendly
Oats And Coconut Dosa Recipe,"Whole Wheat Flour, Rice Flour, Oats Flour, Fresh Coconut, Salt, Jaggery, Sunflower Oil, Green Chilli, Ginger, Curry Leaves, Asafoetida, Whole Black Peppercorns",12,10,15,25,4,South Indian Recipes,South Indian Breakfast,Vegetarian
Spicy Crab Masala Recipe,"Crabs, Fresh Coconut, Coriander, Cinnamon Stick, Bay Leaf, Ginger, Garlic, Onion, Onion, Tomato, Kashmiri Red Chilli Powder, Red Chilli Powder, Coriander Powder, Turmeric Powder, Salt, Sunflower Oil",16,50,30,80,2,Kerala Recipes,Lunch,High Protein Non Vegetarian
How To Make Preserved Pineapple Recipe,"Pineapple, Water, Sugar, Orange Liquor Any Alcohol Of Choice",4,15,15,30,8,Continental,Vegetarian,Diabetic Friendly
Avocado Raita ,"Avocado, Green Chilli, , Peanuts, Coriander, Cumin Powder, Chaat Masala Powder, Salt, Red Chili Powder",9,15,20,35,4,Indian,Side Dish,Vegetarian
Asian Carrot Ginger Lentil Soup Recipe,"Mixed Lentils, Carrot, Onion, Green Bell Pepper, Celery, Ginger, Fresh Red Chilli, Vegetable Stock, Dark Soy Sauce, Sesame, Sesame Seeds, Spring Onion, Salt",13,15,20,35,2,Asian,Dinner,High Protein Vegetarian
Spicy Potatoes and Lady's Finger Stir Fry ,"Okra, Potato, Cumin Seeds, Curry Leaves, Asafoetida, Red Chili Powder, Turmeric Powder, Coriander Powder, Salt, Oil",10,10,35,45,3,North Indian Recipes,Lunch,Vegetarian
Soft & Delicious Ragi Mudde Recipe - Karnataka Style Ragi Balls,"Hot Water, Ragi Flour, Ghee, Salt",4,10,45,55,4,Karnataka,Lunch,Diabetic Friendly
Oats Uppu Kozhukattai Recipe,"Instant Oats, Rice Flour, Sunflower Oil, Salt, Water, Fresh Coconut, Dry Red Chilli, Chana Dal, White Urad Dal, Mustard Seeds, Asafoetida, Sunflower Oil, Curry Leaves, Salt",14,15,15,30,4,South Indian Recipes,Snack,Vegetarian
Spinach Watermelon Salad Recipe,"Spinach, Watermelon, Black Grapes, Feta Cheese, Walnuts, Extra Virgin Olive Oil, Lemon Juice, Honey, Black Pepper Powder, Salt",10,15,0,15,4,Continental,Appetizer,Vegetarian
Arbi Shimla Mirch Sabzi Recipe â Colocasia Capsicum Sabzi,"Colocasia Root, Green Bell Pepper, Tomato, Ginger, Coriander Powder, Turmeric Powder, Red Chilli Powder, Garam Masala Powder, Salt, Sunflower Oil",10,20,35,55,4,North Indian Recipes,Main Course,No Onion No Garlic (Sattvic)
Chaman Qaliya ,"Paneer, Rye, Saffron, Bay Leaf, Lentil Sugar, , Milk, Water, Turmeric Powder, Cumin Powder, Fennel Powder, Salt, Cardamom Powder, Coriander",14,20,25,45,4,Kashmiri,Dinner,Vegetarian
Paneer Shashlik Sizzler Recipe,"Paneer, Red Yellow And Green Bell Peppers, Onion, Tomato, Ginger Garlic Paste, Vinegar, Soy Sauce, Tomato Ketchup, Garam Masala Powder, Black Pepper Powder, Sugar, Salt, Cooked Rice, Green Peas, Cumin Seeds, Ginger, Green Chilli, Cloves, Cardamom, Cinnamon Stick, Bay Leaf, Salt, Ghee, Iceberg Lettuce, Onion, Tomato",26,30,10,40,4,Continental,Main Course,Vegetarian
Milagu Sadam ,"Rice, Onion, Grind    Whole Pepper    Curry Leaves, Mustard, , Cashew Nuts, Oil, Salt",8,15,15,30,2,South Indian Recipes,Lunch,Vegetarian
Karwar Style Surana Bhaji Recipe - Hot and Sour Yam Dry Curry,"Elephant Yam, Mustard Seeds, Dry Red Chilli, Methi Seeds, Asafoetida, Turmeric Powder, Tamarind Paste, Jaggery, Salt, Sunflower Oil",10,10,20,30,4,Karnataka,Side Dish,Vegetarian
Spiced Apple Crumble Recipe with Greek Yogurt,"Apples, Brown Sugar, Butter, Cinnamon Powder, Hung Curd, Sprig Extract Of Natural Bourbon Vanilla, Sugar, Whole Wheat Flour, Instant Oats, Brown Sugar, Butter, Cinnamon Powder, Nutmeg Powder",13,20,15,35,6,Continental,Dessert,Vegetarian
Meat Ka Achaar Recipe (Goat Pickle),"Mutton, Garlic, Turmeric Powder, Red Chilli Powder, Kalonji, Fennel Seeds, Cumin Seeds, Black Cardamom, Cloves, Bay Leaf, Cinnamon Stick, Salt, Lemon Juice, Mustard Oil",14,15,50,65,1,Indian,Side Dish,Non Vegeterian
Tindora Sambharo Recipe,"Tindora, Red Chilli Powder, Fenugreek Seeds, Rye, Asafoetida, Oil, Lemon, Turmeric Powder, Salt, Carrot, Capsicum",11,20,15,35,1,Gujarati Recipesï»¿,Side Dish,Vegetarian
Rajasthani Ghevar Recipe,"All Purpose Flour, Ghee, Milk, Water, Turmeric Powder, Sugar, Water",7,15,30,45,2,Rajasthani,Snack,Vegetarian
Chanar Paturi ,"Cottage Cheese, Mustard, Coconut, Green Chilli, Mustard Oil, Turmeric Powder, Lemon Juice, Teaspoon Sugar, Salt, As Per",10,10,40,50,4,Bengali Recipes,Lunch,High Protein Vegetarian
Karwar Style Kalingana Polo Recipe - Watermelon Rind Dosa,"Dosa Rice, Watermelon Rind, Fresh Coconut, Poha, Salt",5,60,10,70,4,Karnataka,South Indian Breakfast,Vegetarian
Tirunelveli Sodhi Kuzhambu Recipe - Mixed Vegetable Stew,"Yellow Moong Dal, Potato, Green Beans, Carrot, Green Peas, Cauliflower, Drumstick, Pearl Onion, Tomato, Mustard Seeds, Cumin Seeds, Sunflower Oil, Asafoetida, Lemon Juice, Fresh Coconut, Ginger, Garlic, Green Chilli, Curry Leaves, Coriander, Salt",21,20,25,45,4,Tamil Nadu,Lunch,Vegetarian
Potato And Cauliflower In Peanut Curry Recipe,"Cauliflower, Potato, Raw Peanuts, Green Chilli, Mustard Seeds, Bay Leaf, Tomato, Ginger, Gram Flour, Curd, Coriander Powder, Red Chilli Powder, Turmeric Powder, Cumin Powder, Garam Masala Powder, Salt, Coriander, Sunflower Oil",18,15,30,45,4,Indian,Side Dish,No Onion No Garlic (Sattvic)
Pudina Idli Recipe,"Idli Dosa Mixture, Green Cardamom",2,10,20,30,6,South Indian Recipes,South Indian Breakfast,Vegetarian
Amtekai Gojju Recipe - Indian Hog Plum Curry,"Hog Plum, Jaggery, Turmeric Powder, Salt, Fresh Coconut, White Urad Dal, Chana Dal, Methi Seeds, Cumin Seeds, Sesame Seeds, Dry Red Chilli, Asafoetida, Curry Leaves, Coconut Oil, Mustard Seeds, Asafoetida, Curry Leaves",17,20,30,50,4,Indian,Lunch,Vegetarian
Ribs With Guava Barbecue Sauce Recipe,"Lamb Ribs   Ribs Attachedbone, Sugar, Kosher Salt, Mustard Seeds, Chinese  Spice Powder, Black Pepper Powder, Cinnamon Powder, Clove Powder, Vinegar, Lemon Juice, Guava Puree, Apple Cider Vinegar, Homemade Tomato Puree, Lemon Juice, Soy Sauce, Worcestershire Sauce, Ginger, Spring Onion, Clove Garlic, Water, Salt, Black Pepper Powder, Red Chilli Flakes",23,40,120,160,2,Continental,Main Course,Non Vegeterian
Makhana Moongphali Ki Kadhi Recipe - Navratri Fasting/Vrat Recipe,"Phool Makhana, Raw Peanuts, Curd, Rajgira Flour, Green Chilli, Sugar, Coriander, Salt Rock Salt, Ghee, Cumin Seeds, Cinnamon Stick",11,20,30,50,4,North Indian Recipes,Lunch,No Onion No Garlic (Sattvic)
Sindhi Dharan Ji Kadhi Recipe - Besan Tikkis In Tomato Gravy,"Onion, Tomato, Ginger Garlic Paste, Green Chilli, Coriander Powder, Cumin Seeds, Cloves, Sunflower Oil, Coriander, Gram Flour, Onion, Curd, Khuskhus, Salt, Dry Red Chilli, Water",16,10,20,30,4,Sindhi,Lunch,Vegetarian
Paprika Chicken Skewers Recipe,"Chicken Breasts, Red Bell Pepper, Yellow Bell Pepper, Green Bell Pepper, Garlic, Paprika Powder, Salt, Whole Black Peppercorns, Extra Virgin Olive Oil",9,10,45,55,4,Continental,Appetizer,Non Vegeterian
Chinese Spiced Noodle Cutlets Recipe,"Veg Hakka Noodles, Onion, Carrot, Green Bell Pepper, Spring Onion Greens, Ginger, Garlic, Black Pepper Powder, Coriander Powder, Corn Flour, Coriander, Sunflower Oil Shallow Fry, Salt",13,20,20,40,4,Indo Chinese,Appetizer,Vegetarian
Bloomed Potato Cheesy Muffins Recipe,"Potato, All Purpose Flour, Sunflower Oil, Water, Dried Oregano, Black Pepper Powder, Dried Basil Leaves, Rosemary, Butter, Mozzarella Cheese, Coriander, Salt",12,10,25,35,4,Indian,Appetizer,Vegetarian
Tomato Noodle Soup recipe,"Tomato, Onion, Extra Virgin Olive Oil, Salt, Black Pepper Powder, Hakka Noodles",6,10,30,40,2,Fusion,Dinner,Vegetarian
Farfalle Pasta Recipe In a Creamy Mushroom Sauce,"Del Monte Farfalle Pasta, Button Mushrooms, Garlic, Dried Oregano, Salt, Cheese Spread, Milk, Basil Leaves",8,20,20,40,4,Italian Recipes,Dinner,Vegetarian
Aloo Bhindi ,"Okra, Potato, Turmeric Powder, Red Chilli Powder, Salt, Mustard Oil, Khus Khus, Rye",8,20,40,60,4,Bengali Recipes,Lunch,Vegetarian
Vegetarian Thai Green Curry With Tofu Recipe,"Onion, Green Bell Pepper, Red Bell Pepper, Yellow Bell Pepper, Broccoli, Green Beans, Bok Choy, Carrots, Baby Corn, Sugar Snap Peas, Tofu, Brown Sugar, Soy Sauce, Extra Virgin Olive Oil, Coriander, Roasted Peanuts, Lemon, Thai Green Curry Paste, Coconut Milk",19,10,60,70,4,Thai,Lunch,Vegetarian
Indian Style Kala Chana Salad Recipe,"Kala Chana, Onion, Tomato, Green Chilli, Coriander, Salt, Black Pepper Powder, Lemon Juice, Red Chilli Powder, Black Pepper Powder, Lemon Juice",11,10,20,30,4,North Indian Recipes,Appetizer,High Protein Vegetarian
Stuffed Portobello Mushrooms Recipe With 7 Grain Rice And Sprout Salad,"Portobello Mushrooms, Cup Walnuts Pine Nuts, Cup Parmesan Cheese, Wild Rice, Barley, Quinoa, Brown Rice, Bulgur Wheat, Hulled Wheat, Sorghum, Vegetable Stock, Salt, Butter, Green Moong Sprouts Alfalfa Sprouts, Lemon Juice, Extra Virgin Olive Oil, Fresh Orange Juice Can Juice, Salt And Pepper",18,0,60,60,4,Continental,Dinner,Vegetarian
Lemon Oats ,"Oats, Water, Onion, Curry Leaves, Green Chilli, Ginger, Lemon Juice, Oil, Mustard, Cumin Seeds, , Chana Dal, Asafoetida, Turmeric Powder, Salt, Coriander, Peanuts Garnish",17,10,20,30,2,Indian,Indian Breakfast,Vegetarian
"Beetroot, Amla And Pudina Juice Recipe","Beetroots, Amla, Mint Leaves, Tomato, Cucumber, Black Pepper Powder, Black Salt",7,10,0,10,4,Indian,Snack,Vegetarian
Chakkra Pongali Recipe (Andhra Style Sweet Pongal),"Rice, Yellow Moong Dal, Sugar, Milk, Water, Dessicated Coconut, Cardamom Powder, Ghee, Mixed Dry Fruits",9,5,30,35,2,Andhra,Dessert,Vegetarian
Andhra Style Sarva Pindi/Gine Pindi Recipe (Rice Flour and Chana Dal Flatbread Recipe),"Rice Flour, Chana Dal, Curry Leaves, Sesame Seeds, Onion, Green Chilli, Ginger Garlic Paste, Turmeric Powder, Red Chilli Powder, Salt",10,10,30,40,4,Andhra,South Indian Breakfast,Vegetarian
Sun Dried Tomato Olive Pasta In Fresh Tomato Sauce Recipe,"Spaghetti Pasta, Garlic, Sundried Tomato, Kalmatta Olives, Extra Virgin Olive Oil, Salt And Pepper, Dried Oregano, Red Chilli Flakes, Tomato, Onion, Garlic, Paprika Powder, Dry Mix Herbs, Salt And Pepper, Sugar, Extra Virgin Olive Oil, Extra Virgin Olive Oil",17,15,30,45,4,Italian Recipes,Main Course,Vegetarian
Pudina & Dhaniya Raita Recipe,"Curd, Coriander, Mint Leaves, Salt, Mustard Seeds, Cumin Seeds, Curry Leaves, Asafoetida, Sunflower Oil",9,10,5,15,4,North Indian Recipes,Side Dish,Vegetarian
Bengali Doi Potol Recipe (Pointed Gourd In Thick Yogurt Based Gravy),"Pointed Gourd, Curd, Gram Flour, Ginger, Poppy Seeds, Mustard Seeds, Cumin Seeds, Dry Red Chilli, Bay Leaf, Cumin Powder, Coriander Powder, Turmeric Powder, Red Chilli Powder, Green Chilli, Garam Masala Powder, Mustard Oil Cook, Sugar, Salt",18,15,25,40,4,Bengali Recipes,Side Dish,Vegetarian
No Onion No Garlic Oriya Style Moong Dalma Recipe,"Yellow Moong Dal, Mixed Vegetables, Panch Phoran Masala, Fresh Coconut, Ginger, Turmeric Powder, Dry Red Chilli, Bay Leaf, Cumin Seeds, Ghee, Salt, Water, Cumin Seeds, Mustard Seeds, Fennel Seeds, Kalonji, Methi Seeds",17,20,40,60,4,Oriya Recipes,Lunch,Vegetarian
Spicy Eggplant & Capsicum Curry (Indo-Chinese Fusion Recipe),"Brinjal, Green Bell Pepper, Broccoli, Sesame, Garlic   Into Small Pieces, Onion, Soy Sauce, Red Chilli Sauce, Corn Flour, Homemade Hoisin Sauce, Chilli Vinegar, Water, Salt, Coriander, Roasted Peanuts",15,25,45,70,6,Indo Chinese,Lunch,Vegetarian
Whole Grain and Oat Buns Recipe (Healthy Dinner Rolls),"Milk, Lukewarm Water, Butter, Active Dry Yeast, Honey, Whole Wheat Flour, Oats Flour, All Purpose Flour, Salt, Milk, Instant Oats",11,100,20,120,4,Continental,Side Dish,Vegetarian
Kanchipuram Masala Dosa Recipe With Soya Dosa Batter,"Idli Rice, Soybeans, White Urad Dal, Methi Seeds, Chana Dal, Salt, Water, Onion, Carrot, Beetroot, Green Chilli, Sunflower Oil, Sunflower Oil, Mustard Seeds, White Urad Dal, Chana Dal, Onion, Ginger, Green Chilli, Curry Leaves, Potato, Salt, Turmeric Powder, Idli Dosa Podi, Ghee",25,360,30,390,12,South Indian Recipes,South Indian Breakfast,Vegetarian
Thakkali Gotsu Recipe | Thakkali Curry | Spicy & Tangy Tomato Gravy,"Sesame, Mustard Seeds, Curry Leaves, Garlic, Pearl Onion, Tomato, Tamarind, Sambar Powder, Turmeric Powder, Salt, Jaggery",11,10,20,30,4,South Indian Recipes,Lunch,Vegetarian
Raw Mango Raita Recipe,"Mango, Curd, Salt, Red Chilli Powder, Cumin Powder, Mustard Seeds, Curry Leaves, Asafoetida, Sunflower Oil",9,15,15,30,2,Indian,Side Dish,Vegetarian
Dal Fry Recipe,"Chana Dal, Water, Onion, Tomato, Green Chilli, Ginger, Garlic, Kasuri Methi, Turmeric Powder, Salt, Lemon Wedges, Coriander, Kashmiri Red Chilli Powder, Asafoetida, Mustard Seeds, Fennel Seeds, Cumin Seeds, Dry Red Chilli, Ghee",19,10,20,30,2,North Indian Recipes,Lunch,High Protein Vegetarian
Chicken Schezwan Momo - Steamed Chicken Dumpling Recipe,"Chicken, Carrot, Onion, Green Bell Pepper, Ginger, Garlic, Schezwan Sauce, Black Pepper Powder, Salt, Stalk Spring Onion Greens, All Purpose Flour, Salt",12,25,25,50,2,Chinese,Appetizer,Non Vegeterian
Himachali Mutton Rara Recipe,"Mutton, Mustard Oil, Cumin Seeds, Onion, Garlic, Ginger, Turmeric Powder, Red Chilli Powder, Green Chilli, Tomato, Ghee, Lemon Juice, Coriander, Sugar, Salt, Mace, Cloves, Cinnamon Stick, Bay Leaf, Cardamom, Coriander, Cumin Seeds, Nutmeg",23,10,100,110,6,Himachal,Dinner,Non Vegeterian
Raw Banana Bajji Recipe- Balekai Bajji | Vazhakkai Bajji,"Raw Banana, Gram Flour, Turmeric Powder, Red Chilli Powder, Asafoetida, Salt",6,10,10,20,4,South Indian Recipes,Appetizer,Vegetarian
Tofu Masala Rice Recipe (Tofu Pulao),"Rice, Ghee, Cumin Seeds, Bay Leaf, Cinnamon Stick, Cloves, Green Chilli, Ginger Garlic Paste, Onion, Tomato, Red Yellowgreen Bell Pepper, Red Chilli Powder, Turmeric Powder, Coriander Powder, Garam Masala Powder, Tofu, Salt, Coriander",18,20,45,65,4,Indian,Dinner,Vegetarian
Mango Iced Tea Recipe,"Mango, Tea Bags, Lemon Juice, Sugar, Water, Lemon, Mint Leaves, Ice Cubes, Mango",9,10,30,40,4,Continental,Snack,Vegetarian
Smoky Eggplant Soup Recipe,"Eggplant, Vegetable Stock, Pepper Powder, Cumin Powder, Salt, Salt, Almonds, Oil",8,0,45,45,4,Continental,Appetizer,Vegetarian
Poblano Chili Rellenos Recipe - Baked Cheese Stuffed Chilies,"Poblano Chilli, Extra Virgin Olive Oil, Onion, Garlic, Cheddar Cheese Paneer Grated, Dried Thyme Leaves, Black Pepper Powder, Tarragon, Dried Oregano, Gram Flour, Whole Egg, Tomato, Garlic, Tomato Ketchup, Sugar, Red Chilli Flakes, Dried Oregano",17,10,40,50,4,Mexican,Appetizer,Vegetarian
Thandai Phirni Recipe - A Delicious Indian Rice Dessert,"Milk, Rice, Sugar, Cardamom Powder, Thandai Powder, Pistachios, Badam, Saffron Strands, Badam, Cashew Nuts, Fennel Seeds, Poppy Seeds, Melon Seeds, Black Pepper Powder, Cardamom",15,10,30,40,4,Indian,Dessert,Vegetarian
Whole Wheat Vegetable Chilla (Cheela) Recipe,"Whole Wheat Flour, Water, Onion, Tomato, Green Bell Pepper, Turmeric Powder, Cumin Seeds, Red Chilli Powder, Coriander, Salt, Sunflower Oil",11,20,30,50,4,North Indian Recipes,North Indian Breakfast,High Protein Vegetarian
Layered Paneer Butter Masala Biryani Recipe,"Rice, Water, Ghee, Cardamom, Cloves, Star Anise, Cinnamon Stick, Whole Black Pepper Corns, Salt, Bay Leaf, Fried Onion, Coriander, Mint Leaves, Paneer, Tomato, Fresh Cream, Onion, Ginger, Garlic, Green Chilli, Cardamom Powder, Cumin Powder, Garam Masala Powder, Red Chilli Powder, Kasuri Methi, Honey, Salt, Sunflower Oil, Cashew Nuts",29,20,25,45,4,North Indian Recipes,Main Course,Vegetarian
Spicy Aloo Naan Recipe,"All Purpose Flour, Active Dry Yeast, Curd, Sugar, Sunflower Oil, Salt, Potato, Onion, Green Chilli, Turmeric Powder, Garam Masala Powder, Coriander, Amchur, Salt, Garlic",15,70,10,80,4,North Indian Recipes,Lunch,Vegetarian
Carrot Ginger Juice Recipe,"Carrots, Ginger, Lemon Juice, Honey",4,10,5,15,1,World Breakfast,Vegetarian,Vegetarian
Bullseye On Toast Recipe,"Whole Eggs, Whole Wheat Brown Bread, Salt, Black Pepper Powder Sprinkle, Butter Grease",5,5,10,15,2,Continental,World Breakfast,Eggetarian
Noodle Soup Recipe with Vegetables,"Hakka Noodles, Carrot, Green Beans, Clove Garlic, Ginger, Thai Red Chilli, Stalks Celery, Dark Soy Sauce, Rice Vinegar, Red Chilli Sauce, Honey, Vegetable Stock, Coconut Milk, Coriander, Salt",15,20,40,60,4,Chinese,Main Course,Vegetarian
Chole Pindi Recipe (Spicy Chickpea Curry),"Kala Chana, Cardamom, Onion, Cinnamon Stick, Ginger, Green Chilli, Homemade Tomato Puree, Turmeric Powder, Anardana Powder, Coriander Powder, Garam Masala Powder, Amchur, Red Chilli Powder, Sunflower Oil, Salt, Ginger, Lemon",17,500,120,620,4,North Indian Recipes,Lunch,Vegetarian
Traditional Amritsari Chole Recipe | Punjabi Chole Masala,"Kabuli Chana, Tea Bags, Ghee, Onion, Green Chilli, Ginger, Tomato, Turmeric Powder, Amchur, Black Salt, Salt, Coriander, Cinnamon Stick, Cloves, Brown Cardamom, Methi Seeds, Cumin, Coriander, Dried Anardana Seeds, Dry Red Chilli, Whole Black Pepper Corns",21,20,30,50,3,Punjabi,Dinner,High Protein Vegetarian
Bengali Kosha Mangsho Recipe-Slow Cooked Mutton Curry,"Potato, Cloves, Garlic, Ginger, Onion, Tomato, Garam Masala Powder, Coriander Powder, Red Chilli Powder, Cumin Powder, Lemon Juice, Salt, Mutton, Ginger, Garlic, Red Chilli Powder, Turmeric Powder, Coriander Powder, Cumin Powder, Curd, Whole Black Peppercorns, Mustard Seeds, Cinnamon Stick, Cardamom, Bay Leaves, Salt",26,140,45,185,4,Bengali Recipes,Lunch,Non Vegeterian
Besan And Green Pea Cheela Recipe,"Gram Flour, Green Peas, Onion, Garlic, Green Chilli, Ginger, Coriander, Ajwain, Fennel Seeds, Sesame Seeds, Red Chilli Powder, Garam Masala Powder, Salt, Sunflower Oil, Water",15,10,30,40,4,North Indian Recipes,Snack,Vegetarian
Palak Pappu Recipe - Andhra Style Palakura Pappu - Dal Palak,"Arhar Dal, Onion, Green Chilli, Ginger, Turmeric Powder, Water, Salt, Spinach Leaves, Ghee, Mustard Seeds, Cumin Seeds, White Urad Dal, Garlic, Dry Red Chilli, Curry Leaves",15,10,40,50,4,South Indian Recipes,Lunch,High Protein Vegetarian
Tok Dal Recipe (Bengali Style Masoor Dal),"Mango, Masoor Dal, Turmeric Powder, Green Chilli, Salt, Mustard Oil, Bay Leaf, Dry Red Chilli, Panch Phoran Masala",9,10,45,55,4,Bengali Recipes,Lunch,Vegetarian
Smoky Eggplant Soup Recipe,"Aubergine, Vegetable Stock, Black Pepper Powder, Cumin Powder, Salt, Salt, Badam, Sunflower Oil",8,0,45,45,4,Continental,Appetizer,Vegetarian
Bihari Style Baingan Ka Chokha ,"Eggplant, Tomato, Green Chili, Onion, Ginger, Asafoetida, Mustard Oil, Salt",8,10,30,40,3,Bihari,Lunch,Vegetarian
Chettinad Sweet Paniyaram Recipe,"Idli Dosa Batter, Rice Rava, Jaggery, Fresh Coconut, Cardamom Powder, Salt, Water, Sunflower Oil",8,5,20,25,10,Chettinad,Snack,Vegetarian
Tofu & Veggie Coleslaw Sandwich Recipe,"Whole Wheat Brown Bread, Tofu, Soy Sauce, Honey, Red Chilli Sauce, Sesame Seeds, Cabbage, Carrot, Cucumber, Coriander, Hung Curd, Mustard Sauce, Lemon Juice, Sugar, Salt And Pepper",15,20,15,35,2,Continental,Lunch,Vegetarian
Gujarati Kobi Marcha No Sambharo Recipe - Cabbage & Bell Pepper Stir Fry,"Cabbage, Onion, Green Bell Pepper, Mustard Seeds, Methi Seeds, Turmeric Powder, Sunflower Oil, Lemon Juice, Salt",9,10,10,20,4,Gujarati Recipesï»¿,Side Dish,Vegetarian
Tandoori Paneer Tikka Skillet Pizza Recipe,"Whole Wheat Flour, Extra Virgin Olive Oil, Active Dry Yeast, Sugar, Salt, Lukewarm Water, Paneer, Coal, Mozzarella Cheese, Hung Curd, Mint Leaves, Garlic, Ginger, Homemade Tomato Puree, Fennel Seeds, Ajwain, Saffron Strands, Cumin Powder, Coriander Powder, Chaat Masala Powder, Garam Masala Powder, Red Chilli Powder, Turmeric Powder, Black Salt, Salt",25,10,35,45,2,Fusion,Dinner,High Protein Vegetarian
Mixed Vegetable Idli Upma Recipe,"Idli, Pearl Onion, Green Bell Pepper, Green Chilli, Ginger, Carrot, Green Beans, Turmeric Powder, Mustard Seeds, White Urad Dal, Curry Leaves, Sesame, Mint Leaves, Salt",14,10,10,20,4,South Indian Recipes,South Indian Breakfast,Vegetarian
Chenai Kizhangu Poricha Kootu Recipe (Tamil Nadu Style Yam Cooked in Coconut Gravy),"Elephant Yam, Yellow Moong Dal, Chana Dal, Fresh Coconut, Cumin Seeds, Fennel Seeds, Whole Black Peppercorns, Green Chilli, Ginger, Garlic, Onion, Dry Red Chilli, Turmeric Powder, Salt, Tamarind Water, Bay Leaf, Cloves, Cinnamon Stick, Sunflower Oil",19,15,30,45,4,Tamil Nadu,Side Dish,Vegetarian
Sindhi Dal Pakwan Recipe - A Delicious Sindhi Breakfast,"Chana Dal, Turmeric Powder, Garam Masala Powder, Red Chilli Powder, Amchur, Sugar, Salt, Ghee, Asafoetida, Cumin Seeds, Green Chilli, Curry Leaves",12,10,45,55,2,Sindhi,Lunch,Vegetarian
Thai Chicken Massaman Curry Recipe,"Fennel Seeds, Coriander, Black Pepper Corns, Cinnamon Stick, Cardamom, Dry Red Chilli, Onion, Ginger, Garlic, Lemon Grass, Chicken Breasts, Coconut Milk, Palm Sugar, Tamarind Paste, Fish Sauce, Potato, Carrot, Sunflower Oil, Salt",19,15,40,55,4,Thai,Lunch,Non Vegeterian
Tomato Jam Recipe,"Tomato, Sugar, Salt, Lemon Juice, Cinnamon, ",6,5,45,50,10,Indian,World Breakfast,Vegetarian
Carrots & Sweet Potato Stuffed Paratha Recipe,"Whole Wheat Flour, Salt, Sunflower Oil, Carrots, Sweet Potato, Cumin Powder, Green Chilli, Coriander, Salt",9,25,20,45,4,North Indian Recipes,Indian Breakfast,Vegetarian
Vazhaipoo Paruppu Usili Recipe - Banana Flower Paruppu Usili,"Banana Flower, Water, Curd, Sesame, Turmeric Powder, Arhar Dal, Dry Red Chilli, Turmeric Powder, Salt, Water, Sesame, Curry Leaves, Mustard Seeds, Ssp Asafoetida, White Urad Dal",15,20,20,40,4,South Indian Recipes,Side Dish,High Protein Vegetarian
Chilli Paneer Momo Recipe,"All Purpose Flour, Water Knead, Paneer, Green Bell Pepper, Spring Onion, Garlic, Ginger, Green Chilli, Soy Sauce, Tomato Ketchup, Sweet And Spicy Red Chilli Sauce, Sunflower Oil, Salt",13,15,20,35,4,Indo Chinese,Appetizer,Vegetarian
Sticky Date Pudding With Butterscotch Sauce Recipe,"Dates, Milk, Baking Soda, Brown Sugar, Cinnamon Powder, Salt, All Purpose Flour, Butter, Brown Sugar, Butter, Fresh Cream, Vanilla Extract Butterscotch Essence, Walnuts Pecans",13,20,30,50,5,Continental,Dessert,Vegetarian
Spicy Quinoa Upma Recipe,"Quinoa, Cumin Seeds, Turmeric Powder, Onion, Tomato, Green Chilli, Green Peas, Curry Leaves, Ginger, Coriander, Extra Virgin Olive Oil, Salt, Salt",13,10,40,50,2,Indian,Indian Breakfast,High Protein Vegetarian
Italian Style Spinach Tomato Soup Recipe,"Onion, Carrots, Spinach  Boiled And ;  Tomato  Puree, Garlic, Vegetable Stock, Red Chilli Flakes, Paprika Powder, Oregano, Black Pepper Powder, Salt, Olive Oil, Pasta, Vinegar",13,15,30,45,4,Italian Recipes,Dinner,Vegetarian
Andhra Dondakaya Ulli Kura Karam Recipe | Andhra Kovakkai Fry,"Tindora, Sunflower Oil, Mustard Seeds, Curry Leaves, Turmeric Powder, Asafoetida, Salt, Coriander, Chana Dal, White Urad Dal, Sesame Seeds, Cumin Seeds, Methi Seeds, Dry Red Chilli, Tamarind, Roasted Peanuts",16,10,25,35,4,Andhra,Side Dish,Vegetarian
Bengali Bhetki Begum Bahar Recipe (Spicy Fish Fillets Curry),"Fish Fillet, Onion, Homemade Tomato Puree, Ginger, Green Chilli, Poppy Seeds, Cashew Nuts, Turmeric Powder, Coriander Powder, Kashmiri Red Chilli Powder, Cumin Powder, Garam Masala Powder, Nutmeg Powder, Mace, Lemon Juice, Salt, Whole Eggs, Corn Flour, Ginger, Black Pepper Powder, Green Chilli",21,10,90,100,4,Bengali Recipes,Lunch,Non Vegeterian
Pineapple Jal Jeera Recipe,"Cumin Seeds  Roast, Dry Mint, Kashmiri Red Chilli, Whole Black Peppers, Asafetida, Amchoor Powder, Black Saltrock Salt, Salt Salt, Mint, Tamarind Paste, Green Coriander, Sugar, Pineapple, Water, Boondi Garnish",15,0,20,20,4,Maharashtrian Recipes,Appetizer,Vegetarian
Achari Paneer Masala Recipe,"Paneer, Onion, Tomato, Green Bell Pepper, Whole Cashews, Mustard Oil, Green Chilli, Asafoetida, Salt, Coriander, Fennel Seeds, Mustard Seeds, Methi Seeds, Kashmiri Dry Red Chilli, Kalonji, Cumin Seeds",16,15,15,30,5,North Indian Recipes,Lunch,High Protein Vegetarian
Steamed Cauliflower Curry Recipe (Healthy Stir Fry),"Cauliflower, Cumin Seeds, Curry Leaves, Salt, Black Pepper Powder, Sunflower Oil",6,10,20,30,4,Indian,Lunch,Vegan
Lauki Ki Kheer ,"Gourd  Grated, Milk, Sugar, Cardamom Powder, Dry Fruits, Ghee",6,10,25,35,4,Indian,Dessert,Vegetarian
Matar Kachori Recipe,"Whole Wheat Flour, Ghee, Salt, Green Peas, Green Chilli, Garlic, Ginger, Red Chilli Powder, Garam Masala Powder, Amchur, Chaat Masala Powder, Fennel Seeds, Kalonji, Turmeric Powder, Ghee, Salt, Gram Flour, Mustard Oil",18,30,90,120,4,North Indian Recipes,Snack,Vegetarian
Murungai Keerai Sambar Recipe - Drumstick Leaves Sambar,"Arhar Dal, Tamarind Water, Drumstick Leaves, Mooli Mullangi, Pearl Onion, Sambar Powder, Salt, Ghee, Mustard Seeds, Ssp Asafoetida",10,15,20,35,4,South Indian Recipes,Lunch,Diabetic Friendly
Methi Turai Ki Sabzi (Fenugreek Leaves And Ridge Gourd Stir Fry),"Ridge Gourd, Methi Leaves, Onion, Cumin Seeds, Dry Red Chilli, Garlic, Green Chilli, Coriander Powder, Turmeric Powder, Lemon, Garam Masala Powder, Sunflower Oil",12,10,20,30,4,Indian,Dinner,Vegetarian
No Bake Cocoa Oats Cookies Recipe,"Peanut Butter, Honey, Cocoa Powder, Instant Oats, Nutella Spread, Milk  For Binding",6,10,10,20,4,Continental,Dessert,Vegetarian
Chettinad Vegetable Pulao Recipe,"Basmati Rice, Pearl Onion, Garlic, Ginger, Green Chilli, Bay Leaves, Red Chilli Powder, Turmeric Powder, Carrot, Green Beans, Potato, Ghee, Cloves, Cinnamon Stick, Whole Black Peppercorns, Fennel Seeds, Coriander, Green Peas, Mint Leaves",19,15,45,60,4,Chettinad,Dinner,Vegetarian
Dry Fruits Suzhiyam (Boorelu) With Black Rice Recipe,"Sunflower Oil, White Urad Dal, Black Rice, Idli Rice, Sooji, Salt, Dry Fruits, Mixed Nuts, Ghee, Cardamom Powder, Water",11,10,410,420,4,Indian,Dessert,Vegetarian
No Onion No Garlic Raw Tomato Sabzi ,"Tomato, Green Chilies, Cumin Seeds, Curry Leaves, Turmeric Powder, Red Chilli Powder, , Salt   Jaggery  Make Powder, Oil, Garam Masala Powder",10,10,20,30,6,Indian,Dinner,Vegetarian
Eggless Double Chocolate Sugar Bite Cookies Recipe,"All Purpose Flour, Sugar, Dark Chocolate, Chocolate Chips, Baking Powder, Cocoa Powder, Butter, Milk",8,10,12,22,12,Continental,Snack,Vegetarian
Roasted Garlic Tomato Chutney Recipe,"Garlic, Tomato, Dry Red Chilli, Tamarind, Sunflower Oil, Salt, Sunflower Oil, Mustard Seeds, Curry Leaves, Asafoetida, Dry Red Chilli",11,10,5,15,4,South Indian Recipes,Side Dish,Vegetarian
à¤ªà¤¾à¤²à¤ à¤ªà¤ªà¥à¤ªà¥ à¤°à¥à¤¸à¤¿à¤ªà¥ -Spinach Dal ,"Arhar Dal, Mustard, Cumin Seeds, Fenugreek Seeds, Chickpea Lentils, Turmeric Powder, Curry Leaves, Small Asafoetida, Tamarind Paste, Tomato, Spinach, Green Chilli, Garlic, Onion, Salt, Oil",16,10,40,50,4,South Indian Recipes,Lunch,High Protein Vegetarian
Raw Mango Coconut Chutney Recipe,"Coconut, Of Raw Mango, Green Chilli, Salt, Water, Oil, Mustard, Dry Red Chilli, Of Curry Leaves, Raw Mango",10,15,10,25,4,South Indian Recipes,Side Dish,Vegetarian
Ridge Gourd Tambli Recipe - Spicy Ridge Gourd in Coconut Curry,"Ridge Gourd, Mustard Seeds, Curry Leaves, Green Chilli, Fresh Coconut, Asafoetida, Curd, Salt, Water",9,10,25,35,4,South Indian Recipes,Lunch,Vegetarian
Attukal Mochai Kuzhambu Recipe-Mutton Leg & Field Beans Gravy,"Mutton Legs, Avarekai, Small Brinjal, Tomato, Onion, Fresh Coconut, Roasted Gram Dal, Red Chilli Powder, Coriander Powder, Turmeric Powder, Fennel Seeds, Poppy Seeds, Cinnamon Stick, Cloves, Bay Leaf, Tamarind Paste, Salt, Coriander, Gingelly Oil, Mustard Seeds, Cumin Seeds, Curry Leaves, Asafoetida",23,60,60,120,4,Tamil Nadu,Side Dish,Non Vegeterian
Karwar Style Anasa Patal Bhaji Recipe-Pineapple cooked with coconut,"Pineapple, Turmeric Powder, Asafoetida, Kokum, Jaggery, Water, Salt, Dry Red Chilli, Coriander, Fresh Coconut",10,10,30,40,4,Karnataka,Side Dish,Vegetarian
15 minute Cauliflower Fried Rice Recipe,"Cauliflower, Carrot, Red Bell Pepper, Onion, Green Peas, Garlic, Tofu, Soy Sauce, Red Chilli Sauce, Spring Onion Greens",10,15,15,30,4,Indo Chinese,One Pot Dish,Vegan
Peshawari Karahi Gosht Recipe,"Mutton, Tomato, Ginger, Garlic, Dry Red Chilli, Green Chilli, Turmeric Powder, Garam Masala Powder, Curd, Salt, Ghee, Coriander",12,10,45,55,4,Pakistani,Side Dish,Non Vegeterian
Tofu Stir Fry Curry Recipe,"Sunflower Oil, Garlic, Ginger, Green Chilli, Onion, Tofu, Green Bell Pepper, Mixed Vegetables, Salt, Red Chilli Paste, Light Soy Sauce, Rice Wine Vinegar, Honey, Tomato Ketchup, Corn Flour, Water",16,30,10,40,4,Asian,Dinner,High Protein Vegetarian
Tandoori Aloo Tikka Recipe - Indian Spiced Roasted Smoked Potatoes,"Ghee, Baby Potato, Hung Curd, Gram Flour, Ginger, Garlic, Kasuri Methi, Turmeric Powder, Chaat Masala Powder, Garam Masala Powder, Mint Leaves, Salt, Coal, Chaat Masala Powder, Garam Masala Powder, Mint Leaves, Salt, Coal",18,30,30,60,4,North Indian Recipes,Appetizer,Vegetarian
Bajra & Dal Cheela Recipe (Spicy Pearl Millet  & Lentil Crepe Recipe),"Green Moong Dal, Chana Dal, Black Urad Dal, Bajra, Green Chilli, Ginger, Coriander, Asafoetida, Salt, Sunflower Oil",10,400,45,445,4,Indian,North Indian Breakfast,High Protein Vegetarian
Watermelon Panzanella Salad Recipe,"Baguette, Garlic Powder, Extra Virgin Olive Oil, Watermelon, Cucumber, Red Onion, Spinach, Balsamic Vinegar, Black Olives, Salt And Pepper",10,10,15,25,4,Italian Recipes,Appetizer,Vegetarian
Kela Besani Sabzi Recipe,"Raw Banana, Spoon Flour, Asafetida, Cumin Seeds, Turmeric Powder, Red Chilli Powder, Coriander Powder, Garam Masala Powder, Yogurt, Water, Salt, Oil  Coriander, Green Chili, Oil",14,10,30,40,4,North Indian Recipes,Lunch,No Onion No Garlic (Sattvic)
Amlechi Uddamethi Recipe - Goan Raw Mango Curry,"Mango, Jaggery, Tamarind Water, Fresh Coconut, Turmeric Powder, Dry Red Chilli, Whole Black Peppercorns, Sunflower Oil, White Urad Dal, Methi Seeds, Mustard Seeds, Asafoetida",12,10,30,40,2,Goan Recipes,Lunch,Vegetarian
Mozzarella Basil Sandwiches Recipe,"Panini Bread, Tomato, Mozzarella Cheese, Basil Leaves, Garlic, Walnuts, Extra Virgin Olive Oil, Salt",8,25,5,30,4,Continental,Snack,Vegetarian
Green Chutney Aloo Chaat Recipe,"Potato, Coriander, Mint Leaves, Green Chilli, Ginger, Lemon, Peanuts, Sugar, Salt, Cumin, Garam Masala Powder, Cumin Powder, Fresh Pomegranate Fruit Kernels, Sev, Chaat Masala Powder, Sunflower Oil",16,20,10,30,4,North Indian Recipes,Snack,Vegetarian
Italian Grissini Recipe- Homemade Breadsticks,"All Purpose Flour, Whole Wheat Flour, Active Dry Yeast, Milk, Honey Sugar, Extra Virgin Olive Oil, Red Chilli Flakes, Ajwain, Sesame Seeds, Salt, Lukewarm Water",11,140,15,155,4,Italian Recipes,Snack,Vegetarian
Restaurant Style Green Peas Masala Recipe,"Green Peas, Onion, Garlic, Green Chilli, Ginger  Finely, Tomato, Red Chilli Powder, Coriander Powder, Cumin Powder, Turmeric Powder, Garam Masala Powder, Salt, Sugar, Coriander, Cashew Nuts, Curd, Cinnamon Stick, Cardamom, Cloves, Bay Leaf, Sunflower Oil, Butter",22,20,30,50,3,North Indian Recipes,Main Course,Vegetarian
Cherupayar Thoran Recipe - Kerala Style Green Gram Sabzi,"Green Moong Dal, Onion, Green Chilli, Garlic, Fresh Coconut, Dry Red Chilli, Turmeric Powder, Cumin Seeds, Mustard Seeds, White Urad Dal, Coconut Oil, Curry Leaves, Coriander, Salt",14,10,20,30,2,South Indian Recipes,Side Dish,High Protein Vegetarian
Dhaba Style Dal Fry ,"Ghee, Asafoetida, Cumin Seeds, Rye, Cassia, Green Chilli, Long, Large Cardamom, Star Anees, Elaichi, Onion, Tomato, , Red Chilli Powder, Coriander Powder, Green Chilli, Of Green Coriander, Arhar Dal, Chana Dal, Masoor Dal, White Urad Dal, Yellow Moong Dal, Water, Salt, ",25,10,20,30,2,North Indian Recipes,Lunch,Vegetarian
Cucumber Tomato Corn Peanut Salad With Lemon Recipe,"Cucumber, Tomato, Onion, Sweet Corn, Green Chilli, Roasted Peanuts, Lemon Juice, Salt, Coriander",9,30,0,30,4,Indian,Side Dish,Vegetarian
Bharli Bhendi Recipe - Maharashtrian Style Stuffed Bhindi,"Bhindi, Fresh Coconut  Grated, Poppy Seeds, Red Chilli Powder, Turmeric Powder, Kashmiri Red Chilli Powder, Tamarind, Salt, Sunflower Oil, Mustard Seeds, Asafoetida",11,30,35,65,4,Maharashtrian Recipes,Lunch,Vegetarian
Cucumber Ginger Lemonade Recipe,"Cucumber   And Deseeded, Lemon Juice, Honey, Mint Leaves, Ginger, Aerated Water, Salt",7,10,5,15,1,Continental,Vegetarian,Vegetarian
Pyaz Wali Bhindi Recipe | Bhindi Do Pyaza - Okra Onion Stir Fry,"Bhindi, Mustard Oil Sunflower Oil, Ajwain, Cinnamon Stick, Bay Leaf, Onion, Turmeric Powder, Red Chilli Powder, Coriander, Amchur, Salt",11,10,30,40,4,Indian,Lunch,Vegetarian
Achari Lachha Paratha Recipe-Spicy Indian Style Flaky Bread,"Whole Wheat Flour, Salt, Sunflower Oil, Water Knead The Dough, Punjabi Style Mango Pickle, Ghee Roast The Parathas",6,10,15,25,2,North Indian Recipes,Main Course,Vegetarian
Whole Wheat Strawberry Banana Muffins Recipe,"Whole Wheat Flour, Caster Sugar, Nutmeg Powder, Baking Powder, Baking Soda, Whole Eggs, Milk, Sunflower Oil, Vanilla Extract, Strawberries, Ripe Bananas",11,30,15,45,4,Continental,World Breakfast,Eggetarian
Sindhi Pakwan Recipe - Crisp Delicious Puri,"Whole Wheat Flour, All Purpose Flour, Ajwain, Cumin Seeds, Ghee, Salt, Sunflower Oil",7,20,25,45,4,Sindhi,North Indian Breakfast,Vegetarian
Bele Dose Recipe (Lentil Dosa Recipe),"White Urad Dal, Yellow Moong Dal, Arhar Dal, Rice, Methi Seeds, Onion, Green Chilli, Curry Leaves, Fresh Coconut, Cumin Seeds, Salt, Coriander",12,500,10,510,4,Karnataka,South Indian Breakfast,Vegetarian
Multani Kaali Arbi Recipe (Arbi Gravy Style),"Colocasia Root, Sunflower Oil, Salt, Red Chilli Powder, Coriander",5,10,30,40,4,North Indian Recipes,Lunch,Vegetarian
Greek Style Bourekia Recipe (Potato and Leek Puffs Recipe),"Whole Wheat Flour, Butter, Salt, Potato, Leek, Milk, Sunflower Oil, Turmeric Powder, Red Chilli Flakes, Fennel Seeds, Salt",11,15,45,60,4,Greek,Snack,Vegetarian
Andhra Style Usirikaya Pachadi Recipe (Indian Gooseberries Chutney),"Amla, Green Chilli, Mustard Seeds, Dry Red Chilli, Asafoetida, Sunflower Oil, Salt",7,5,20,25,2,Andhra,Side Dish,Vegetarian
Gajar Halwa Barfi Recipe (Carrot Fudge),"Carrot, Milk, Khoya, Sugar, Fresh Cream, Saffron Strands, Ghee, Dry Fruits",8,20,20,40,2,Indian,Dessert,Vegetarian
Lemon Pudina Curry Leaf Shikanji Recipe,"Curry Leaves, Mint Leaves, Lemons, Cumin Seeds, Jaggery, Black Salt, Water",7,10,0,10,4,Indian,Appetizer,Vegetarian
Kashmiri Style Mutton Gogji Syun Recipe - Mutton & Turnip,"Mutton, Turnips, Fennel Seeds, Ginger, Asafoetida, Turmeric Powder, Red Chilli Powder, Mustard Oil, Salt",9,5,60,65,4,Kashmiri,Lunch,Non Vegeterian
Cheesy Chinese Bhel Recipe,"Hakka Noodles, Mint Leaves, Green Chilli, Garlic, Ginger, Roasted Peanuts, Sugar, Salt, Britannia Cheese Spread, Water, Garlic, Ginger, Onion, Green Bell Pepper, Carrot, Green Beans, Cabbage, Soy Sauce, Red Chilli Sauce, Salt, Sunflower Oil, Sweet Chutney, Red Chilli Sauce, Britannia Cheese Block, Spring Onion Greens",25,10,15,25,4,Indo Chinese,Snack,Vegetarian
Whole Wheat Spinach Paratha Recipe,"Whole Wheat Flour, Sunflower Oil, Green Chilli, Garlic, Coriander, Spinach Leaves, Ajwain, Water, Salt, Ghee Oilgrease The Pan",10,20,20,40,4,Indian,North Indian Breakfast,High Protein Vegetarian
Healthy Snack Bowl Recipe,"Coconut Oil, Corn Kernels, Salt, Peanut Butter, Soy Milk, Cocoa Powder, Maple Syrup Honey, Apple, Raisins, Walnuts",10,10,15,25,2,Indian,Snack,Vegetarian
Thonnai Idli Recipe (Dried Leaves Idli),"Idli Rice, White Urad Dal, Methi Seeds, Sabudana, Salt, Mustard Seeds, Chana Dal, Cumin Seeds, White Urad Dal, Black Pepper Powder, Ginger, Cashew Nuts, Curry Leaves, Ghee, Gingelly Oil, Asafoetida, Thonnai",17,360,60,420,4,Tamil Nadu,South Indian Breakfast,Vegetarian
Sweet Spinach Whole Wheat Muffin Recipe,"Whole Wheat Flour, Baking Soda, Baking Powder, Cinnamon Powder, Spinach, Ripe Bananas, Milk, Extra Virgin Olive Oil, Honey, Whole Egg, Vanilla Extract, Pistachios",12,20,15,35,4,Continental,Dessert,Eggetarian
Crunchy Carrots In Hot Dogs Buns Recipe,"Carrots, Spring Onion Greens, Coriander, Extra Virgin Olive Oil, Hot Dog Bread, Lemon Juice, Fresh Orange Juice, Orange Zest, Black Pepper Powder, Extra Virgin Olive Oil, Salt, Hung Curd, Mint Leaves, Lemon Juice, Salt",15,0,20,20,4,Continental,Lunch,Vegetarian
Chukku Kaapi Recipe - Dry Ginger Coffee,"Water, Dry Ginger Powder, Black Pepper Powder, Instant Coffee Powder, Tulsi, Cumin Seeds, Cardamom, Jaggery, Salt",9,2,10,12,4,Kerala Recipes,Snack,Vegetarian
Coconut Jaggery Burfi Recipe,"Fresh Coconut, Jaggery, Cardamom Powder, Ghee",4,5,20,25,5,Indian,Dessert,Vegetarian
Makki Ki Puri Recipe (Maize Flour Fried Indian Bread),"Makki Ka Atta, Whole Wheat Flour, Sunflower Oil, Ajwain, Salt",5,20,30,50,4,Indian,Indian Breakfast,Vegetarian
Vegetable Chops Recipe,"Carrots, Beetroot, Potato, Green Peas, Sweet Corn, Onion, Green Chilli, Ginger, Cumin Powder, Red Chilli Powder, Salt, Sunflower Oil, Corn Flour, Water, Whole Wheat Bread Crumbs",15,30,30,60,4,Bengali Recipes,Snack,Vegetarian
Goli Baje Recipe - Mangalorean Vada Recipe,"All Purpose Flour, Gram Flour, Rice Flour, Curd, Ginger, Green Chilli, Curry Leaves, Baking Powder, Salt, Fresh Coconut, Asafoetida, Sunflower Oil",12,20,30,50,4,Mangalorean,Snack,Vegetarian
Andhra Style Peanut Chutney Recipe,"Peanuts, Garlic, Tomato, Dry Red Chilli, Oil, Rye, White Urad Dal, Curry Leaves, Salt",9,15,15,30,6,Andhra,Side Dish,High Protein Vegetarian
Andhra Style Zucchini Tomato Chutney Recipe,"Sunflower Oil, Green Chilli, Garlic, Green Zucchini, Tomato, Tamarind, Coriander, Cumin Seeds, Salt, Sunflower Oil, Mustard Seeds, Cumin Seeds, Dry Red Chilli, Asafoetida, Few Curry Leaves",15,15,15,30,6,Andhra,Side Dish,Vegetarian
Sali Par Eedu Recipe - Parsi Breakfast Eggs On Fried Potato,"Potato, Whole Egg, Tomato, Coriander, Salt, Black Pepper Powder, Ghee",7,10,15,25,2,Parsi Recipes,North Indian Breakfast,Eggetarian
Jeera Aloo Sabzi ,"Potato, Green Chilies, Turmeric Powder, Cumin Seeds, Salt, Curry Leaves, Oil",7,10,30,40,4,North Indian Recipes,Lunch,Vegetarian
Gujarati Palak Dhokla Recipe,"Flour, Spinach, Hung Curd, Ginger, Green Chilli, Oil, Lemon Juice, Sugar, Salt, Ino Fruit Salt, Oil, Rye, Sesame Seeds, Kadhi Leaves, Asafoetida, Water",16,20,30,50,4,Gujarati Recipesï»¿,North Indian Breakfast,High Protein Vegetarian
Moongphali Bhindi Recipe - Okra and Peanut Stir Fry,"Bhindi, Sunflower Oil, Dry Red Chilli, Onion, Roasted Peanuts, Coriander Powder, Turmeric Powder, Red Chilli Powder, Amchur, Salt",10,10,30,40,4,North Indian Recipes,Lunch,High Protein Vegetarian
Murgh Musallam Recipe - Masala Roasted Chicken,"Chicken Drumstick, Ginger, Garlic, Onion, Cashew Nuts, Red Chilli Powder, Turmeric Powder, Black Pepper Powder, Curd, Salt, Sunflower Oil, Coriander, Cumin Seeds, Cardamom, Cloves, Black Cardamom, Cardamom, Mace, Nutmeg",19,60,45,105,2,North Indian Recipes,Appetizer,Non Vegeterian
Vankaya Gasagasala Kura | Andhra Style Eggplant Poppy Seeds Curry Recipe,"Methi Seeds, Poppy Seeds, Brinjal, Sunflower Oil, Mustard Seeds, Cumin Seeds, Garlic, Red Chilli Powder, Coriander Powder, Turmeric Powder, Methi Seeds, Tamarind, Jaggery, Salt",14,15,30,45,4,Andhra,Dinner,Vegetarian
Carrots And Coriander Fritters Recipe,"Carrots, Coriander, Gram Flour, Green Chilli, Salt, Sunflower Oil",6,10,20,30,2,Indian,Snack,Vegetarian
Kathiyawadi Shaak Recipe,"Small Green Brinjal, Garlic, Onion, Roasted Peanuts, Curd, Red Chilli Powder, Coriander Powder, Cumin Powder, Turmeric Powder, Garam Masala Powder, Coriander, Sunflower Oil",12,10,20,30,4,Gujarati Recipesï»¿,Dinner,Vegetarian
Pudalangai Thogayal Recipe (Snake Gourd Chutney Recipe),"Snake Gourd, Chana Dal, White Urad Dal, Sesame Seeds, Cumin Seeds, Ginger, Tamarind Water, Green Chilli, Salt, Turmeric Powder, Cumin Seeds, Mustard Seeds, Red Chilli Powder, White Urad Dal, Garlic, Curry Leaves",16,10,20,30,4,Tamil Nadu,Side Dish,Diabetic Friendly
Chamomile Tea Recipe,"Water, Dried Chamomile, Honey",3,2,5,7,2,Asian,Vegetarian,Vegetarian
Creamy Sweet Corn And Jalapeno Dip Recipe,"Sweet Corn, Walnuts, Pickled Jalapenos, Parmesan Cheese, Extra Virgin Olive Oil, Parsley Leaves, Salt",7,10,0,10,4,Continental,Snack,Vegetarian
Bangkok Coconut Curry Noodle Bowl Recipe,"Rice Noodles, Sunflower Oil, Dry Red Chilli, Thai Red Chilli, Ginger, Garlic, Turmeric Powder, Coriander Seeds, Spring Onion, Salt, Stalks Lemongrass, Water, Green Zucchini, Onion, Broccoli, Carrot, Green Zucchini, Salt, Sesame, Coconut Milk, Water, Stalks Spring Onion, Basil Leaves, Palm Jaggery",24,20,30,50,4,Asian,Lunch,Vegetarian
Rajasthani Dal Muthiya Recipe,"Yellow Moong Dal, Turmeric Powder, Green Chilli, Salt, Water, Ghee, Asafoetida, Red Chilli Powder, Dry Red Chilli, Mustard Seeds, Coriander, Whole Wheat Flour, Sunflower Oil, Salt, Water, Ajwain",16,10,20,30,2,Rajasthani,Lunch,High Protein Vegetarian
Dill Leaves & Parmesan Dip Recipe,"Dill Leaves, Cashew Nuts, Melon Seeds, Curd, Salt, Lemon Juice, Feta Cheese, Black Pepper Powder, Parmesan Cheese",9,0,10,10,4,Continental,Side Dish,Vegetarian
Healthy Eggless Date Squares Recipe,"All Purpose Flour, Whole Wheat Flour, Cardamom Powder, Salt, Baking Powder, Cashew Nuts, Dates, Milk, Custard Powder, Brown Sugar, Sunflower Oil, Water",12,10,45,55,2,Continental,Snack,Vegetarian
Dragon Fruit and Rose Water Popsicle Recipe,"Pink Flesh Dragon Fruitpitaya, Rose Water, Honey",3,20,480,500,3,Continental,Dessert,Vegetarian
Granola Yogurt Parfait Recipe with Fresh Kiwi & Pomegranates,"Hung Curd, Vanilla Extract, Kiwi, Anardana Powder, Granola, Walnuts Pecans, Honey",7,10,20,30,2,Continental,World Breakfast,Vegetarian
High Fiber Oat And Orange Coconut Parfait Recipe,"Instant Oats, Water, Multigrain Digestive Biscuits, Hung Curd, Vanilla Extract, Fresh Coconut, Fresh Pomegranate Fruit Kernels, Orange, Honey",9,10,10,20,2,Continental,World Breakfast,Vegetarian
Dosakaya Pappu Recipe-Andhra Style Yellow Cucumber Dal,"Arhar Dal, Turmeric Powder, Onion, Green Chilli, Tamarind Water, Red Chilli Powder, Tomato, Mangalorean Cucumber, Ghee, Garlic, Dry Red Chilli, Mustard Seeds, Cumin Seeds, Asafoetida, Curry Leaves, Salt, Coriander",17,10,30,40,4,Andhra,Lunch,High Protein Vegetarian
Manganem Recipe - Goan Style Chana Dal Payasam,"Chana Dal, Sabudana, Jaggery, Coconut Milk, Cashew Nuts, Ghee",6,240,60,300,4,Goan Recipes,Dessert,Vegetarian
Bhogichi Bhaji ,"Potato, Carrots, Eggplants, Green Gram, Avrekalu, Plum, Green Chilli, Large Spoon Peanut Powder, Sesame Powder, Oil, Goda Masala, Cumin Seeds, Mustard, Asafoetida, Teaspoon Turmeric Powder, Salt, Coriander Leaves, Lemon Juice",18,10,30,40,4,Maharashtrian Recipes,Lunch,Vegetarian
Rose Flavoured Golden Almond Milk Recipe - Badam Doodh,"Milk, Sugar, Cardamom, Badam, Turmeric Powder, Rose Water",6,10,15,25,4,Indian,Indian Breakfast,High Protein Vegetarian
Dal Tadka Recipe Flavoured With Lemon And Coriander,"Yellow Moong Dal, Butter, Ghee, Ginger, Cumin Seeds, Turmeric Powder, Bay Leaf, Green Chilli, S Of Coriander, Lemon Juice, Salt",11,10,30,40,3,North Indian Recipes,Lunch,High Protein Vegetarian
Chicken Crepe Lasagne Recipe,"Whole Wheat Flour, Sooji, Salt, Curd, Water, Boneless Chicken, Red Yellow And Green Bell Peppers, Spinach Leaves, Salt, Black Pepper Powder, Dried Oregano, Red Chilli Flakes, Homemade Pizza And Pasta Sauce, Cheese",14,15,20,35,2,Italian Recipes,Dinner,Non Vegeterian
Murungai Keerai Poriyal With Moong Dal Recipe,"Drumstick Leaves, Yellow Moong Dal, Onion, Asafoetida, Sambar Powder, Fresh Coconut, Mustard Seeds, Cumin Seeds, Dry Red Chilli, Curry Leaves, Salt, Sunflower Oil",12,10,15,25,4,South Indian Recipes,Lunch,Vegetarian
Irish Barm Brack Recipe,"Vivatta Maida, Mixed Dry Fruits, Baking Powder, Tea, Whiskey, Brown Sugar, Whole Egg, All Spice Powder",8,20,60,80,8,Continental,Dessert,Vegetarian
Kumro Patai Ilish Paturi Recipe - Hilsa Fish In Pumpkin Leaves,"Hilsa Fish, Pumpkin Leaves, Banana Leaf, Yellow Mustard Seeds, Mustard Seeds, Poppy Seeds, Mustard Oil, Turmeric Powder, Green Chilli, Green Chilli Red Chilli Powder",10,30,25,55,4,Bengali Recipes,Dinner,High Protein Non Vegetarian
Goan Mushroom Xacuti Recipe,"Button Mushrooms, Onion, Tomato, Coriander, Fresh Coconut, Dry Red Chilli, Coriander, Whole Black Peppercorns, Cloves, Turmeric Powder, Garam Masala Powder, Tamarind, Salt, Sunflower Oil",14,15,45,60,4,Goan Recipes,Lunch,Vegetarian
Chocolate Coconut Pistachio Bites Recipe (Paleo & Vegan),"Pistachios, Dessicated Coconut, Cocoa Powder, Almond Butter Peanut Butter, Maple Syrup Honey, Vanilla Extract",6,10,10,20,4,Continental,Snack,Vegan
Spinach Watermelon Salad Recipe With Walnuts,"Spinach Leaves, Watermelon, Black Grapes, Feta Cheese, Walnuts, Extra Virgin Olive Oil, Lemon Juice, Honey, Black Pepper Powder, Salt",10,15,0,15,4,Continental,Appetizer,Vegetarian
Dondakkai Puli Curry Recipe,"Tindora, Black Urad Dal, Dry Red Chilli, Cumin Seeds, Turmeric Powder, Tamarind Paste, Salt, Oil, Teaspoon Oil, Mustard, Cumin Seeds",11,20,25,45,4,Tamil Nadu,Lunch,Vegetarian
Corn Stuffed Paratha Recipe,"Whole Wheat Flour, Water, Salt, Sweet Corn, Potato, Green Chilli, Coriander, Onion, Mango Pickle Any Pickle Of Your Choice, Sunflower Oil",10,30,30,60,5,North Indian Recipes,Lunch,Vegetarian
Kongunadu Urulai Kurma Recipe (Curried Potatoes from Kongunadu),"Potato, Homemade Tomato Puree, Onion, Ginger, Garlic, Turmeric Powder, Sunflower Oil Ghee, Salt, Coriander, Chana Dal, Dry Red Chilli, Fennel Seeds, Cumin Seeds, Whole Black Peppercorns, Cloves, Cinnamon Stick, Bay Leaf, Fresh Coconut",18,15,40,55,4,South Indian Recipes,Lunch,Vegetarian
Vietnamese Style Vegetarian Spring Rolls Recipe With Peanut Dipping Sauce,"Rice Paper Rolls, Coriander, Mint Leaves, Cucumber, Carrot, Red Bell Pepper, Tofu Paneer, Soy Sauce, Red Chilli Flakes, Salt And Pepper, Sunflower Oil, Peanut Butter, Soy Sauce, Red Chilli Sauce Sriracha Sauce, Lemon Juice, Roasted Peanuts, Red Chilli Flakes",17,25,5,30,2,Vietnamese,Appetizer,Vegetarian
Kopparai Thengai Milagai Podi Recipe - Dry Coconut Chutney Podi,"Dry Coconut, Chana Dal, White Urad Dal, Asafoetida, Sesame Seeds, Dry Red Chilli, Tamarind, Salt",8,15,15,30,4,South Indian Recipes,Side Dish,Vegetarian
Kerala Style Beetroot Pachadi ,"Beetroot, Curd, Salt, Turmeric, Coconut, Dry Red Chilli, Ginger, Mustard, Small Spoon Cumin Seeds, Oil, Mustard, Curry Leaves, Red Chili",13,15,20,35,4,Indian,Side Dish,Vegetarian
Puli Koozh Recipe - Rice Flour Porridge In Tamarind,"Idli Rice, Tamarind, Sesame, Mustard Seeds, Chana Dal, White Urad Dal, Curry Leaves, Dry Red Chilli, Asafoetida, Turmeric Powder, Water",11,5,20,25,2,Tamil Nadu,Lunch,Vegetarian
Okra Idli Recipe (Ladyfinger Idli),"Idli Rice, White Urad Dal, Methi Seeds, Bhindi, Green Chilli, Cumin Seeds, Salt, Sunflower Oil Grease The Moulds",8,500,39,539,4,South Indian Recipes,South Indian Breakfast,Diabetic Friendly
Hoisin Tofu & Mushroom Stir Fry with homemade Hoisin Sauce Recipe,"Homemade Hoisin Sauce, Corn Flour, Water, Tofu, Button Mushrooms, Garlic, Ginger, Red Chilli Flakes, Spring Onion",9,10,30,40,4,Chinese,Main Course,Vegetarian
Mango Kesari Recipe | Mango Sooji Halwa | Mango Sheera,"Sooji, Ghee, Water  Depending On The Consistency You Desire, Sugar, Mango, Cardamom Powder, Ghee, Cashew Nuts, Cashew Nuts",9,10,20,30,4,Indian,Dessert,Vegetarian
Thai Roasted Vegetables with Peanut Coconut Sauce Recipe,"Carrot, Potato, Sweet Potato, Green Zucchini, Garlic, Onion, Coconut Oil, Cumin Powder, Fennel Powder, Salt And Pepper, Peanut Butter, Coconut Milk, Soy Sauce, Red Chilli Flakes, Brown Sugar, Lemon Juice, Lemon Grass, Basil Leaves Garnish The Curry",18,10,30,40,2,Thai,Dinner,Vegetarian
Thai Coconut Garlic Rice Recipe,"Coconut Oil, Garlic, Rice, Water, Coconut Milk, Coriander, Salt, Coconut Oil, Garlic, Dry Coconut",10,5,20,25,3,Thai,Main Course,Vegetarian
Sakkare Achhu Recipe (Festive Sugar Figurines),"Sugar, Water, Milk, Curd, Food Color",5,20,30,50,20,Karnataka,Dessert,Vegetarian
Soya Pilaf/Pulav Recipe,"Basmati Rice, Soy Chunks, Onion, Green Chilli, Ginger Garlic Paste, Tomato, Potato, Ghee, Cardamom, Bay Leaves, Whole Black Peppercorns, Cloves, Cinnamon Stick, Star Anise, Salt, Ajwain, Lemon, Mint Leaves, Coriander, Coriander Powder, Red Chilli Powder, Kewra Water, Caramelized Onion, Cashew Nuts, Raisins",25,20,50,70,4,Indian,Dinner,Vegetarian
Vegetarian Grilled Gyros Recipe,"Mini Pita Breads, Tzatziki Hummus, Brinjal, Green Zucchini, Yellow Zucchini, Green Bell Pepper, Red Bell Pepper, Yellow Bell Pepper, Button Mushrooms, Tomato, Red Onion, Cucumber, Extra Virgin Olive Oil, Lemon Juice, Salt, Black Pepper Powder, Garlic",17,10,45,55,4,Greek,Appetizer,Vegetarian
Homemade Healthy Sour Cream Recipe,"Hung Curd, Fresh Cream, Salt, Lemon Juice",4,10,0,10,1,Mexican,Side Dish,Vegetarian
Andhra Style Kakarakaya Vepudu Recipe - Bitter Gourd Stir Fry,"Karela, Curd, Turmeric Powder, Mustard Seeds, Cumin Seeds, Dry Red Chilli, Onion, Garlic, Curry Leaves, Red Chilli Powder, Amchur, Jaggery, Coriander",13,20,30,50,4,Andhra,Side Dish,Diabetic Friendly
No Onion No Garlic Black Eyed Beans Curry ,"Cowpea, Oil, Mustard, Cumin Seeds, Asafoetida, Turmeric Powder, Coconut, Peanuts, Kokum, Jaggery, Goda Masala, Red Chilli Powder, Salt",13,10,30,40,2,North Indian Recipes,Lunch,High Protein Vegetarian
Buttered Mashed Potatoes - For Babies Over 7 months,"Potato, Salt, Butter, Black Pepper Powder",4,15,10,25,6,Continental,Lunch,Vegetarian
Besan Aur Pyaz Ka Cheela Recipe - Roz Ka Khana With Figaro Olive Oil,"Gram Flour, Onion, Green Chilli, Fennel Seeds, Coriander, Salt, Figaro Pure Olive Oil, Onion, Green Chutney",9,20,30,50,4,Indian,North Indian Breakfast,High Protein Vegetarian
Vazhaithandu Mor Kootu Recipe (Tamil Nadu Style Banana Stem Recipe),"Banana Stem, Buttermilk, Curd, Fresh Coconut, Cumin Seeds, Green Chilli, Rice Flour, Coconut Oil, Mustard Seeds, White Urad Dal, Dry Red Chilli, Curry Leaves, Salt",13,15,15,30,3,Tamil Nadu,Lunch,Vegetarian
Restaurant Style Chicken 65 Recipe,"Chicken Breasts, Garlic, Red Chilli Powder, Black Pepper Powder, Turmeric Powder, Lemon Juice, Salt, Gram Flour, Curd, Red Chilli Powder, Sugar, Garlic, Vinegar, Curry Leaves, Sunflower Oil",15,65,30,95,4,South Indian Recipes,Appetizer,Non Vegeterian
Spicy Mexican Layered Chilli Rice Recipe,"Rajma, Garlic, Homemade Tomato Puree, Cumin Powder, Red Chilli Powder, Tabasco Original, Extra Virgin Olive Oil, Salt, Cooked Rice, Butter, Garlic, Mixed Herbs, Red Chilli Flakes, Salt, Coriander",15,740,25,765,4,Mexican,Main Course,Vegetarian
Bajra Matar Ki Khichdi (Gluten Free Breakfast Recipe),"Bajra Flour, Yellow Moong Dal, Sunflower Oil, Mustard Seeds, Cumin Seeds, Asafoetida, Onion, Tomato, Potato, Carrot, Green Peas, Red Chilli Powder, Ginger Garlic Paste, Coriander Powder, Garam Masala Powder, Turmeric Powder, Salt, Coriander, Lemon",19,260,30,290,4,Indian,Lunch,Gluten Free
Quinoa With Grilled Zucchini & Chickpea Recipe,"Quinoa, Water, Salt, Green Zucchini, Kabuli Chana, Spring Onion, Tomato, Green Chilli, Garlic, Dill Leaves, Dried Oregano, Salt, Extra Virgin Olive Oil",13,20,40,60,3,Continental,Dinner,Diabetic Friendly
Tomato Garlic Chutney ,"Tomato, Garlic, Green Chilies, Red Chili Powder, Salt, Mustard, Oil",7,20,10,30,6,Indian,Side Dish,Vegetarian
Mango Sago Kheer Recipe - Sabudana Kheer With Mangoes,"Nylon Sabakki, Water, Milk, Sugar, Cardamom Powder, Mango, Badam",7,20,20,40,4,Indian,Dessert,Vegetarian
Badam Elaichi Kulfi Recipe,"Milk, Badam, Sugar, Saffron Strands, Cardamom Powder, Pistachios",6,20,610,630,4,North Indian Recipes,Dessert,Vegetarian
Turmeric Amla Ginger Juice - Indonesian Jamu Recipe | Anti Inflammatory Health Tonic,"Fresh Turmeric Root, Amla, Ginger, Honey, Black Pepper Powder, Water",6,20,0,20,1,Indonesian,Appetizer,Vegetarian
Shorshe Maach Recipe - Bengali Style Mustard Fish Curry,"Mustard Seeds, Green Chilli, Coriander, Turmeric Powder, Salt, Mustard Oil, Seer Fish Hilsa Fish, Turmeric Powder, Red Chilli Powder, Salt, Yellow Mustard Seeds, Turmeric Powder, Green Chilli, Water, Coriander, Lemon Wedges",16,10,30,40,4,Bengali Recipes,Dinner,High Protein Non Vegetarian
Nagori Puri Recipe (Semolina Puri),"Sooji, Whole Wheat Flour, Cumin Seeds, Ghee, Water, Salt, Sunflower Oil",7,10,20,30,5,North Indian Recipes,Lunch,Vegetarian
Sweet Boondi / Meethi Boondi Recipe,"Gram Flour, Baking Soda, Yellow Food Colour, Orange Color, Water, Sunflower Oil Deep Fry, Sugar, Water",8,80,30,110,4,Indian,Dessert,Vegetarian
Sri Lankan Egg Curry Recipe,"Whole Eggs  Hardboiled, Onion, Ginger Garlic Paste, Curry Leaves, Coriander, Fennel Seeds, Tomato, Coconut Milk, Red Chilli Powder, Turmeric Powder, Curry Powder, Salt, Sunflower Oil, Dry Red Chilli, Coriander, Cumin Seeds, Cloves, Whole Black Peppercorns, Cardamom, Cinnamon Stick, Curry Leaves, Curry Leaves",22,25,35,60,4,Sri Lankan,Lunch,Eggetarian
Coorg Style Kulae Puttu Recipe- Puttu with Jackfruit & Jaggery,"Broken Raw Rice Rice Rawa, Jackfruit Ripe, Fresh Coconut, Jaggery, Cardamom, Salt, Banana Leaf Steam Cook",7,20,25,45,4,Coorg,South Indian Breakfast,Vegetarian
Whole Moong Dal Vada Recipe,"Green Moong Dal, Chana Dal, Onion, Green Chilli, Ginger, Garlic, Salt, Asafoetida, Sunflower Oil",9,30,30,60,4,Indian,Snack,Vegetarian
Palak Matar Recipe - Spinach And Green Peas Curry,"Stalks Spinach Leaves, Green Peas, Onion, Tomato, Ginger, Garlic, Red Chilli Powder, Garam Masala Powder, Coriander Powder, Sunflower Oil, Ghee, Cumin Seeds, Garlic, Onion, Dry Red Chilli, Garam Masala Powder",16,20,30,50,4,North Indian Recipes,Lunch,Vegetarian
Atar Payesh Recipe (Sitaphal Kheer),"Milk, Custard Apple, Heavy Whipping Cream, Cardamom Powder, Sugar",5,10,40,50,4,Bengali Recipes,Dessert,Vegetarian
Bengali Style Sheem Poshto Recipe - Flat Beans In Poppy Seeds,"Flat Green Beans, Potato, Mustard Seeds, Turmeric Powder, Kalonji, Sugar, Mustard Oil, Salt, Poppy Seeds, Green Chilli",10,10,30,40,4,Bengali Recipes,Lunch,Vegetarian
Tomato Basil Risotto Recipe With Grilled Chicken,"Arborio Rice, Homemade Tomato Puree, Extra Virgin Olive Oil, Garlic, Basil Leaves, Salt, Vegetable Stock, Curd, Ginger, Garlic, Lemon Juice, Garam Masala Powder, Kashmiri Red Chilli Powder, Kashmiri Red Chilli Powder, Salt, Salt, Kashmiri Red Chilli Powder, Salt",18,15,25,40,2,Fusion,Main Course,Non Vegeterian
Stuffed Corn and Capsicum Paratha Recipe with Herbs,"Phulka, Sunflower Oil, Onion, Baby Corn, Red Yellow And Green Bell Peppers, Garlic, Mixed Herbs, Red Chilli Flakes, Salt",9,20,30,50,4,Indian,Indian Breakfast,Vegetarian
Kaleji Ka Faal Recipe-Mutton Liver Pepper Fry,"Mutton Liver, Onion, Tomato, Green Chilli, Ginger Garlic Paste, Black Pepper Powder, Salt, Coriander, Sunflower Oil",9,5,15,20,4,Hyderabadi,Side Dish,Non Vegeterian
Calzone/ Pocket Pizza/ Mc Puffs Recipe (With Baked Option),"All Purpose Flour, Whole Wheat Flour, Water As Required, Active Dry Yeast, Sugar, Extra Virgin Olive Oil, Salt, Carrot, Green Beans, Green Bell Pepper, Onion, Sweet Corn, Black Olives, Homemade Tomato Puree, Vinegar, Dried Oregano, Red Chilli Flakes, White Pepper Powder, Cheese, Sunflower Oil",20,10,120,130,4,Italian Recipes,Appetizer,Vegetarian
Besan Burfi Recipe,"Gram Flour, Khoya, Caster Sugar, Ghee, Cardamom Powder, Mixed Nuts",6,10,40,50,20,Indian,Dessert,Vegetarian
Crispy Palak Pakora Recipe - Monsoon Snack,"Spinach Leaves, Gram Flour, Red Chilli Powder, Ajwain, Turmeric Powder, Salt, Chaat Masala Powder, Sunflower Oil",8,15,25,40,5,Indian,Snack,Vegetarian
Creamy Mushroom Ravioli Recipe In Mint Mayo Sauce,"All Purpose Flour, Salt, Extra Virgin Olive Oil, Button Mushrooms, Ginger, Garlic, Extra Virgin Olive Oil, Del Monte Mint Mayo, Black Pepper Powder, Salt, Butter, All Purpose Flour, Milk, Fresh Cream",14,30,30,60,4,Italian Recipes,Brunch,Vegetarian
Bengali Style Chingri Posto Recipe (Prawns Cooked In Poppy Seed Gravy),"Prawns, Poppy Seeds, Potato, Onion, Green Chilli, Turmeric Powder, Red Chilli Powder, Mustard Oil Cook, Salt",9,10,30,40,4,Bengali Recipes,Side Dish,Non Vegeterian
Prawn Fritters Recipe (Shrimp Vadai),"Prawns, Fresh Coconut, Shallots, Ginger, Garlic, Green Chilli, Red Chilli Powder, Turmeric Powder, Salt, Onion, Fennel Seeds, Coriander, Rice Flour, Sunflower Oil, Curry Leaves",15,10,15,25,4,Indian,Appetizer,Non Vegeterian
Angoor Raita Recipe,"Curd, Green Seedless Grapes, Sugar, Salt, Cumin Powder, Red Chilli Powder, Mint Leaves",7,5,5,10,4,North Indian Recipes,Side Dish,Vegetarian
Mexican Style Vegetable Fajita Recipe,"Onion, Green Bell Pepper, Red Bell Pepper, Yellow Bell Pepper, Extra Virgin Olive Oil, Button Mushrooms, Garlic, Paprika Powder, Cumin Powder, Salt, Corn Flour Tortilla",11,10,20,30,4,Mexican,Lunch,Vegetarian
Awadhi Moong Dal Ki Goli Recipe - Lentil Dumplings In Tomato Gravy,"Green Moong Dal, Sunflower Oil, Ginger Garlic Paste, Garam Masala Powder, Red Chilli Powder, Tomato, Onion, Salt, Tomato, Onion, Red Chilli Powder, Turmeric Powder, Garlic, Sunflower Oil, Coriander, Anardana Powder, Ginger, Green Chilli, Coriander",19,20,25,45,4,Awadhi,Main Course,High Protein Vegetarian
High Protein Chickpea Potato Hash Brown Recipe,"Potato, Kabuli Chana, Salt, Cumin Powder, Black Pepper Powder, Butter, Lemon Juice, Whole Egg, Whole Wheat Bread Crumbs",9,20,15,35,6,American,World Breakfast,High Protein Vegetarian
Mughalai Shahi Kaju Aloo Ki Sabzi Recipe,"Potato, Cashew Nuts, Ginger, Garlic, Cumin Seeds, Bay Leaf, Onion, Turmeric Powder, Red Chilli Powder, Garam Masala Powder, Coriander, Milk, Water, Curd, Sunflower Oil, Salt",16,20,45,65,12,Mughlai,Dinner,Vegetarian
Kasuri Malai Murgh Tikka Recipe,"Chicken, Cauliflower, Curd, Fresh Cream, Cashew Nuts, Kasuri Methi, Whole Black Peppercorns, Coriander Powder, Red Chilli Powder, Turmeric Powder, Salt, Sunflower Oil, Ajwain, Cardamom, Black Cardamom, Cloves, Cinnamon Stick, Bay Leaf, Mace, Onion, Garlic, Ginger  Grated",22,30,45,75,4,North Indian Recipes,Appetizer,High Protein Non Vegetarian
Baked Penne Pasta With Roasted Peppers In Marinara Sauce Recipe,"Penne Pasta, Tomato, Extra Virgin Olive Oil, Dried Oregano, Garlic, Red Chilli Powder, Sugar, Green Bell Pepper, Red Bell Pepper, Salt, Water, Stalks Parsley Leaves, Mozzarella Cheese",13,10,25,35,4,Italian Recipes,Dinner,Vegetarian
Kodava Ellu Pajji Recipe - Sesame & Tamarind Chutney,"Sesame Seeds, Fresh Coconut, Pearl Onion, Dry Red Chilli, Tamarind, Jaggery, Salt, Mustard Seeds, Curry Leaves, Dry Red Chilli, Coconut Oil",11,10,5,15,4,Coorg,South Indian Breakfast,Vegetarian
Zucchini Pancake Recipe With Tomato Salsa,"Green Zucchini, Green Chilli, Oats Flour, Whole Wheat Flour, Curd, Baking Powder, Salt And Pepper, Sunflower Oil, Tomato Salsa",9,15,15,30,4,Continental,World Breakfast,Vegetarian
Fried Artichokes Recipe Flavored With Lemon & Ginger,"Artichokes, Whole Egg, Clove Garlic, Ginger, Lemon Zest, Sugar, Salt, Parsley Leaves, Parmesan Cheese, Whole Wheat Bread Crumbs, All Purpose Flour, Sunflower Oil",12,10,20,30,4,Continental,Dinner,Eggetarian
One Pot Pressure Cooker Chicken Curry Recipe,"Coconut Oil, Curry Leaves, Garlic, Ginger, Onion, Tomato, Turmeric Powder, Garam Masala Powder, Red Chilli Powder, Coriander Powder, Chicken Breasts, Salt, Water",13,15,25,40,4,South Indian Recipes,Lunch,Non Vegeterian
Utanki Recipe - Crispy Rice Crepes,"Rice Flour, Sugar, Milk, Sunflower Oil",4,270,10,280,6,Oriya Recipes,Snack,Vegetarian
Masala Pav Recipe With Cheese,"Tablespoons Butter, Ginger, Garlic, Onion, Tomato, Potato, Turmeric Powder, Red Bell Pepper, Salt, Garam Masala Powder, Pav Bhaji Masala, Coriander, Pav Buns, Ghee, Pav Bhaji Masala, Onion, Coriander, Sev, Mozzarella Cheese, Green Chutney, Sweet Chutney, Onion",22,10,15,25,4,Maharashtrian Recipes,Snack,Vegetarian
Barley Rava Idli Recipe,"Sooji, Barley, Curd, Enos Fruit Salt, Green Chilli, Water More If Needed, Salt, Mustard Seeds, White Urad Dal, Chana Dal, Sunflower Oil",11,380,20,400,4,South Indian Recipes,South Indian Breakfast,Diabetic Friendly
Mooli And Moong Dal Sabji Recipe,"Mooli Mullangi, Mooli Ke Patte, Yellow Moong Dal, Garlic, Sunflower Oil, Mustard Seeds, Cumin Seeds, Turmeric Powder, Asafoetida, Green Chilli, Sugar, Salt",12,10,15,25,3,North Indian Recipes,Lunch,High Protein Vegetarian
Mangalorean Chicken Ghee Roast Recipe,"Chicken Breasts, Curd, Turmeric Powder, Lemon Juice, Curry Leaves, Jaggery, Ghee, Salt, Dry Red Chilli, Whole Black Peppercorns, Cloves, Methi Seeds, Coriander, Cumin Seeds, Garlic, Tamarind Paste",16,60,45,105,4,Mangalorean,Lunch,Non Vegeterian
Karnataka Style Sandige Huli Recipe (Toor dal dumplings in Gravy Recipe),"Arhar Dal, Green Chilli, Fresh Coconut, Turmeric Powder, Jaggery, Tamarind Water, Asafoetida, Salt, White Urad Dal, Garlic, Curry Leaves, Ghee",12,200,30,230,4,Karnataka,Lunch,Vegetarian
Vegetable Tartlets Recipe,"All Purpose Flour, Butter, Salt, Water, Milk, Whole Eggs, Ricotta Cheese Malai Paneer, Carrot, Green Beans, Green Bell Pepper, Cherry Tomato, Parsley Leaves, Basil Leaves, Fresh Thyme Leaves, Dried Oregano, Salt, Whole Black Peppercorns",17,45,60,105,4,Continental,Dinner,Vegetarian
Aloo Methi Sabzi Recipe - Potato Fenugreek Leaves Sabzi,"Baby Potato, Methi Leaves, Sunflower Oil, Cumin Seeds, Onion, Ginger, Garlic, Bay Leaf, Cinnamon Stick, Turmeric Powder, Garam Masala Powder, Coriander Powder, Red Chilli Powder, Amchur, Salt",15,10,40,50,4,North Indian Recipes,Lunch,Vegetarian
Yele Kadubu Recipe With Sweet And Spicy Onion Chutney,"Whole Wheat Flour, Water, Salt, Ghee, Sunflower Oil, Red Onion, Garlic, Methi Seeds, Dry Red Chilli, Tamarind Paste, Jaggery, Sunflower Oil, Salt",13,15,15,30,2,Karnataka,Snack,Vegetarian
Red Bean Mexican Burrito Bowl Recipe - Roz Ka Khana With Figaro Olive Oil,"Rajma, Garlic, Homemade Tomato Puree, Cumin Powder, Red Chilli Powder, Coriander, Tabasco Original  Hot Sauce, Salt, Extra Virgin Olive Oil, Rice, Figaro Pure Olive Oil, Garlic, Parsley Leaves, Avocado, Red Chilli Flakes, Onion, Parsley Leaves, Extra Virgin Olive Oil, Tomato, Green Chilli, Onion, Sugar, Cumin Powder, Red Chilli Powder, Salt, Tabasco Original  Hot Sauce, Coriander, Red Bell Pepper, Green Bell Pepper, Onion, Figaro Pure Olive Oil, Hung Curd, Parsley Leaves, Garlic, Extra Virgin Olive Oil",35,30,60,90,4,Mexican,One Pot Dish,Vegetarian
Mulyachi Bhaji Recipe - Goan Style Mooli Ki Sabzi,"Mooli Mullangi, Yellow Moong Dal, Water, Green Chilli, Fresh Coconut, Jaggery, Salt",7,10,30,40,4,Maharashtrian Recipes,Lunch,Vegetarian
Spicy Chickpeas Aloo Salad Chaat Recipe,"Cup Kabuli Chana, Onion, Tomato, Green Chilli, Potato, Coriander, Black Salt, Black Pepper Powder, Chaat Masala Powder, Lemon Juice, Chaat Masala Powder, Lemon Juice",12,20,20,40,3,Indian,Appetizer,High Protein Vegetarian
Bulgur Wheat Potato Patty Recipe,"Bulgur Wheat, Potato, Ginger, Garlic, Green Chilli, Red Chilli Powder, Cumin Powder, Carrots, Cauliflower, Instant Oats, Salt, All Purpose Flour, Sunflower Oil",13,20,40,60,4,Continental,Snack,Vegetarian
Mujaddara Recipe (Traditional Middle Eastern Rice),"Rice, Masoor Dal, Red Onion, Bay Leaf, Cumin Seeds, Coriander Powder, Whole Black Peppercorns, Red Chilli Powder, Extra Virgin Olive Oil, Salt, Pine Nuts Raisins For Garnishing, Lemon Juice",12,180,45,225,3,Middle Eastern,Dinner,Vegetarian
Spinach Corn & Cheese Momo Recipe,"All Purpose Flour, Salt, Water Knead, Extra Virgin Olive Oil, Spinach Leaves, Sweet Corn, Garlic, Salt, Black Pepper Powder, Mixed Herbs, Red Chilli Flakes, Britannia Cheese Block",12,15,20,35,4,Indo Chinese,Appetizer,Vegetarian
Beans Matki Bhaji Recipe - Green Beans Moth Beans Sabzi,"Green Beans, Moth Dal, Ghee, Cumin Seeds, Mustard Seeds, Curry Leaves, Asafoetida, Amchur, Jaggery, Red Chilli Powder, Maharashtrian Goda Masala, Turmeric Powder, Salt, Fresh Coconut",14,20,30,50,6,Maharashtrian Recipes,Lunch,Vegetarian
Kerala Style Chena Mezhukkupuratty Recipe - Yam Stir Fry,"Elephant Yam, Red Chilli Powder, Turmeric Powder, Fennel Seeds, Black Pepper Powder, Mustard Seeds, Curry Leaves, Coconut Oil, Pearl Onion, Garlic",10,10,35,45,4,Kerala Recipes,Lunch,Vegetarian
Ragi Appam Recipe - A Healthy Twist To The Classic Kerala Appam,"Ragi Seeds, Broken Raw Rice, Idli Rice, White Urad Dal, Red Poha, Yellow Fenugreek Seeds, Salt, Confectioners Sugar",8,200,30,230,4,South Indian Recipes,South Indian Breakfast,Diabetic Friendly
Vegan Malai Gobhi Recipe,"Cauliflower, Cashew Nuts, Coconut Milk, Onion, Garlic, Ginger, Green Chilli, Cloves, Bay Leaf, Garam Masala Powder, Black Pepper Powder, Cardamom Powder, Kasuri Methi, Green Chilli, Sunflower Oil, Salt",16,10,20,30,4,North Indian Recipes,Lunch,Vegetarian
Besan Cheela Recipe Stuffed With Chatapa Paneer,"Gram Flour, Onion, Green Chilli, Coriander, Salt, Cumin Powder, Sunflower Oil, Paneer, Green Chilli, Chaat Masala Powder, Coriander, Salt",12,10,15,25,6,Indian,North Indian Breakfast,High Protein Vegetarian
Protein Fingers Recipe,"Paneer, Chicken, Tofu, Extra Virgin Olive Oil, Garlic, Cumin Powder, Salt, Black Pepper Powder, Paprika Powder, Red Chilli Powder, Onion Powder, Garlic Powder, Dried Oregano, Sage, Lemon Juice",15,20,10,30,6,Continental,Dinner,High Protein Non Vegetarian
Baked Chevdo Recipe (Chivda Mixture -Tea Time Snack),"Poha, Sesame Seeds, Curry Leaves, Roasted Peanuts, Slivered Almonds, Raisins, Green Chilli, Turmeric Powder, Red Chilli Powder, Asafoetida, Sugar, Salt, Sunflower Oil",13,20,30,50,8,Gujarati Recipesï»¿,Snack,Vegetarian
Spicy Chettinad Fish Fry Recipe,"Seer Fish, Sunflower Oil Fry, Tomato, Curry Leaves, Tamarind  Soaked In  Water, Mustard Seeds, Garlic, Ginger Garlic Paste, Cumin Seeds, Coriander, Fennel Seeds, Whole Black Peppercorns, Red Chilli Powder, Turmeric Powder, Salt, Sunflower Oil, Lemon Wedges",17,15,45,60,4,Chettinad,Lunch,High Protein Non Vegetarian
Khatti Meethi Palak Khichdi Recipe,"Ghee, Mustard Seeds, Cumin Seeds, Tomato, Ginger, Cinnamon Stick, Bay Leaf, Turmeric Powder, Red Chilli Powder, Asafoetida, Jaggery, Lemon, Salt, Rice, Arhar Dal, Spinach, Ghee Be Added After Khichdi Is Cooked",17,10,20,30,4,North Indian Recipes,Dinner,Vegetarian
Spaghetti Arrabiata Pasta Recipe - Spicy Italian Pasta Recipe,"Spaghetti Pasta, Tomato, Basil Leaves, Garlic, Onion, Extra Virgin Olive Oil, Red Chilli Flakes, Sugar, Salt And Pepper, Parmesan Cheese",10,10,45,55,2,Italian Recipes,Lunch,Vegetarian
Pheki Mathri Recipe - Crispy Fried Savoury Fritters,"All Purpose Flour, Chiroti Rava, Ghee, Lukewarm Water",4,30,30,60,4,Indian,Snack,Vegetarian
Red Capsicum Chutney Recipe - Red Bell Pepper Chutney,"Red Bell Pepper, Pearl Onion, Tomato, Dry Red Chilli, Garlic, Sunflower Oil, Salt, Sunflower Oil, Mustard Seeds, White Urad Dal, Curry Leaves, Dry Red Chilli",12,10,15,25,4,South Indian Recipes,Side Dish,Vegetarian
Kabuli Chana & Moongphali Salad Recipe,"Kabuli Chana, Boiled Peanuts, Onion, Tomato, Green Bell Pepper, Green Chilli, Coriander, Amchur, Red Chilli Powder, Dry Ginger Powder, Salt, Lemon Juice",12,30,60,90,4,Indian,Side Dish,Vegetarian
Mushroom Masala With Corn Recipe,"Button Mushrooms, Sweet Corn, Onion, Dry Red Chilli, Ginger, Garlic, Green Chilli, Turmeric Powder, Red Chilli Powder, Cumin Powder, Coriander Powder, Amchur, Coriander, Corn Flour, Sunflower Oil, Salt",16,10,20,30,4,Indian,Appetizer,High Protein Vegetarian
Poha Stars Recipe (Poha Potato Fritters Flavoured With Kasuri Methi),"Poha, Potato, Whole Wheat Bread Crumbs, Green Chilli, Kasuri Methi, Red Chilli Powder, Lemon Juice, Coriander, Salt, Rice Flour, Sunflower Oil Deep Fry",11,20,30,50,4,Indian,Snack,Vegetarian
Apple And Pomegranate Smoothie Recipe,"Curd, Apple, Anardana Powder, Honey, Ice Cubes",5,0,20,20,4,Continental,World Breakfast,Vegetarian
Lahsuni Palak Dal Recipe (Spinach & Lentil Curry with Garlic),"Yellow Moong Dal, Spinach Leaves, Turmeric Powder, Red Chilli Powder, Cumin Powder, Salt, Sunflower Oil, Ghee, Cumin Seeds, Garlic",10,10,40,50,3,North Indian Recipes,Lunch,High Protein Vegetarian
Healthy Oats And Nuts Energy Bar Recipe,"Instant Oats, Pecans, Pretzels, Dates, Dry Coconut, Badam, Slivered Almonds, Salt, Coconut Oil",9,10,50,60,3,Indian,Snack,Vegetarian
Lauki and Whole Green Moong Dal Cheela Recipe,"Green Moong Dal, Rice Flour, Bottle Gourd, Green Chilli, Ginger, Coriander, Asafoetida, Salt, Sunflower Oil, Water",10,10,15,25,4,Indian,North Indian Breakfast,Diabetic Friendly
Spinach Coconut Zucchini Soup Recipe,"Extra Virgin Olive Oil, Garlic, Onion, Green Zucchini, Spinach, Whole Black Peppercorns, Salt, Coconut Oil, Cumin Powder, Coconut Milk, Water, Fried Bread Cubes",12,10,20,30,4,Continental,Appetizer,Vegetarian
Whole Wheat Sun Dried Tomato Focaccia Bread | Healthy Homemade Bread Recipe,"All Purpose Flour, Whole Wheat Flour, Active Dry Yeast, Salt, Honey, Dried Oregano, Rosemary, Whole Black Peppercorns, Extra Virgin Olive Oil, Lukewarm Water, Parmesan Cheese, Onion, Sun Dried Tomato",13,120,30,150,6,Italian Recipes,Dinner,Vegetarian
Cheese Tarts Recipe,"Vivatta Maida, Butter, Icing Sugar, Whole Eggs, Vanilla Extract, Salt, Milk Powder, Packet Britannia Cream Cheese, Mozzarella Cheese, Sugar, Vanilla Extract, Lemon Juice, Whole Egg, Milk, Corn Flour, Salt, Butter, Egg Yolks",18,40,75,115,10,Continental,Dessert,Vegetarian
Spinach Oats Vada Recipe,"Spinach Leaves, Chana Dal, Instant Oats, Potato, Onion, Red Chilli Powder, Turmeric Powder, Coriander Powder, Garam Masala Powder, Corn Flour, Asafoetida, Salt, Sunflower Oil Shallow Fry",13,20,30,50,4,South Indian Recipes,Snack,Vegetarian
Rajasthani Papad Ki Sabzi Recipe,"Ghee, Cumin, Asafoetida, Ginger, Green Chilli, Garlic, Kasuri Methi, Tomato, Turmeric Powder, Red Chilli Powder, Coriander Powder, Curd, Papad, Salt, Coriander",15,10,20,30,4,Rajasthani,Lunch,Vegetarian
Kandarappam Recipe (Chettinad Sweet Appam),"Rice, Cooked Rice, White Urad Dal, Yellow Moong Dal, Arhar Dal, Chana Dal, Salt, Jaggery  Grated, Fresh Coconut, Cardamom Powder, Water",11,250,50,300,10,Chettinad,Lunch,Vegetarian
Spinach & Broad Bean Shakshuka Recipe,"Avarekai, Broccoli, Spinach Leaves, Onion, Garlic, Tomato, Red Chilli Powder, Dried Oregano, Dried Thyme Leaves, Red Chilli Powder, Cumin Powder, Sugar, Whole Eggs, Salt, Sunflower Oil",15,10,45,55,4,European,Lunch,Eggetarian
Raw Mango Prawns Curry Recipe,"Prawns, Mango, Cardamom, Cinnamon Stick, Ginger, Garlic, Turmeric Powder, Red Chilli Powder, Vinegar, Lemon Juice, Coconut Milk, Onion, Fresh Coconut, Curry Leaves",14,20,30,50,4,South Indian Recipes,Main Course,Non Vegeterian
Corn And Drumstick Leaves Salad Recipe,"Del Monte Whole Corn Kernels, Drumstick Leaves, Cumin Seeds, Mustard Seeds, Red Chilli Powder, Turmeric Powder, Jaggery, Water, Sunflower Oil, Salt",10,10,10,20,3,Indian,Side Dish,Vegetarian
Slow Cooker Mexican Chicken Stew Recipe,"Chicken Thighs, Carrots, Sweet Corn, Black Beans, Onion, Green Bell Pepper, Tomato, Chicken Stock, Red Chilli Powder, Cumin Powder, Lemon Juice, Salt And Pepper, Coriander",13,0,360,360,4,Mexican,Main Course,Non Vegeterian
Dairyfree Balsamic Strawberry Ice-cream Recipe,"Strawberries, Cashew Nuts  Soaked For  Hours, Balsamic Vinegar, Maple Syrup, Salt, Corn Flour Arrowroot Powder, Vanilla Extract, Coconut Milk",8,500,480,980,3,Continental,Dessert,Vegan
Herb Mushroom Bruschetta Recipe,"Baguette, Button Mushrooms, Mint Leaves, Lemon, Garlic, Cherry Tomato  Quartered, Salt And Pepper",7,10,20,30,6,Italian Recipes,Appetizer,Vegetarian
Maharashtrian Style Surnachi Koshimbir Recipe-Yam Salad,"Elephant Yam, Onion, Fresh Coconut, Coriander, Green Chilli, Lemon Juice, Sugar, Salt, Sunflower Oil, Sunflower Oil, Mustard Seeds, Asafoetida",12,10,30,40,4,Maharashtrian Recipes,Side Dish,Vegetarian
Orange Rasam Recipe,"Ghee, Mustard Seeds, Cumin Seeds, Curry Leaves, Asafoetida, Garlic, Tomato, Fresh Orange Juice, Lemon, Turmeric Powder, Red Chilli Powder, Cumin Powder, Coriander Powder, Black Pepper Powder, Salt, Coriander, Arhar Dal",17,10,25,35,2,South Indian Recipes,Lunch,Vegetarian
Jodhpuri Kabuli Recipe,"Rice, Cloves, Lemon Juice, Ghee, Fennel Seeds, Cumin Seeds, Black Cardamom, Cardamom, Whole Black Peppercorns, Onion, Cauliflower, Potato, Green Peas, Whole Wheat Brown Bread, Curd, Fresh Pomegranate Fruit Kernels, Turmeric Powder, Red Chilli Powder, Cashew Nuts, Raisins, Ghee",21,20,45,65,4,Rajasthani,Lunch,Vegetarian
Hariyali Dum Aloo Recipe - Potatoes In Spinach Mint Curry,"Baby Potato, Red Chilli Powder, Turmeric Powder, Salt, Green Chilli, Garlic, Ginger, Spinach, Mint Leaves, Salt, Ghee, Cinnamon Stick, Garlic, Clove Onion, Garam Masala Powder, Fresh Cream",16,20,20,40,3,North Indian Recipes,Lunch,Vegetarian
"Vegetable Sizzler Recipe With Potato Tikki, Mint Rice & Corn and Spinach Sauce","Aloo Tikki, Mint Rice, Butter, Butter, Garlic, All Purpose Flour, Sweet Corn, Spinach, Milk, Salt, Butter, Carrots, Green Beans, Green Bell Pepper, Salt",15,10,45,55,2,Continental,Dinner,Vegetarian
Tempura Chicken Wings With Barbecue Sauce Recipe,"Chicken Wings, Barbeque Sauce, Whole Wheat Bread Crumbs, Chilli Vinegar, Ginger, Garlic, Corn Flour, Whole Egg, Salt And Pepper",9,10,30,40,4,Continental,Appetizer,Non Vegeterian
Moong Dal Tikki Recipe,"Cup Yellow Moong Dal, Green Chilli, Ginger, Coriander, Onion, Green Peas, Green Bell Pepper, Cup Paneer, Corn Flour, Tablespoon Cumin Powder, Salt, Amchur, Chaat Masala Powder, Sunflower Oil",14,140,15,155,4,Indian,Appetizer,High Protein Vegetarian
Mughlai Zafrani Murg Recipe,"Chicken, Curd, Fresh Cream, Lemon Juice, Saffron Strands, Red Chilli Powder, Cumin Powder, Coriander Powder, Salt, Garam Masala Powder Spinkle, Coriander",11,15,20,35,3,Mughlai,Side Dish,Non Vegeterian
Mixed Vegetables Oats Idli Recipe,"Instant Oats, Sooji, Curd, White Urad Dal, Raw Peanuts, Sunflower Oil, Asafoetida, Cumin Powder, Green Chilli, Ginger, Carrot, Onion, Green Bell Pepper, Curry Leaves, Mustard Seeds, Baking Soda, Coriander, Lemon Juice, Salt",19,40,15,55,4,South Indian Recipes,South Indian Breakfast,Vegetarian
Gajar Methi Poriyal Recipe - Carrot Fenugreek Stir Fry,"Carrots, Methi Leaves, Onion, Cumin Seeds, Curry Leaves, Dry Red Chilli, Turmeric Powder, Coriander Powder, Salt, Coconut Oil, Coriander",11,10,15,25,4,South Indian Recipes,Side Dish,Vegetarian
Simple Lemon Tea Recipe,"Water, Lemon, Lemon Wedges Slices, Lemon Zest, Brown Sugar",5,2,5,7,2,Indian,Dessert,Vegetarian
Bengali Style Dimer Chop Recipe,"Potato, Onion, Ginger, Garlic, Green Chilli, Coriander, Turmeric Powder, Cumin Seeds, Dry Red Chilli, Garam Masala Powder, Sunflower Oil Cook, Salt, Whole Eggs, All Purpose Flour, Whole Wheat Bread Crumbs, Whole Eggs, Corn Flour, Black Pepper Powder, Salt",19,40,20,60,6,Bengali Recipes,Appetizer,Eggetarian
Traditional Anarsa Recipe With Curd (Apoopa),"Rice, Caster Sugar, Ghee Cook, Curd, Poppy Seeds",5,30,32,62,4,Maharashtrian Recipes,Snack,Vegetarian
Bengali Bhapa Doi Recipe,"Hung Curd, Milk, Condensed Milk, Cardamom Powder, Pistachios, Raisins, Strawberries",7,10,45,55,4,Bengali Recipes,Dessert,Vegetarian
Apple Cinnamon Soy Smoothie Recipe,"Apples, Cinnamon Powder, Soy Milk",3,0,10,10,3,Continental,World Breakfast,Diabetic Friendly
Bharwa Karela Makhani  Recipe - Stuffed Karela Masala Gravy,"Karela, Paneer, Potato, Salt, Black Pepper Powder, Coriander, Mint Leaves, Sunflower Oil, Sunflower Oil, Onion, Homemade Tomato Puree, Ginger, Garlic, Green Chilli, Red Chilli Powder, Coriander Powder, Cumin Powder, Garam Masala Powder, Sugar, Fresh Cream, Salt",21,10,25,35,3,North Indian Recipes,Main Course,Diabetic Friendly
Khakhra Pizza Recipe With Cheese Spread & Roasted Vegetables,"Homemade Whole Wheat Khakras, Britannia Cheese Spread, Green Bell Pepper, Tomato, Sweet Corn, Basil Leaves, Pizza Seasoning, Red Chilli Flakes",8,5,30,35,2,Indian,Snack,Vegetarian
Gluten Free Rajgira Burfi Recipe,"Rajgira Flour, Jaggery, Ghee, Cardamom Powder, Cashew Nuts",5,10,30,40,8,North Indian Recipes,Snack,Vegetarian
Gobi Ke Kofte Recipe (Cauliflower Fritters In Spicy Gravy),"Ginger Garlic Paste, Curd, Onion, Bay Leaf, Black Cardamom, Cinnamon Stick, Red Chilli Powder, Turmeric Powder, Coriander Powder, Salt, Sunflower Oil, Water, Coriander, Cauliflower, Gram Flour, Red Chilli Powder, Green Chilli, Salt, Water, Sunflower Oil",20,15,60,75,4,North Indian Recipes,Lunch,Vegetarian
Shahi Vegetable Pulao Recipe,"Basmati Rice, Cumin Seeds, Cinnamon Stick, Cardamom, Few Saffron Strands, Milk, Green Chilli, Salt, Ghee, Few  Mint Leaves, Carrots, Cauliflower, Cashew Nuts, Raisins, Salt",15,15,60,75,4,Mughlai,Lunch,Vegetarian
Chow Chow And Beans Poriyal Recipe,"Chayote, Green Beans, Fresh Coconut, Onion, Green Chilli, Curry Leaves, Cumin Seeds, Mustard Seeds, White Urad Dal, Chana Dal, Turmeric Powder, Curry Leaves, Salt",13,10,30,40,4,South Indian Recipes,Lunch,Vegetarian
Kuthiraivali Upma Kozhukattai Recipe (Barnyard Millet Steamed Dumplings),"Barnyard Millet, Fresh Coconut, Mustard Seeds, White Urad Dal, Green Chilli, Curry Leaves  Finely, Asafoetida, Sesame, Salt",9,15,40,55,4,Tamil Nadu,South Indian Breakfast,Vegetarian
Fresh Strawberry Jam Recipe,"Strawberries, Sugar, Lemon Juice",3,10,20,30,4,Continental,Side Dish,Vegetarian
Ellu Sadam Recipe - South Indian Style Til Pulao Recipe,"Basmati Rice, Sesame Seeds, Dry Red Chilli, Cashew Nuts, Raw Peanuts, Fresh Coconut, Mustard Seeds, White Urad Dal, Curry Leaves, Ghee, Salt",11,20,20,40,4,Hyderabadi,Lunch,Vegetarian
Sun Dried Raw Mango Raita Recipe-Ambula Rai,"Dry Green Mango, Fresh Coconut, Curd, Mustard Seeds, Green Chilli, Sugar, Mustard Oil, Dry Red Chilli, Curry Leaves, Salt",10,10,1,11,3,South Indian Recipes,Side Dish,Vegetarian
Kerala Style Chakka Varattiyathu Ari Payasam Recipe - Jackfruit Brown Rice Kheer,"Jackfruit Raw, Brown Rice, Milk, Cardamom, Ghee, Cashew Nuts",6,10,60,70,4,Kerala Recipes,Dessert,Vegetarian
Bengali Style Kosha Mangsho Recipe- Spicy Mutton Curry,"Mutton, Mustard Oil, Cardamom, Cinnamon Stick, Cloves, Cumin Seeds, Onion, Ginger Garlic Paste, Red Chilli Powder, Salt, Turmeric Powder, Curd, Coriander",13,10,20,30,3,Bengali Recipes,Lunch,High Protein Non Vegetarian
Chana Pulao Recipe - Spicy Chickpea Pulao,"Kabuli Chana, Basmati Rice, Onion, Tomato, Red Bell Pepper, Curd, Ghee, Kashmiri Red Chilli Powder, Garam Masala Powder, Turmeric Powder, Kasuri Methi, Saffron Strands, Dry Fruits, Anardana Powder, Water  For Pressure Cooking Rice, Few Mint Leaves, Few Coriander, Salt, Cardamom, Mace, Bay Leaf, Cloves, Cinnamon Stick, Ajwain, Black Cardamom, Ginger, Garlic, Green Chilli",28,480,45,525,3,Indian,Lunch,Vegetarian
Orange Marmalade Tea Cake Recipe,"All Purpose Flour, Whole Wheat Flour, Almond Meal, Salt, Baking Powder, Baking Soda, Extra Virgin Olive Oil, Fresh Orange Juice, Whole Eggs, Orange Marmalade Jam, Caster Sugar, Buttermilk, Orange Marmalade Jam Drizzlebrush On The Cake",13,20,50,70,6,Continental,Dessert,Vegetarian
Parsi Mawa Cake Recipe (Tea Time Cake Flavored with Cardamom & Pistachios),"All Purpose Flour, Baking Powder, Cardamom Powder, Salt, Khoya, Butter, Sugar, Whole Eggs, Milk, Slivered Almonds, Pistachios",11,15,75,90,6,Parsi Recipes,Dessert,Eggetarian
Carrot Cauliflower Peas Sabzi Recipe - Gajar Gobi Matar Sabzi,"Coconut Oil, Ajwain, Bay Leaves, Cinnamon Stick, Carrots, Cauliflower, Green Peas, Black Pepper Powder, Salt",9,10,15,25,4,North Indian Recipes,Lunch,Diabetic Friendly
Taco Chaat Recipe,"Hard Taco Shells, Potato, Onion, Tomato, Sweet Corn, Green Seedless Grapes, Anardana Powder, Coriander, Green Chilli, Chaat Masala Powder, Red Chilli Powder, Sev, Boondi, Cheetos, Curd, Sweet Chutney, Green Chutney, Lahsun Ki Chutney",18,30,0,30,4,Fusion,Snack,Vegetarian
Nellikai Rasam Recipe - Whole Gooseberry Rasam,"Amla, Turmeric Powder, Salt, Arhar Dal, Ghee, Mustard Seeds, Asafoetida, Curry Leaves, Ginger, Garlic, Green Chilli, Tomato, Tamarind Water, Coriander Powder, Cumin Powder, Kashmiri Red Chilli Powder, Sugar, Salt, Coriander",19,10,30,40,4,South Indian Recipes,Lunch,Vegetarian
Fish Tandoori Recipe,"Fish, Curd, Onion, Green Chilli, Tandoori Masala, Ginger Garlic Paste, Red Chilli Powder, Garam Masala Powder, Coriander Powder, Cumin Powder, Coriander, Sunflower Oil, Salt",13,60,20,80,3,North Indian Recipes,Appetizer,High Protein Non Vegetarian
Puran Poli Recipe | Gujarati & Maharastrian | Sweet Spiced Stuffed Paratha With Jaggery,"Whole Wheat Flour, Salt, Sunflower Oil, Ghee, Arhar Dal, Jaggery, Saffron Strands, Cardamom Powder, Nutmeg Powder, Gram Flour",10,20,60,80,5,Gujarati Recipesï»¿,Dessert,Vegetarian
Ginger Garlic Tofu Curry Recipe,"Tofu, Ginger, Garlic, Carrot, Spring Onion, Spring Onion Greens, Green Chilli, Coconut Milk, Vegetable Stock, Turmeric Powder, Black Pepper Powder, Garam Masala Powder, Sweet And Spicy Red Chilli Sauce, Salt, Soy Sauce, Corn Flour",16,15,30,45,2,Indian,Dinner,High Protein Vegetarian
Muesli and Oats Waffle with Apricots Recipe,"Oats Flour, Muesli, Whole Egg, Milk, Baking Powder, Cinnamon Powder, Date Syrup, Salt, Apricots",9,10,30,40,4,Continental,World Breakfast,Sugar Free Diet
Prawns Biryani Recipe,"Ajwain, Fennel Seeds, Cardamom, Clove Powder, Cinnamon Stick, Sunflower Oil, Onion, Bay Leaves, Cinnamon Stick, Cloves, Cardamom, Star Anise, Basmati Rice, Prawns  Cleaned And Deveined, Red Chilli Powder, Turmeric Powder, Lemon, Curd, Mint Leaves, Salt",20,15,45,60,4,Indian,Dinner,Non Vegeterian
Rye Breakfast Sandwich With Cucumber And Eggs Recipe,"Rye Bread Any Other Whole Meal Bread, Butter, Whole Eggs, Britannia Cream Cheese, Cucumber, Salt And Pepper",6,10,20,30,2,Continental,World Breakfast,Eggetarian
Enchiladas Stuffed With Beans and Tartare Dip Recipe,"Whole Wheat Flour Tortilla, Rajma, Del Monte Tartare Dip, Onion, Tomato, Coriander, Garlic, Cumin Powder, Dried Oregano, Red Chilli Powder, All Purpose Flour, Tomato, Lemon Juice, Extra Virgin Olive Oil, Cheese, Spring Onion Greens",16,25,20,45,4,Mexican,World Breakfast,Eggetarian
Banarasi Tamatar Chaat Recipe - Spicy Tomato Chaat,"Sunflower Oil, Onion, Potato, Tomato, Ginger, Green Chilli, Pav Bhaji Masala, Garam Masala Powder, Cumin Powder, Red Chilli Powder, Chaat Masala Powder, Black Salt, Salt, Lemon Juice, Namak Para Garnish, Sev Granish, Coriander",17,10,20,30,4,North Indian Recipes,Appetizer,Vegetarian
Jowar Jo Dodo Recipe - Sindhi Sorghum Roti,"Jowar Flour, Onion, Methi Leaves, Coriander, Salt, Green Chilli, Sunflower Oil, Ghee Cook The Dodas",8,10,30,40,4,Sindhi,Main Course,Vegetarian
No Bake Eggless Dark Chocolate Fudge Recipe With Nuts,"Dark Chocolate  Compound, Condensed Milk, Butter, Cocoa Powder, Salt, Mixed Nuts",6,10,30,40,4,Continental,Dessert,Vegetarian
Carrots Dill and Peanut Sadam - South Indian Style Stir Fried Rice,"Rice, Sesame, Mustard Seeds, Asafoetida, Curry Leaves, White Urad Dal, Chana Dal, Raw Peanuts, Black Sesame Seeds, Sesame Seeds, Dry Red Chilli, Fresh Coconut, Onion, Carrots, Dill Leaves",15,15,15,30,3,South Indian Recipes,Lunch,Vegetarian
Methi Paneer Bhurji Recipe in Creamy Gravy,"Homemade Tomato Puree, Onion, Garlic, Ginger, Turmeric Powder, Red Chilli Powder, Garam Masala Powder, Salt, Sunflower Oil, Fresh Cream, Cumin Seeds, Turmeric Powder, Onion, Green Chilli, Ginger, Green Bell Pepper, Tomato, Methi Leaves, Kasuri Methi, Paneer, Salt, Red Chilli Powder, Sunflower Oil, Coriander",24,15,40,55,4,North Indian Recipes,Lunch,High Protein Vegetarian
Manipuri Style Karotkhabi Kanghou Recipe - Bitter Gourd & Potato Stir Fry,"Karela, Potato, Onion, Cumin Seeds, Turmeric Powder, Red Chilli Powder, Green Chilli, Salt, Sunflower Oil",9,10,20,30,4,North East India Recipes,Lunch,Vegetarian
Spinach And Soya Sub Sandwich Recipe,"Garlic, Spinach, Soy Chunks, Butter, Feta Cheese, Parmesan Cheese, Whole Wheat Bread Crumbs, Dried Oregano, Whole Egg, French Bread, Roasted Tomato Pasta Sauce, Mozzarella Cheese, Extra Virgin Olive Oil, Salt And Pepper",14,15,30,45,4,Continental,Snack,Vegetarian
Multigrain Pizza with Roasted Vegetables Recipe,"Whole Wheat Flour, Ragi Flour, Instant Oats, Sesame Seeds, Lukewarm Water, Honey, Active Dry Yeast, Salt, Extra Virgin Olive Oil, Homemade Pizza And Pasta Sauce, Mozzarella Cheese, Button Mushrooms, Green Bell Pepper, Green Zucchini, Dried Oregano Pizza Seasoning, Salt And Pepper",16,10,160,170,4,Italian Recipes,Main Course,Vegetarian
Lebanese Fattoush Salad Recipe,"Whole Wheat Pita Bread, Extra Virgin Olive Oil, Few Spring Onion, Clove Garlic, Iceberg Lettuce, Parsley Leaves, Tomato, Cucumber, Mooli Mullangi, Red Bell Pepper, Feta Cheese, Lemon Juice, Red Wine Vinaigrette, Fresh Thyme Leaves, Red Chilli Powder, Salt And Pepper",16,10,25,35,2,Middle Eastern,Appetizer,Vegetarian
Greek Yogurt Chocolate Mousse Recipe,"Hung Curd, Sugar, Vanilla Extract, Dark Chocolate, Mint Leaves, Dark Chocolate, Fresh Cream",7,20,10,30,6,Continental,Dessert,Vegetarian
Chettinad Keerai Mandi Recipe With Amaranth Greens,"Green Amaranth Leaves, Shallots, Green Chilli, Dry Red Chilli, Mustard Seeds, White Urad Dal, Mandi, Coconut Milk, Sesame, Salt",10,10,20,30,4,Chettinad,Side Dish,High Protein Vegetarian
Mung Pani Recipe - Whole Green Mung Soup,"Green Moong Dal, Lemon Juice, Asafoetida, Black Pepper Powder, Ghee, Cumin Seeds, Salt",7,10,30,40,2,Indian,Appetizer,Vegetarian
Succotash Recipe,"Butter, Onion, Spring Onion Greens, Garlic, Red Bell Pepper, Corn Kernels, Rajma, Lima Beans, Salt And Pepper",9,15,30,45,2,American,Appetizer,Vegetarian
Eggless Boston Cream Cupcake Recipe - Vegan Option,"All Purpose Flour, Ripe Bananas, Baking Powder, Baking Soda, Sugar, Salt, Dark Chocolate, Butter, Sunflower Oil, Coconut Milk Milk, Badam, Custard Powder, Sugar, Coconut Milk Milk",14,20,30,50,6,Continental,Dessert,Eggetarian
Chettinadu Style Kollu Thogayal Recipe (Horsegram Chutney),"Horse Gram Dal, Dry Red Chilli, Garlic, Tamarind, Onion, Cumin Seeds, Whole Black Peppercorns, Salt, Sunflower Oil, Sunflower Oil, Mustard Seeds, Curry Leaves",12,10,15,25,4,Chettinad,Side Dish,High Protein Vegetarian
Thecha Paniyaram Recipe,"Idli Dosa Batter, Sooji, Coriander, Salt, Sunflower Oil Drizzle, Garlic, Badam, Green Chilli, Coriander",9,10,20,30,4,Maharashtrian Recipes,Snack,Vegetarian
Sweet Potato And Moong Sprouts Cutlet Recipe,"Sweet Potato, Green Moong Sprouts, Poha, Coriander, Onion, Mint Leaves, Green Chilli, Ginger, Amchur, Kashmiri Red Chilli Powder, Salt, Sunflower Oil, Purple Cabbage, Chaat Masala Powder, Lemon Wedges",15,30,25,55,5,Indian,Appetizer,Vegetarian
Farfalle In Creamy Mushroom Sauce Recipe,"Pasta, Garlic, Onion, Dried Mushrooms, Fresh Cream, Salt, Black Pepper Powder, Extra Virgin Olive Oil, Mixed Herbs, Parmesan Cheese",10,15,15,30,2,Italian Recipes,Dinner,Vegetarian
Mangalore Bajji Recipe - Goli Baje,"All Purpose Flour, Curd, Baking Soda, Fresh Coconut, Green Chilli, Coriander, Sunflower Oil, Salt",8,60,20,80,4,Mangalorean,Snack,Vegetarian
S'mores Cake Recipe,"All Purpose Flour, Whole Wheat Flour, Butter, Brown Sugar, Honey, Molasses, Baking Powder, All Purpose Flour, Butter, Brown Sugar, Graham Cracker Crumbs, Milk, Whole Eggs, Baking Powder, Dark Chocolate, Heavy Whipping Cream, Egg White, Lemon Juice, Caster Sugar, Water",20,120,90,210,4,Continental,Dessert,Eggetarian
Rose Gulkand Phirni Recipe,"Milk, Rice, Condensed Milk, Dried Rose Petals, Gulkand, Sugar, Rose Water Rooh Afza, Cardamom Powder, Fennel Powder, Rose Water, Pistachios, Badam, Cashew Nuts, Dried Rose Petals",14,10,60,70,4,North Indian Recipes,Dessert,Vegetarian
Andhra Style Pappu Urumindi Recipe,"Chana Dal, White Urad Dal, Turmeric Powder, Salt, Dry Red Chilli, Coriander, Cumin Seeds, Methi Seeds, Tamarind, Dry Coconut, Mustard Seeds, Cumin Seeds, Curry Leaves, Sunflower Oil",14,5,30,35,4,Andhra,One Pot Dish,High Protein Vegetarian
Banana Stem Poriyal Recipe With Curry Powder,"Banana Stem, Onion, Red Chilli Powder, Curry Powder, Turmeric Powder, Cumin Powder, Curd, Salt, Gram Flour, Sunflower Oil, Mustard Seeds, Cumin Seeds, Curry Leaves",13,15,15,30,3,Karnataka,Side Dish,Vegetarian
Burnt Orange Panna Cotta Recipe,"Fresh Cream, Milk, Gelatin, Sugar, Oranges, Orange Zest",6,15,240,255,4,Italian Recipes,Dessert,Vegetarian
Desi Style Masala Pasta Recipe In Electric Pressure Cooker,"Penne Pasta Any Other Pasta Of Your Choice, Extra Virgin Olive Oil, Garlic, Onion, Homemade Tomato Puree, Carrot, Sweet Corn, Salt, Coriander Powder, Garam Masala Powder, Turmeric Powder, Red Chilli Powder, Mint Leaves",13,10,40,50,4,Fusion,Dinner,Vegetarian
Karnataka Style Majjige Huli Recipe - Tasty Buttermilk Rasam,"Buttermilk, Onion, Dry Red Chilli, Ginger, Garlic, Coriander Powder, Black Pepper Powder, Fresh Coconut, Salt, Sunflower Oil, Mustard Seeds, Cumin Seeds, Curry Leaves",13,5,5,10,4,Karnataka,Side Dish,Vegetarian
Mediterranean Pumpkin Kibbeh Recipe,"Broken Wheat, Mixed Herbs, Salt, Extra Virgin Olive Oil, Kaddu, Garlic, Onion, Red Bell Pepper, Dried Oregano, Red Chilli Flakes, Black Pepper Powder, Salt, Extra Virgin Olive Oil, Whole Egg, All Purpose Flour, Black Pepper Powder, Salt, Whole Wheat Bread Crumbs, Hung Curd, Lemon, Garlic, Fresh Pomegranate Fruit Kernels, Mixed Herbs",23,15,30,45,4,Middle Eastern,Appetizer,Vegetarian
Lentil Dal with Coconut Milk Recipe,"Fresh Green Toor Dal, Coconut Milk, Onion, Tomato, Green Chilli, Ginger, Garlic, Dry Red Chilli, Ghee, Curry Powder, Kashmiri Red Chilli Powder, Turmeric Powder, Salt, Panch Phoran Masala, Fresh Coconut, Lemon Wedges, Coriander",17,10,30,40,2,South Indian Recipes,Lunch,Vegetarian
Egg Manchurian Recipe,"Whole Eggs, Garlic, Onion, Spring Onion Greens, Green Chilli, Soy Sauce, Tablespoon Sweet And Spicy Red Chilli Sauce, Tablespoon Vinegar, Tablespoon Sugar, Salt, Sunflower Oil Cook",11,15,15,30,2,Indo Chinese,Appetizer,Eggetarian
Bangaladumpa Thalimpu Recipe - Potato Stir Fry,"Potato, Sunflower Oil, Mustard Seeds, Dry Red Chilli, Curry Leaves, Salt, Roasted Gram Dal, Dessicated Coconut, Red Chilli Powder, Asafoetida, Garlic",11,15,15,30,4,Tamil Nadu,Lunch,Vegetarian
Raw Jackfruit Poriyal Recipe - South Indian Raw Jackfruit Stir Fry,"Jackfruit Raw, Curry Leaves, Mustard Seeds, Asafoetida, White Urad Dal, Chana Dal, Green Chilli, Salt, Turmeric Powder, Black Pepper Powder, Lemon Juice, Fresh Coconut",12,20,35,55,4,South Indian Recipes,Side Dish,Vegetarian
Togarikaayi Usli Recipe (Green Pigeon Peas),"Fresh Green Toor Dal, Sunflower Oil, Green Chilli, Garlic, Coriander, Salt, Butter, Mustard Seeds",8,10,30,40,4,North Karnataka,Lunch,High Protein Vegetarian
Eggless Checker Board Cookies Recipe,"All Purpose Flour, Cocoa Powder, Sugar, Vanilla Extract, Butter, Salt, Milk, Water",8,120,15,135,6,Continental,Dessert,Vegetarian
Japanese Chicken Udon Soup Recipe,"Chicken Stock, Boneless Chicken, Ginger, Soy Sauce, Carrots, Cabbage, Sweet Corn, Button Mushrooms, Spring Onion, Salt, Udon Noodles, Whole Eggs",12,20,30,50,2,Japanese,Dinner,Non Vegeterian
Healthy Black Bean Stuffed Burrito Recipe With Amaranth And Quinoa,"Mixed Grains, Water, Salt, Extra Virgin Olive Oil, Canned Black Beans, Salt, Clove Garlic, Tortillas, Sour Cream, Red Bell Pepper, Lemon, Extra Virgin Olive Oil, Coriander, Sweet Corn, Mozzarella Cheese Any Cheese, Mango Pickle Any Sauce Of Your Choice",16,30,20,50,4,Mexican,World Breakfast,Vegetarian
Goan Style Brinjal Bharta ,"Eggplant, Onion, Green Chilli, Green Coriander, Tamarind Paste, Coconut, Tamarind, Salt, As Per",9,10,45,55,2,Goan Recipes,Lunch,Vegetarian
Zucchini Pesarattu Recipe,"Green Zucchini, Green Moong Dal, Rice, Chana Dal, Green Chilli, Ginger, Asafoetida, Salt, Sunflower Oil Cook, Onion",10,10,30,40,4,Fusion,South Indian Breakfast,Vegetarian
Open Bean and Veggies Burrito Muffin Recipe,"Whole Wheat Flour Tortilla, Mixed Vegetables, Pickled Jalapenos, Red Chilli Flakes, Dried Oregano, Cooked Rice, Rajma, Tomato Salsa, Salt And Pepper, Lemon Juice, Parsley Leaves, Cheese, Spring Onion Greens",13,10,8,18,3,Mexican,Appetizer,Vegetarian
Murg Malai Kebab Recipe (Reshmi Kebab),"Boneless Chicken, Black Pepper Powder, Ginger Garlic Paste, Lemon Juice, Salt, Mozzarella Cheese, Corn Flour, Green Chilli, Garlic, Coriander, Cardamom, Garlic Powder, Hung Curd, Fresh Cream, Sunflower Oil, Salt",16,150,20,170,4,Mughlai,Appetizer,Non Vegeterian
Beetroot Garlic Lemon Rasam ,"Chakundar, Of Water, Salt, Black Pepper Powder, Cumin Seeds, Coriander Seeds, Dry Red Chilli, Bud Garlic, Green Coriander, Curry Leaves, Green Coriander, Oil, Mustard, Cumin Seeds, Dry Red Chilli, Curry Leaves, Asafoetida, Salt, Coriander",19,10,20,30,4,South Indian Recipes,Lunch,Vegetarian
Homemade Thengai Sevai Recipe - Coconut Idiyappam Recipe,"Idli Rice, Fresh Coconut, Mustard Seeds, White Urad Dal, Dry Red Chilli, Roasted Peanuts, Green Chilli, Curry Leaves, Ginger, Sesame",10,120,40,160,2,South Indian Recipes,South Indian Breakfast,Vegetarian
Thai Style Steamed Buns Recipe,"All Purpose Flour, Whole Wheat Flour, Active Dry Yeast, Sugar, Salt, English Cucumber, Carrot, Cabbage, Pickled Jalapenos, Soy Sauce, Chilli Vinegar, Sugar, Red Chilli Sauce, Salt",14,60,30,90,4,Thai,Appetizer,Vegetarian
Mini Pita Pizza With Tahini Roasted Vegetables Recipe,"Mini Pita Breads, Red Bell Pepper, Green Zucchini, Onion, Tahini, Tomato Basil Pasta Sauce, Cheddar Cheese",7,15,10,25,4,Mediterranean,Appetizer,Vegetarian
Non-Fried Vegetable & Oat Manchurian Balls Recipe In Sweet & Spicy Oat Sauce,"Cabbage, Cauliflower, Carrot, Ginger, Rolled Oats Or Instant Oats, Green Bell Pepper, Corn Flour, Whole Wheat Flour, Salt, Sunflower Oil, Spring Onion, Garlic, Green Chilli, Ginger, Corn Flour, Vegetable Stock Water, Soy Sauce, Tomato Ketchup, Sriracha Sauce, Red Chilli Sauce, Sunflower Oil Sunflower Oil, Salt And Pepper",22,15,30,45,4,Asian,Dinner,Vegetarian
Hare Pyaaz Ki Puri Recipe - Spring Onion Puri,"Whole Wheat Flour, Sunflower Oil, Cumin Seeds, Ajwain, Spring Onion Greens, Coriander, Sunflower Oil Deep Fry",7,10,15,25,4,Indian,Dinner,Vegetarian
Eggless Thandai Cookie Recipe,"All Purpose Flour, Baking Soda, Salt, Caster Sugar, Butter, Corn Flour, Thandai Masala, Rose Water, Pistachios, Badam, Whole Black Peppercorns, Poppy Seeds, Fennel Seeds, Cardamom",14,20,60,80,6,Indian,Snack,Vegetarian
Panasa Pottu Pappu Koora Recipe - Jackfruit & Dal Curry,"Jackfruit Raw, Yellow Moong Dal, Sunflower Oil, Black Urad Dal, Cumin Seeds, Mustard Seeds, Dry Red Chilli, Asafoetida, Curry Leaves, Turmeric Powder, Salt",11,60,10,70,4,Andhra,Lunch,Diabetic Friendly
Muringakka Manga Mulakushyam - Mango & Drumstick Kootu Curry,"Drumstick, Mango, Green Chilli, Water, Salt, Arhar Dal, Turmeric Powder, Water, Fresh Coconut, Cumin Seeds, Green Chilli, Water, Coconut Oil, Mustard Seeds, White Urad Dal, Dry Red Chilli, Curry Leaves",17,10,35,45,4,Kerala Recipes,Lunch,Vegetarian
Lip Smacking Lemonade Cupcake Recipe,"All Purpose Flour, Sugar, Curd, Butter, Vanilla Extract, Lemon Juice, Baking Powder, Baking Soda, Butter, Icing Sugar, P Lemon Zest",11,31,20,51,4,Continental,Dessert,Vegetarian
Roasted Garlic No Knead Skillet Bread Recipe With Olives,"All Purpose Flour, Active Dry Yeast, Salt, Sugar, Extra Virgin Olive Oil, Mixed Herbs, Black Olives, Garlic, Water, Mixed Herbs, Black Olives, Garlic, Extra Virgin Olive Oil, Extra Virgin Olive Oil",14,120,40,160,6,Continental,Appetizer,Vegetarian
Bhang Thandai Recipe,"Milk, Saffron Strands, Sugar, Poppy Seeds, Fennel Seeds, Badam, Whole Black Peppercorns, Cardamom, Bhang Paste",9,10,30,40,4,Indian,Snack,Vegetarian
Muesli Ragi Chocolate Chip Cookies Recipe,"Muesli, All Purpose Flour, Ragi Flour, Cinnamon Powder, Baking Powder, Salt, Extra Virgin Olive Oil, Jaggery, Nutmeg, Chocolate Chips",10,10,35,45,4,Continental,Snack,Vegetarian
Malvani Masala Powder Recipe,"Dry Red Chilli, Coriander, Whole Black Peppercorns, Fennel Seeds, Cumin Seeds, Poppy Seeds, Mace, Cloves, Cinnamon Stick, Star Anise, Stone Flower, Nutmeg Powder, Turmeric Powder, Asafoetida",14,5,10,15,4,Maharashtrian Recipes,Snack,Vegetarian
Cheesy Baked Potato Gratin With Sweet Corn,"Potato, Milk, Heavy Whipping Cream, Clove Garlic, Butter, Sweet Corn, Tomato, Black Pepper Powder, Cheese, Dried Oregano, Red Chilli Flakes, Salt",12,10,45,55,3,Continental,Dinner,Vegetarian
Italian Cheese And Basil Uttappam Recipe,"White Urad Dal, Rice, Methi Seeds, Salt, Idli Dosa Batter, Parmesan Cheese, Dried Basil Leaves, Extra Virgin Olive Oil Any Other Cooking Oil",8,250,20,270,4,Fusion,South Indian Breakfast,Vegetarian
Broccoli Orange Asian Salad Recipe,"Broccoli, Baby Spinach, Purple Cabbage, Carrot, Snow Peas, Orange, Raw Peanuts, Extra Virgin Olive Oil, Soy Sauce, Sesame, Sriracha Sauce Any Asian Styles Hot Sauce, Ginger, Honey, Orange",14,10,20,30,4,Continental,Appetizer,High Protein Vegetarian
Tamil Nadu Style Dal Masala Vada with Cabbage Recipe,"Chana Dal, White Urad Dal, Cabbage, Green Chilli, Onion, Carrot, Instant Oats, Garlic, Curry Leaves, Fennel Seeds, Salt, Coriander",12,45,30,75,4,Tamil Nadu,Snack,Vegetarian
Punjabi Style Moth Beans Dal Recipe (Matki),"Moth Dal, Onion, Tomato, Green Chilli, Ginger, Garlic, Cumin Seeds, Amchur, Garam Masala Powder, Red Chilli Powder, Turmeric Powder, Salt, Sunflower Oil, Green Chilli, Ginger",15,10,45,55,4,Punjabi,Lunch,High Protein Vegetarian
One Pot Vegetable Pasta With Beans Recipe,"Pasta  Fusilli Any Pasta You Like, Green Bell Pepper, Green Zucchini, Red Onion, Tomato, Spinach Leaves, Garlic, Italian Seasoning, Red Chilli Flakes, Salt, Extra Virgin Olive Oil, Vegetable Stock, Black Beans, Cheese",14,10,30,40,2,Italian Recipes,Dinner,High Protein Vegetarian
Khurchan Mawa Burfi Recipe,"Khurchan, Gram Flour, Khoya, Sugar, Condensed Milk, Cardamom Powder, Ghee, Cashew Nuts, Raisins, Edible Silver Foilleaf",10,15,20,35,10,Indian,Dessert,Vegetarian
Chocolate Salami Recipe (Salame Al Cioccolato),"Butter, Caster Sugar, Cocoa Powder, Milk, Digestive Biscuit, Pistachios, Cranberries, Vanilla Extract",8,240,0,240,15,Italian Recipes,Dessert,Vegetarian
Kakrar Jhal (Bengali Crab Korma Recipe),"Crabs, Onion, Ginger Garlic Paste, Homemade Tomato Puree, Green Chilli, Fresh Red Chilli, Mustard Seeds, Cumin Seeds, Turmeric Powder, Garam Masala Powder, Coriander, Salt, Sugar, Mustard Oil Cook",14,10,45,55,4,Bengali Recipes,Lunch,High Protein Non Vegetarian
Goan Batata Recheado Recipe With Carrots & Beans,"Baby Potato, Carrots, Green Beans, Onion, Reacheado Masala, Sunflower Oil, Salt, Dry Red Chilli, Tamarind Paste, Cloves, Cinnamon Stick, Cardamom, Cumin Seeds, Black Pepper Corns, Ginger, Garlic, Onion, Turmeric Powder, Vinegar, Tamarind, Salt",21,15,15,30,4,Goan Recipes,Side Dish,Vegetarian
Assamese Amitar Khar Recipe,"Raw Papaya, Mustard Oil, Green Chilli, Bay Leaf, Dry Red Chilli, Panch Phoran Masala, Salt, Sunflower Oil, Fennel Seeds, Cumin Seeds, Kalonji, Mustard Seeds, Methi Seeds",13,10,20,30,5,Assamese,Side Dish,Vegetarian
Pyaaz Ki Sabzi Recipe,"Pearl Onion, Cumin Seeds, Asafoetida, Fennel Seeds, Red Chilli Powder, Amchur, Coriander Powder, Salt, Sunflower Oil",9,10,30,40,4,North Indian Recipes,Lunch,Vegetarian
Avarakkai Poricha Kootu Recipe - Broad Beans Kootu Recipe,"Avarekai, Yellow Moong Dal, Turmeric Powder, Fresh Coconut, Dry Red Chilli, Cumin Seeds, Curry Leaves, Salt, Curry Leaves, Mustard Seeds, Coconut Oil, White Urad Dal",12,10,25,35,4,Tamil Nadu,Side Dish,Vegetarian
Manjal Poosanikai Sambar Recipe (Yellow Pumpkin in Toor Dal Recipe),"Arhar Dal, Kaddu, Pearl Onion, Tamarind Water, Sambar Powder, Sugar, Salt, Coriander, Mustard Seeds, Asafoetida, Curry Leaves, Dry Red Chilli, Sunflower Oil",13,10,40,50,4,South Indian Recipes,Lunch,High Protein Vegetarian
Bean Spinach And Corn Quesadilla Recipe,"Whole Wheat Flour Tortilla, Refried Beans, Spinach  Roughly, Sweet Corn, Yellow Bell Pepper, Cheddar Cheese, Red Chilli Powder Paprika, Cumin Powder, Mixed Herbs, Coriander, Salt, Butter",12,15,35,50,3,Mexican,Dinner,Vegetarian
Gil-E-Firdaus Recipe (Kesar Phirni),"Milk, Rice, Sugar, Cardamom Powder, Few Saffron Strands, Badam, Cashew Nuts, Pistachios, Raisins, Edible Silver Foilleaf, Mixed Nuts, Dried Rose Petals, Few Saffron Strands",13,40,20,60,8,Hyderabadi,Dessert,Vegetarian
Asian Style Sweet Potato Croquettes Recipe,"Sweet Potato, Onion, Green Chilli, Coriander, White Pepper Powder, Dark Soy Sauce, Whole Wheat Bread Crumbs, Corn Flour, Sunflower Oil, Salt",10,15,15,30,4,Asian,Appetizer,Vegetarian
Bihari Karela and Aloo Ki Subzi ,"Bitter Gourd, Potato, Onion, Panch Phoran Masala, Mustard Oil, Salt, Red Chilli Powder, Turmeric Powder",8,20,45,65,4,Bihari,Side Dish,Diabetic Friendly
Sweet Potato & Rosemary Crisps/ Chips,"Sweet Potato, Extra Virgin Olive Oil, Lemon Juice, Rosemary, Salt",5,15,0,15,4,Snack,Vegetarian,Diabetic Friendly
Uttarakhand Style Singhal Recipe,"Sooji, Hung Curd, Ripe Bananas, Sugar, Cardamom Powder, Milk, Sunflower Oil Deep Fry",7,240,20,260,4,North Indian Recipes,Snack,Vegetarian
BaNilla Sandwich Cookie Recipe,"Nilla Cookies, Ripe Bananas, Nutella Spread, Peanut Butter, Decorative Sugar",5,20,15,35,4,Continental,Snack,Vegetarian
Indian Style Beetroot Soup Recipe,"Beetroot, Tomato, Garlic, Onion, Vegetable Stock, Black Pepper Powder, Bay Leaf, Whole Black Peppercorns, Cloves, Cinnamon Stick, Salt",11,30,30,60,4,Indian,Dinner,Vegetarian
"Oats, Cranberry And Walnut Bread Recipe","All Purpose Flour, Instant Oats, Sugar, Baking Powder, Baking Soda, Salt, Milk, Apple Cider Vinegar, Whole Egg, Butter, Orange Zest, Cranberries, Walnuts",13,15,60,75,1,Continental,Snack,Eggetarian
Golden Glow Smoothie Recipe,"Carrot, Orange Mosambi Juice, Papaya, Turmeric Powder, Ginger, Ice Cubes",6,15,5,20,1,Continental,World Breakfast,Vegan
Punjabi Style Arbi ,"Gm Arabic, Onion, Green Chilli, Ghee, Cumin, Salt, Red Chilli Powder, Garam Masala Powder, Amchoor, Turmeric Powder, Coriander",11,10,45,55,4,Punjabi,Lunch,Vegetarian
Jhunka Vadi Recipe - North Karnataka/Maharashtrian Speciality,"Gram Flour, Cumin Seeds, Mustard Seeds, Onion, Ginger, Garlic, Turmeric Powder, Red Chilli Powder, Asafoetida, Sugar, Lemon, Sunflower Oil, Salt, Mustard Seeds, Curry Leaves, Sunflower Oil, Coriander",17,20,30,50,4,Maharashtrian Recipes,Snack,Vegetarian
Chana Kanghou Recipe - Manipuri Style Kala Chana Sabzi,"Kala Chana, Onion, Tomato, Green Chilli, Cumin Seeds, Red Chilli Powder, Coriander Powder, Salt And Pepper, Coriander, Mustard Oil",10,300,20,320,4,North East India Recipes,Lunch,Vegetarian
Kerala Style Banana Dosa Recipe,"Rice Flour, All Purpose Flour, Dry Ginger Powder, Cardamom Powder, Ripe Bananas, Jaggery, Cashew Nuts, Salt, Ghee",9,10,30,40,4,Kerala Recipes,Dessert,Vegetarian
Khandeshi Sev Bhaji Recipe,"Sev, Red Chilli Powder, Turmeric Powder, Maharashtrian Goda Masala, Jaggery, Salt, Onion, Dry Coconut, Garlic, Ginger",10,10,45,55,4,Maharashtrian Recipes,Lunch,Vegetarian
Methi Mushroom Masala Recipe,"Button Mushrooms, Curd, Kashmiri Red Chilli Powder, Ginger, Sunflower Oil, Onion, Homemade Tomato Puree, Ginger Garlic Paste, Bay Leaf, Turmeric Powder, Red Chilli Powder, Garam Masala Powder, Kalonji, Kasuri Methi, Lemon Juice, Dry Red Chilli, Salt, Lukewarm Water",18,10,15,25,2,North Indian Recipes,Lunch,Vegetarian
Palak And Moong Dal Pakodas Recipe,"Yellow Moong Dal, Spinach, Onion, Green Chilli, Ajwain, Coriander, Red Chilli Powder, Garam Masala Powder, Turmeric Powder, Cumin Powder, Lemon Juice, Salt, Sunflower Oil",13,10,25,35,4,North Indian Recipes,Snack,High Protein Vegetarian
Milagu Sadam Recipe (Instant Pepper Rice),"Basmati Rice, Onion, Whole Black Peppercorns  Freshly Ground, Curry Leaves, Mustard Seeds, White Urad Dal, Cashew Nuts, Sunflower Oil, Salt",9,15,15,30,4,South Indian Recipes,Lunch,Vegetarian
Gulkand Panna Cotta Recipe with Strawberry Sauce,"Milk, Fresh Cream, Caster Sugar, Gulkand, Gelatin Agar Agar, Strawberry Compote",6,20,260,280,3,Fusion,Dessert,Vegetarian
Masala Khichia Recipe (Spicy Corn Flour Papad),"Corn Flour, Cumin Seeds, Green Chilli Paste, Red Chilli Powder, Papad Khar, Ajwain, Salt, Mustard Oil, Chilled Water, Onion, Cucumber, Tomato, Green Chilli, Salt, Red Chilli Powder, Ghee, Coriander",17,5,60,65,4,Rajasthani,Appetizer,Vegetarian
Grilled Basil Pesto Chicken Sub Sandwich Recipe,"Hot Dog Bread, Cheese Slices, Classic Mayonnaise, Sweet And Spicy Red Chilli Sauce, Tomato, Chicken Breasts, Fresh Cream, Lemon Juice, Garlic Butter, Basil Leaves, Walnuts, Garlic, Salt, Extra Virgin Olive Oil, Whole Black Peppercorns, Parmesan Cheese",16,90,30,120,2,Continental,Main Course,Non Vegeterian
Simple Peruvian (Mayocoba) Beans Salad Recipe,"Peruvian Beans, Water, Salt, Canola Oil, Onion, Tomato, White Onion, Pickled Jalapenos, Black Pepper Powder, Salt, Lemon Juice, Extra Virgin Olive Oil",12,15,240,255,4,Continental,Appetizer,High Protein Vegetarian
Mexican Low Fat Fish Wraps Recipe,"Whole Wheat Flour Tortilla, Basa Fish, Iceberg Lettuce, Sunflower Oil, Black Pepper Powder, Salt, Lemon Juice, Tomato, Onion, Coriander, Green Chilli, Extra Virgin Olive Oil, Lemon Juice, Salt, Hung Curd, Italian Seasoning",16,10,30,40,4,Mexican,Lunch,Non Vegeterian
Phalguni Dal Recipe - Bengali Style Red Lentils With Fresh Green Peas,"Masoor Dal, Green Peas, Onion, Tomato, Ginger, Garlic, Green Chilli, Turmeric Powder, Salt, Mustard Seeds, Methi Seeds, Cumin Seeds, Fennel Seeds, Kalonji, Garam Masala Powder, Mustard Oil, Asafoetida",17,10,20,30,2,Bengali Recipes,Lunch,High Protein Vegetarian
Sanjori Bread Recipe (Maharashtrian Sweet Flatbread Stuffed with Halwa),"Whole Wheat Flour, Salt, Ghee, Water Knead, Broken Wheat, Cardamom Powder, Jaggery, Milk, Water, Ghee",10,40,60,100,5,Maharashtrian Recipes,Dessert,Vegetarian
Creamy Mango Kulfi Recipe With Cream Cheese,"Mango Pulp, Mango, Britannia Cream Cheese, Heavy Whipping Cream",4,20,120,140,12,Indian,Dessert,Vegetarian
Mushroom And Bok Choy Stir Fry Recipe,"Button Mushrooms, Bok Choy, Garlic, Ginger, Fresh Red Chilli, Soy Sauce, Salt, White Vinegar, Honey, Paprika Powder, Sesame, Sesame Seeds",12,10,30,40,2,Asian,Side Dish,Vegetarian
Corn And Onion Raita Recipe,"Sweet Corn, Curd, Water, Sunflower Oil, Cumin Seeds, Green Chilli, Onion, Red Chilli Powder, Salt",9,10,20,30,4,Indian,Side Dish,Vegetarian
Achari Aloo Parwal Sabzi Recipe (Pointed Gourd And Potato Stir Fry In Pickle Spices),"Pointed Gourd, Potato, Onion, Tomato, Mustard Oil, Kalonji, Turmeric Powder, Amchur, Salt, Coriander, Cumin Seeds, Mustard Seeds, Fennel Seeds, Kalonji, Methi Seeds, Dry Red Chilli",16,10,40,50,4,North Indian Recipes,Lunch,Vegetarian
Pan Fried Avocado Kofta Recipe,"Avocado, Carrot, Sooji, Rice Flour, Onion, Coriander, Green Chilli, Ginger, Garlic, Tamarind Water Lime Juice, Tablespoons Sunflower Oil, Garam Masala Powder, Coriander Powder, Cumin Powder, Red Chilli Powder, Black Pepper Powder, Turmeric Powder, Salt",18,10,8,18,15,Indian,Snack,Vegetarian
Cinnamon Spiced Orange Iced Tea Recipe,"Tea Bags Tea Leaves, Oranges, Water, Cinnamon Stick, Star Anise, Sugar, Lemon Wedges, Mint Leaves",8,10,15,25,2,Continental,Snack,Vegetarian
Punjabi Sabut Moong Ki Dal Recipe (Whole Green Lentils Cooked With Punjabi Spices),"Green Moong Dal, Onion, Tomato, Ginger, Garlic, Green Chilli, Sunflower Oil, Cumin Seeds, Garam Masala Powder, Salt, Turmeric Powder, Ghee, Kashmiri Red Chilli Powder, Coriander",14,10,30,40,2,North Indian Recipes,Lunch,High Protein Vegetarian
Quinoa Vangi Bath Recipe,"Kenua, Brinjals, Dry Red Chilli, Rye, White Urad Dal, Chana Dal, Cashews, Kabuli Chana, Asafoetida, Turmeric Powder, Lemon Juice, Wangi Bhat Powder, Salt, Oil",14,20,35,55,1,Indian,Lunch,Vegetarian
Kali Mirch Aloo Bhindi Sabzi - Aloo Bhindi Pepper Fry Recipe,"Potato, Bhindi, Turmeric Powder, Cumin Seeds, Onion, Sunflower Oil, Salt, Cumin Seeds, Whole Black Peppercorns",9,10,20,30,4,North Indian Recipes,Lunch,Vegetarian
Kolkata Style Vegetable Chop Recipe,"Carrot, Potato, Beetroot, Raw Peanuts, Ginger, Fennel Seeds, Cumin Seeds, Kala Jeera, Dry Red Chilli, Cardamom, Cinnamon Stick, Whole Black Peppercorns, Salt, Sugar, Whole Wheat Bread Crumbs, Corn Flour, Sunflower Oil Deep Fry",17,30,30,60,4,Bengali Recipes,Snack,Vegetarian
Creamy Chicken Pesto Spaghetti Pasta Recipe,"Extra Virgin Olive Oil, Chicken Breasts, Spaghetti Pasta, Sun Dried Tomato, Basil Leaves, Walnuts, Parmesan Cheese, Garlic, Extra Virgin Olive Oil, Salt, Whole Black Pepper Corns, Lemon Juice",12,10,20,30,4,Italian Recipes,Dinner,High Protein Non Vegetarian
Sesame Potato Toast Recipe,"Sesame Seeds, Potato, Coriander, Green Chilli, French Loaf, Chaat Masala Powder, Salt, Butter",8,10,20,30,4,Continental,Snack,Vegetarian
Andhra Pepper Chicken Recipe,"Chicken, Onion, Garlic, Ginger, Green Chilli, Salt, Lemon Juice, Curry Leaves, Coriander Powder, Turmeric Powder, Sunflower Oil Cook, Whole Black Peppercorns  Freshly Crushed, Coriander",13,10,20,30,2,Andhra,Side Dish,Non Vegeterian
"Cabbage, Bell Pepper and Apples with Sriracha Slaw Recipe ","Cabbage, Red Bell Pepper, Apple, Hung Curd, Sriracha Sauce, Tabasco Original, Honey, Chia Seeds, Salt And Pepper",9,20,0,20,4,Continental,Appetizer,Vegetarian
Hash Browns With Chives Recipe,"Potato, Whole Wheat Brown Bread, Whole Egg, Cheese, Chives, Salt And Pepper, Whole Egg, Tomato, Butter, Extra Virgin Olive Oil, Cheddar Cheese, Sea Salt",12,20,20,40,4,Continental,World Breakfast,Eggetarian
Khatti Meethi Lauki Dal Recipe - Sweet & Spicy Bottle Gourd Dal,"Sunflower Oil, Cumin, Curry Leaves, Cinnamon Stick, Bay Leaf, Ginger, Tomato, Turmeric Powder, Red Chilli Powder, Arhar Dal, Bottle Gourd, Salt, Jaggery, Lemon, Coriander, Amchur, Jaggery, Lemon Juice, Coriander, Sunflower Oil",20,20,30,50,4,North Indian Recipes,Dinner,Vegetarian
Orange Zested Shortbread Cookie Recipe (Egg Free/Eggless),"All Purpose Flour, Salt, Butter, Caster Sugar, Vanilla Extract, Orange Zest, Dark Chocolate, Hazelnut",8,80,45,125,6,Continental,Snack,Vegetarian
Bihari Karela Aloo Sabzi Recipe,"Karela, Mustard Oil, Cumin Seeds, Garlic, Onion, Potato, Turmeric Powder, Garam Masala Powder, Coriander, Amchur, Red Chilli Powder, Salt, Jaggery",13,20,45,65,6,Bihari,Lunch,Diabetic Friendly
Beetroot Moong Phali Sabzi Recipe-Beetroot Stir Fry with Roasted Peanuts,"Beetroot, Pearl Onion, Garlic, Green Chilli, Ginger, Turmeric Powder, Coriander Powder, Amchur, Roasted Peanuts, Sunflower Oil, Salt",11,10,20,30,4,North Indian Recipes,Side Dish,Vegetarian
"Chickpea Salad with Cherry Tomatoes,Olives and Capsicum Recipe","Extra Virgin Olive Oil, Kala Chana, Green Bell Pepper, Onion, Garlic, Cherry Tomato, Baby Corn, Salt, Black Olives, Basil Leaves, Black Pepper Powder, Red Chilli Flakes, Lemon",13,15,5,20,4,Mediterranean,Appetizer,High Protein Vegetarian
Sindhi Tahiri Recipe - Sindhi Style Sweet Rice,"Rice, Fennel Seeds, Whole Black Peppercorns, Cardamom, Sugar, Ghee, Dry Fruits Garnish, Saffron Strands",8,30,25,55,4,Sindhi,Main Course,Vegetarian
Vegetable Rice Upma Recipe,"Rice, Onion, Tomato, Green Chilli, Ginger, Curry Leaves, Carrot, Green Beans, Green Peas, Sunflower Oil, Mustard Seeds, White Urad Dal, Chana Dal, Salt, Hot Water, Ghee, Coriander",17,20,40,60,4,South Indian Recipes,South Indian Breakfast,Gluten Free
Parsi Style Baingan Capsicum Ka Salan ,"Brinjal, Capsicum, Tomato, Onion, Turmeric Powder, Red Chili Powder, Dhansak Masala, Salt, S Of Coriander, Oil",10,10,30,40,4,Parsi Recipes,Lunch,Vegetarian
Traditional Bihari Litti Chokha Recipe,"Whole Wheat Flour, Ghee, Baking Soda, Curd, Ajwain, Salt, Lukewarm Water Knead The Flour, Roasted Gram Flour, Ginger, Garlic, Green Chilli, Coriander, Ajwain, Kalonji, Fennel Seeds, Mustard Oil, Salt, Lemon Juice",18,45,60,105,4,Bihari,Lunch,Vegetarian
Egg And Ridge Gourd Burji ,"Trumpet, Eggs, Onion, Cumin Seeds, Mustard, White Urad Dal, Black Pepper Powder, Oil, Salt",9,10,25,35,4,South Indian Recipes,Lunch,Eggetarian
Garlic Knot Recipe,"All Purpose Flour, Active Dry Yeast, Baking Powder, Extra Virgin Olive Oil, Salt, Sugar, Lukewarm Water Milk, Butter, Garlic, Parsley Leaves, Basil Leaves, Red Chilli Flakes, Salt",13,10,150,160,4,Fusion,Snack,Vegetarian
Paya Curry Recipe | Lamb Trotters,"Lamb Trotters  Well Roasted & Rinsed Lamb Trotters, Turmeric Powder, Coriander Powder, Red Chilli Powder, Rice Flour, Salt, Onion, Sunflower Oil, Coriander, Ginger, Garlic, Cinnamon Stick, Cloves",13,30,80,110,4,South Indian Recipes,Side Dish,Non Vegeterian
Andhra Dondakaya Chutney Recipe - Tindora Chutney,"Tindora, Green Chilli, Dry Red Chilli, Tamarind, Cumin Seeds, Chana Dal, White Urad Dal, Peanuts, Coriander, Garlic, Sunflower Oil, Salt, Sunflower Oil, Dry Red Chilli, Curry Leaves, Mustard Seeds",16,5,10,15,4,Andhra,Side Dish,Vegetarian
Murungai Keerai Masala Vadai Recipe,"Chana Dal, Onion, Drumstick Leaves, Mint Leaves, Coriander, Dry Red Chilli, Ginger, Garlic, Cloves, Cumin Seeds, Asafoetida, Salt, Sunflower Oil Cook",13,180,20,200,4,South Indian Recipes,Snack,Vegetarian
Dhaba Style Country Chicken Recipe,"Chicken, Onion, Ginger, Garlic, Fresh Red Chilli, Mustard Oil, Onion, Bay Leaf, Cinnamon Stick, Cardamom, Coriander Powder, Turmeric Powder, Cumin Powder, Kashmiri Red Chilli Powder, Salt, Water",16,10,60,70,6,North Indian Recipes,Lunch,High Protein Non Vegetarian
3 Beans Stuffed Quesadillas Recipe,"Rajma, Black Eyed Beans, Red Black Eyed Beans, Tomato, Onion, Garlic, Red Chilli Flakes, Dried Oregano, Paprika Powder, Sugar, Salt, Cheese, Whole Wheat Flour, Extra Virgin Olive Oil, Salt",15,60,45,105,4,Mexican,Lunch,High Protein Vegetarian
Quick Indian Style Ginger Pickle Recipe,"Ginger, Salt, Lemons, Green Chilli",4,15,0,15,100,Indian,Side Dish,Vegetarian
Spicy And Tangy Bread Upma Recipe,"Onion, Green Chilli, Sunflower Oil, Mustard Seeds, White Urad Dal, Tomato, Green Bell Pepper, Ginger Garlic Paste, Garam Masala Powder, Chaat Masala Powder, Sugar, Salt, Coriander, Water, Whole Wheat Brown Bread",15,5,10,15,3,South Indian Recipes,South Indian Breakfast,Vegetarian
Shrimp Sambal Recipe,"Shrimps, Onion, Garlic, Ginger Paste, Sugar, Sambal Paste, Sesame, Lemon, Coriander, Water",10,10,20,30,2,Malaysian,Lunch,High Protein Non Vegetarian
Mini Potato Cheesy Au Gratin Recipe,"Potato, Nutralite Garlic & Oregano Spread, Heavy Whipping Cream, Nutralite Cheesy Garlic Mayo, Milk, All Purpose Flour, Garlic  Finely Minced, Salt, Black Pepper Powder, Cheddar Cheese",10,10,60,70,4,French,Lunch,Vegetarian
Mango Popsicle Recipe,"Mango, Sugar, Water",3,10,20,30,2,Continental,Dessert,Vegetarian
Karwar NKGSB Style Bharli Vangi Recipe - Brinjal Curry,"Brinjal, Potato, Onion  Finely, Fresh Coconut, Turmeric Powder, Tamarind, Garlic, Ginger, Jaggery, Gram Flour, Coriander, Salt, Cloves, Cinnamon Stick, Cardamom, Whole Black Peppercorns, Byadagi Dried Chilli, Sunflower Oil, Onion, Fresh Coconut, Sunflower Oil, Mustard Seeds, Asafoetida, Curry Leaves",24,30,45,75,4,Karnataka,Lunch,Vegetarian
Soto Ayam Recipe - Indonesian Chicken Noodle Meal bowl,"Onion, Garlic, Ginger, Turmeric Powder, Cumin Seeds, Coriander, Whole Black Peppercorns, Stalks Lemongrass, Coconut Milk, Water, Garlic, Stalks Lemongrass, Kaffir Lime Leaves, Spring Onion Greens, Celery, Salt, Chicken Breasts, Lemon Juice, Bean Sprouts, Rice Noodles, Boiled Egg, Coriander, Lemon Wedges Serve",23,20,20,40,4,Indonesian,Main Course,High Protein Non Vegetarian
Vegetarian Tofu Matzo Ball Soup Recipe,"Extra Virgin Olive Oil, Onion, Ginger, Garlic, Matzo Meal Bread Crumbs, Salt And Pepper, Tofu, Vegetable Stock, Parsley Leaves  Finely, Extra Virgin Olive Oil, Onion, Carrot, Vegetable Stock, Parsley Leaves  Finely, Dill Leaves  Finely, Salt And Pepper",16,15,45,60,3,Jewish,Dinner,Vegetarian
Chettinad Mixed Bean Adai Recipe,"White Urad Dal, Arhar Dal, Green Moong Dal, Basmati Rice, Water, Dry Red Chilli, Cumin Seeds, Fennel Seeds, Asafoetida, Turmeric Powder, Salt, Sunflower Oil",12,10,10,20,3,South Indian Recipes,South Indian Breakfast,High Protein Vegetarian
Restaurant Style Paneer Lababdar Recipe,"Paneer, Onion, Ginger, Tomato, Cumin Seeds, Kashmiri Red Chilli Powder, Garam Masala Powder, Cumin Powder, Kasuri Methi, Butter, Fresh Cream, Ginger, Sunflower Oil, Salt",14,10,20,30,4,North Indian Recipes,Dinner,High Protein Vegetarian
Chocolate And Salted Caramel Tart Recipe,"Rolled Oats, Whole Wheat Flour, Cocoa Powder, Honey, Butter, Brown Sugar, Butter, Heavy Whipping Cream, Salt, Dark Chocolate, Heavy Whipping Cream, Dried Rose Petals",12,50,45,95,8,Continental,Dessert,Vegetarian
Jeera Hing Aloo Recipe - No Onion No Garlic Recipe,"Baby Potato, Cumin Seeds, Ssp Asafoetida, Salt, Red Chilli Powder, Turmeric Powder, Coriander Powder, Ginger, Amchur, Sunflower Oil, Coriander",11,10,30,40,4,Indian,Lunch,Vegetarian
Cheesy Potatoes Recipe,"Potato, Onion, Sweet Corn, Mozzarella Cheese, Coriander, Red Chilli Flakes, Dried Oregano, Lemon Juice, Salted Butter, Salt",10,20,30,50,4,Indian,Appetizer,Vegetarian
Sesame Peanut Potato ,"Oil, Sesame Seeds, Green Chilli, Peanuts, Potato, Mango Powder Powder, Cumin Powder, Black Pepper Powder, Coriander, Salt",10,10,30,40,4,Indian,Lunch,Vegetarian
Potato Sagu Recipe,"Potato, Onion, Green Chilli, Ginger, Curry Leaves, Rye, White Urad Dal, Chana Dal, Asafoetida, Turmeric Powder, Coriander Powder, Coriander, Sugar, Spoon Lemon Juice, Salt, Oil",16,20,35,55,4,South Indian Recipes,South Indian Breakfast,Vegetarian
Kerala Mutton Roast Recipe - Kerala Mutton Masala,"Mutton, Black Pepper Powder, Salt, Turmeric Powder, Coconut Oil, Onion, Tomato, Ginger, Garlic, Red Chilli Powder, Turmeric Powder, Coriander Powder, Garam Masala Powder, Fennel Seeds, Curry Leaves, Salt",16,20,45,65,2,Kerala Recipes,Main Course,Non Vegeterian
Horlicks Cookies Recipe,"Salted Butter, Vivatta Maida, Sugar, Horlicks",4,10,15,25,10,Continental,Snack,Vegetarian
Watermelon And Corn Salad Recipe - A Refreshing Summer Salad,"Watermelon, Del Monte Whole Corn Kernels, Basil Leaves, Mint Leaves, Lemon Juice, Salt, Black Pepper Powder, Pickled Jalapenos, Extra Virgin Olive Oil, Honey",10,10,5,15,4,Continental,Appetizer,Vegetarian
Pata Gobi Aur Kele Kofta Curry Recipe - No onion No Garlic,"Raw Banana, Cabbage, Gram Flour, Green Chilli, Cumin Seeds, Coriander, Cumin Powder, Red Chilli Powder, Garam Masala Powder, Turmeric Powder, Salt, Sunflower Oil, Tomato, Ginger, Green Chilli, Gram Flour, Fresh Cream, Curd, Coriander Powder, Turmeric Powder, Cumin Powder, Garam Masala Powder, Bay Leaf, Cardamom, Salt, Sunflower Oil",26,10,30,40,4,North Indian Recipes,Lunch,No Onion No Garlic (Sattvic)
Tuna Roasted Mushroom Sandwich Recipe with Tartare Dip Mayo,"Ciabatta Bread, Canned Tuna, Button Mushrooms, Onion, Black Olives, Cherry Tomato, Lemon Juice, Del Monte Tartare Dip, Rocket Leaves, Extra Virgin Olive Oil, Fresh Thyme Leaves, Salt, Black Pepper Powder, Red Romaine Lettuce",14,15,30,45,4,Continental,World Breakfast,No Onion No Garlic (Sattvic)
Dark Chocolate Cherry Cake Recipe,"Whole Wheat Flour, Instant Oats, Sugar, Cocoa Powder, Dark Chocolate, Fresh Cherries, Whole Eggs, Sunflower Oil, Hot Water, Milk, Vanilla Extract, Baking Powder, Salt",13,15,40,55,5,Continental,World Breakfast,No Onion No Garlic (Sattvic)
Sago Khichdi Recipe (Savory Tapioca Pearls Stir Fry),"Sabudana, Raw Peanuts, Anardana Powder, Coriander, Sunflower Oil, Salt, Potato, Tomato, Lemon Juice, Green Chilli",10,20,20,40,2,Indian,Dinner,Vegetarian
Lauki Moongphali Soup ,"Gourd, Green Chili, Ginger, Peanuts, Salt, Rajgira Flour, Olive Oil, Mint Leaves, Black Pepper Powder, Cream Garnish",10,30,15,45,2,Indian,Side Dish,Vegetarian
Whole Wheat Onion Stuffed Kulcha Recipe,"Wheat Flour, Active Dry Yeast, Sugar, Garlic, Salt, Water, Onion, Green Coriander, , Buds Garlic, Salt, Red Chilli Powder, Turmeric Powder",13,150,40,190,4,North Indian Recipes,Dinner,Vegetarian
Whole Wheat Palak Naan Recipe,"Whole Wheat Flour, Spinach Leaves, Baking Soda, Salt, Sugar, Sunflower Oil, Curd, Ghee, Kalonji",9,25,25,50,4,North Indian Recipes,Dinner,High Protein Vegetarian
"Mizoram Inspired Veg Sawhchiar Recipe-Rice Pilaf With Kashmiri Red Chillies, Bay Leaf and Paneer","Basmati Rice, Paneer, Cardamom, Bay Leaf, Kashmiri Dry Red Chilli, Iceberg Lettuce, Spinach Leaves, Black Pepper Powder, Salt, Sunflower Oil",10,15,25,40,2,North East India Recipes,Main Course,Vegetarian
Khakara Vegetable Pizza Recipe,"Whole Wheat Flour, Red Chilli Powder, Turmeric Powder, Kasuri Methi, Ajwain, Salt, Sunflower Oil, Water, Green Bell Pepper, Red Bell Pepper, Yellow Bell Pepper, Broccoli, Onion, Tomato, Sunflower Oil, Dried Oregano, Red Chilli Flakes, Mozzarella Cheese",18,20,0,20,4,Indian,Snack,Vegetarian
Tri Color Rotini Spirali Pasta Recipe Tossed in Creamy Basil Sauce,"Del Monte Tricolour Spirali Pasta, Apricots, Walnuts, Salt And Pepper, Basil Leaves, Garlic, Milk, Salt And Pepper, Extra Virgin Olive Oil",9,20,20,40,4,Italian Recipes,Dinner,Vegetarian
Spinach Omelette Recipe,"Whole Eggs, Spinach, Spring Onion Greens, Turmeric Powder, Red Chilli Powder, Salt, Milk, Extra Virgin Olive Oil",8,10,15,25,3,Continental,World Breakfast,Eggetarian
Spinach And Feta Cheese Rotolo Recipe,"Whole Wheat Flour, All Purpose Flour, Whole Egg, Salt, Spinach, Garlic, Feta Cheese, Black Pepper Powder, Salt, Butter, All Purpose Flour, Milk, Spinach, Dried Thyme Leaves, Salt, Black Pepper Powder",16,10,45,55,4,Italian Recipes,Main Course,Vegetarian
Cheesy Loaded Veggie Nachos Recipes,"Butter, All Purpose Flour, Milk, Salt, Britannia Cheese Spread, Tomato, Onion, Green Chilli, Cumin Powder, Red Chilli Powder, Sugar, Tabasco Original, Lemon, Coriander, Salt, Sunflower Oil, Garlic, Onion, Rajma, Homemade Tomato Puree, Tabasco Original, Cumin Powder, Turmeric Powder, Salt, Nachos, Black Olives, Pickled Jalapenos, Britannia Cheese Block",28,10,20,30,4,Mexican,Appetizer,Vegetarian
Maharashtrian Anarsa Recipe,"Cup Rice, Cup Jaggery, Milk, Ripe Bananas, Poppy Seeds, Sunflower Oil, Salt",7,20,45,65,4,Maharashtrian Recipes,Snack,Vegetarian
Lal Mathachi Bhaji Recipe - Amaranth Leaves Moong Sprouts Sabzi,"Red Amaranth Leaves, Green Moong Sprouts, Mustard Seeds, Asafoetida, Onion, Garlic, Turmeric Powder, Red Chilli Powder, Jaggery, Salt",10,10,30,40,4,Maharashtrian Recipes,Lunch,Diabetic Friendly
Cinnamon Rice Pudding With Cherry Compote Recipe,"Basmati Rice, Water, Milk, Heavy Whipping Cream, Condensed Milk, Vanilla Extract, Almond Essence, Cinnamon Powder, Nutmeg Powder, Canned Cherries, Sugar, Corn Flour, Vanilla Extract",13,10,45,55,4,Continental,Dessert,Vegetarian
Aloo Parwal Sabzi ,"Parwal, Potato, Peanuts, Turmeric Powder, Red Chilli Powder, Coriander Powder, S Coriander, Rye, Salt, Oil",10,10,40,50,6,Indian,Lunch,Vegetarian
Mixed Flour And Spring Onion Cheela Recipe,"Bajra Flour, Jowar Flour, Rice Flour, Ginger Garlic Paste, Cumin Seeds, Coriander Powder, Turmeric Powder, Spring Onion, Salt, Red Chilli Powder, Sunflower Oil Shallow Fry",11,10,15,25,4,Indian,Indian Breakfast,Vegetarian
Paneer in Yogurt Tomato Curry ,"Paneer, , Asafetida, Cinnamon, Cardamom, Bay Leaves   Tomato  Grated, Royal Cumin, Kashmiri Red Chilli Powder, , Curd, Saffron, Ginger Powder, Mixed Masala, Mustard Oil, Salt, Coriander",16,30,20,50,4,Kashmiri,Lunch,Vegetarian
No Cream Healthy Broccoli Pasta Recipe,"Broccoli, Garlic, Vegetable Stock, Salt, Black Pepper Powder, Spirali Pasta, Extra Virgin Olive Oil, Butter, Parmesan Cheese, Red Chilli Flakes",10,10,25,35,3,Italian Recipes,Dinner,Vegetarian
Crepes Stuffed With Caramelized Banana Recipe,"Whole Wheat Flour, Whole Eggs, Milk, Extra Virgin Olive Oil, Salt, Butter, Ripe Bananas, Brown Sugar, Butter, Caramel Sauce",10,20,30,50,4,Continental,Dessert,Vegetarian
Spinach Buns Recipe (Masala Palak Pav),"Vivatta Maida, Salt, Active Dry Yeast, Sugar, Red Chilli Powder, Turmeric Powder, Kasuri Methi, Garam Masala Powder, Egg Yolks, Extra Virgin Olive Oil, Spinach, Milk, Kalonji",13,20,25,45,2,Indian,Side Dish,Vegetarian
Garlic & Ginger Spiced Potato Wedges Recipe (Baked),"Potato, Extra Virgin Olive Oil, Ginger Garlic Paste, Red Chilli Flakes, Italian Seasoning, Dried Thyme Leaves, Water",7,10,60,70,4,Continental,Snack,Vegetarian
Methi Dana Sabzi Recipe - Healthy Fenugreek Seeds Stir Fry,"Methi Seeds, Dates, Raisins, Asafoetida, Coriander, Fennel Powder, Cumin Powder, Amchur, Red Chilli Powder, Turmeric Powder, Jaggery, Coriander, Mustard Oil, Salt",14,10,20,30,4,Rajasthani,Side Dish,Vegetarian
Safed Achari Baingan ,"Eggplant, Onion, Cumin Seeds, Mustard, Ginger, Garlic, Turmeric Powder, Coriander Powder, Red Chilli Powder, Amchur Powder, Tomato, Salt, Green Coriander, Red Chilli Powder, Rye, Teaspoon Cumin Seeds, Fennel Seeds, Kalonji Seeds, Celery, Fenugreek Seeds, , Oil",22,20,40,60,4,Indian,Dinner,Vegetarian
Burmese Samosa Soup Recipe,"Samosas, Sunflower Oil, Cumin Seeds, Dry Red Chilli, Green Chilli, Ginger, Pearl Onion, Turmeric Powder, Garam Masala Powder, Black Pepper Powder, Kashmiri Red Chilli Powder, Coriander Powder, Arhar Dal, Chana Dal, Vegetable Stock Water, Tamarind Paste, Coconut Milk, Onion, Cabbage, Mixed Sprouts, Coriander, Carrots, Purple Cabbage, Lemon, Spring Onion Greens",25,30,20,50,4,Burmese,Lunch,Vegetarian
Honey Sesame Chilli Potato Recipe - Indian Chinese Chilli Potato,"Red Chilli Sauce, Tomato Ketchup, Soy Sauce, Honey, Rice Vinegar, Sunflower Oil, Sesame Seeds, Garlic, Ginger, Green Chilli, Spring Onion Greens, Baby Potato, Salt, Spring Onion Greens   Into   Pieces",14,20,20,40,4,Chinese,Appetizer,Vegetarian
Apricot Muesli Coffee Slice Recipe,"Ragi Flour, Jaggery, Muesli, Instant Coffee Powder, Extra Virgin Olive Oil, Curd, Vanilla Extract, Apricots, Egg Whites",9,15,30,45,4,Continental,Snack,Eggetarian
Banana Yogurt and Walnut Smoothie Recipe,"Ripe Bananas, Curd, Cinnamon Powder, Honey, Walnuts, Water",6,15,0,15,4,Continental,World Breakfast,Vegetarian
Himachali Pahari Auriya Kaddu Recipe - Himachali Tangy Pumpkin Sabzi,"Kaddu, Cumin Seeds, Asafoetida, Ginger, Garlic, Panch Phoran Masala, Amchur, Coriander Powder, Salt, Mustard Oil, Rice, Mustard Seeds, Yellow Mustard Seeds",13,10,35,45,4,Himachal,Lunch,Vegetarian
Goan Style Khatkhatem Recipe (Mixed Vegetable Gravy),"Kaddu, Raw Banana, Green Peas, Yellow Moong Dal, Salt, Tamarind Water, Fresh Coconut, Turmeric Powder, Dry Red Chilli",9,10,35,45,4,Goan Recipes,One Pot Dish,Vegetarian
Mango Milkshake Recipe - Mango Smoothie,"Mango, Milk, Sugar",3,5,0,5,4,Continental,Snack,Vegetarian
Strawberry Salad Recipe,"Strawberries, Onion, English Cucumber, Coriander, Extra Virgin Olive Oil, Red Chilli Flakes, Salt, Honey",8,10,15,25,4,Continental,Dinner,Vegetarian
Moong Dal Palak Cheela Recipe (Yellow Lentil And Spinach Crepes),"Yellow Moong Dal, Curd, Spinach Leaves, Onion, Coriander, Green Chilli, Ginger, Cumin Seeds, Turmeric Powder, Red Chilli Powder, Lemon Juice, Salt, Sunflower Oil",13,20,30,50,4,Indian,North Indian Breakfast,High Protein Vegetarian
One Pot Vangi Bath Recipe Using Preethi Electric Pressure Cooker (Brinjal Rice),"Rice, Brinjal, Salt, Sunflower Oil, White Urad Dal, Chana Dal, Coriander, Cumin Seeds, Sesame Seeds, Methi Seeds, Dry Red Chilli, Sunflower Oil, Mustard Seeds, Asafoetida, Turmeric Powder, Curry Leaves",16,10,20,30,4,South Karnataka,Lunch,Vegetarian
Sakkaravalli Kizhangu Poriyal Recipe - Spicy Sweet Potato Roast,"Sweet Potato, Asafoetida, Mustard Seeds, White Urad Dal, Turmeric Powder, Red Chilli Powder, Curry Leaves, Sesame, Salt",9,15,30,45,4,Chettinad,Lunch,Vegetarian
Gulab Phirni Recipe,"Rice, Milk, Few Saffron Strands, Sugar, Dried Rose Petals, Mixed Nuts",6,30,35,65,4,Indian,Dessert,Vegetarian
Malai Matar Paneer Recipe (Cottage Cheese & Peas In Rich Creamy Gravy),"Green Peas, Cashew Nuts, Poppy Seeds, Yogurt, Green Chilli, Onion, Garlic, Coriander Powder, Coriander Leaves",9,15,30,45,4,North Indian Recipes,Dinner,High Protein Vegetarian
Aloo & Nariyal Ki Kachori Recipe (Pan Fried Farali Aloo Vada),"Potato, Arrowroot Flour, Fresh Coconut, Coriander, Green Chilli, Ginger, Cashew Nuts, Roasted Peanuts, Raisins, Lemon Juice, Sugar, Cumin Seeds",12,20,40,60,4,North Indian Recipes,Snack,Vegetarian
Egg Shoap Recipe | Assamese Appetizer,"Whole Eggs, Potato, Onion, Green Chilli, Cumin Powder, Turmeric Powder, Salt, Whole Eggs, Whole Wheat Bread Crumbs, Sunflower Oil",10,20,10,30,4,Assamese,Appetizer,Eggetarian
Indian Style Tapenade Recipe,"Loaf French Bread, Green Moong Dal, Salt, Black Olives, Green Olives, Onion, Garlic, Green Chilli, Extra Virgin Olive Oil, Lemon Zest, Parsley Leaves, Dry Red Chilli, Lemon Juice, Extra Virgin Olive Oil, Dry Red Chilli",15,10,30,40,4,Indian,Snack,High Protein Vegetarian
Oats Banana And Apple Porridge Recipe For Babies And Toddlers,"Apple, Ripe Bananas, Instant Oats",3,5,15,20,2,Indian,Lunch,Vegetarian
Bengali Luchi Recipe - Bengali Softa Maida Puffed Puri,"All Purpose Flour, Ghee, Salt, Sunflower Oil, Lukewarm Water",5,20,30,50,4,Bengali Recipes,Lunch,Vegetarian
Andhra Avakaya Recipe - Spicy Raw Mango Pickle Recipe,"Mango, Mustard Seeds, Methi Seeds, Red Chilli Powder, Salt, Garlic, Gingelly Oil",7,30,10,40,5,Andhra,Side Dish,Vegetarian
Chettinad Style Pepper Mushroom ,"Button Mushrooms, Tomato, Green Chili, Bay Leaf, Fennel, Curry Leaves, Green Coriander, Small Spoon Oil, Salt, Coconut, Coriander Seeds, Whole Pepper, Cumin Seeds, Poppy Seeds, Fennel, Lentil Sugar, Cardamom, , Round Flower, Mace, Nutmeg, Dry Red Chilli, White Urad Dal, Onion, Garlic, Ginger, Curry Leaves, Turmeric Powder",28,15,20,35,4,Chettinad,Lunch,Vegetarian
Brahmin Style Vegetable Kurma Recipe,"Carrots, Green Beans, Potato, Green Chilli, Mustard Seeds, Cinnamon Stick, Salt, Sunflower Oil, Fresh Coconut, Roasted Gram Dal, Coriander, Kala Jeera, Cumin Seeds, Green Chilli, Ginger, Turmeric Powder, Tamarind",17,15,20,35,4,South Indian Recipes,Lunch,No Onion No Garlic (Sattvic)
Dahi Vada With Sweet & Spicy Chutney Recipe,"White Urad Dal, Cooking Soda, Salt, Sweet Chutney, Red Chilli Powder, Cumin Powder, Black Salt, Chaat Masala Powder",8,30,45,75,4,South Indian Recipes,Snack,Vegetarian
Ragi Murukku And Kodubale Recipe -Chakli And Kodubale,"Ragi Flour, Bajra Flour, Rice Flour, Gram Flour, Urad Dal Flour, Cumin Seeds, Red Chilli Powder, Asafoetida, Butter, Lukewarm Water, Salt, Sunflower Oil",12,20,15,35,5,South Indian Recipes,Snack,Vegetarian
Spinach Paneer Kofta Curry Recipe,"Paneer, Spinach Leaves, Gram Flour, Cumin Powder, Salt, Sunflower Oil, Whole Wheat Bread Crumbs, Garlic  Grated, Ginger, Honey, Cardamom Powder, Garam Masala Powder, Salt, Red Chilli Powder, Fresh Cream, Kasuri Methi",16,30,70,100,4,North Indian Recipes,Lunch,High Protein Vegetarian
Thenkuzhal Murukku Recipe - South Indian Snack,"Rice Flour, Urad Dal Flour, Cumin Seeds, Asafoetida, Sunflower Oil, Salt, Water, Sunflower Oil",8,10,45,55,4,Tamil Nadu,Snack,Vegetarian
Hare Tamatar Ki Sabzi Recipe - Raw Tomato Curry,"Tomato, Sunflower Oil, Cumin Seeds, Mustard Seeds, Asafoetida, Dry Red Chilli, Green Chilli, Turmeric Powder, Red Chilli Powder, Coriander Powder, Cumin Powder, Garam Masala Powder, Kasuri Methi, Salt",14,10,30,40,4,Indian,Lunch,Vegan
Pineapple And Semolina Sheera Recipe,"Sooji, Ghee, Sugar, Pineapple, Raisins, Pistachios, Cashew Nuts, Water, Cardamom, Saffron Strands",10,10,25,35,3,North Indian Recipes,Dessert,Vegetarian
Chicken Meatballs In A Makhni Gravy Recipe,"Chicken, Onion, Garlic, Green Chilli, Whole Wheat Bread Crumbs, Salt, Sunflower Oil, Onion, Tomato, Ginger Garlic Paste, Dry Red Chilli, Cardamom, Mace, Bay Leaf, Honey, Fresh Cream, Garam Masala Powder, Kasuri Methi, Sunflower Oil, Butter, Coriander, Water",22,15,30,45,4,North Indian Recipes,Main Course,Non Vegeterian
Hare Pyaaz Ki Puri Recipe,"Wheat Flour, Oil, Cumin, Celery, Salt, Green Onion Leaves, Green Coriander, Oil",8,10,15,25,4,Indian,Dinner,Vegetarian
Makki Paneer Pakora Recipe,"Sweet Corn  Mash, Cottage Cheese, Onion, Green Coriander, Curry Leaves, Flour, Salt, Oil, Fennel Seeds, Green Chilli, Ginger",11,15,10,25,2,Indian,Snack,Vegetarian
Avarekalu Kadubu Recipe (Hyacinth Beans Steamed Dumplings),"Rice Rava, Avarekalu  Lilva Beans, Green Chilli, Curry Leaves, Cumin Seeds, Salt",6,15,10,25,2,Karnataka,South Indian Breakfast,Vegetarian
Chocolate Peda Recipe,"Milk Powder, Cocoa Powder, Condensed Milk, Milk, Cardamom Powder, Pistachios, Butter, Ghee",8,10,25,35,4,Indian,Dessert,Vegetarian
Zucchini Salad with Barbecue Sauce Dressing Recipe,"Green Zucchini, Carrot, Yellow Bell Pepper, Red Bell Pepper, Sesame Seeds, Mixed Herbs, Barbeque Sauce, Lemon Juice, Red Chilli Flakes, Extra Virgin Olive Oil, Salt",11,10,0,10,4,Continental,Appetizer,Vegetarian
Barnyard Millet Sweet Pongal Recipe (Kuthiraivali Sakkarai Pongal),"Barnyard Millet, Yellow Moong Dal, Jaggery, Cardamom Powder, Ghee, Cashew Nuts, Edible Camphor",7,20,40,60,4,South Indian Recipes,South Indian Breakfast,Vegetarian
Lebanese Style Baked Chicken and Potatoes Recipe,"Chicken Thighs, Potato, Garlic, Lemon Juice, Extra Virgin Olive Oil, Salt, Black Pepper Powder, Cumin Powder, Coriander Powder, Mint Powder, Nutmeg Powder, Rosemary, Fresh Thyme Leaves",13,10,40,50,2,Mediterranean,Main Course,Non Vegeterian
Neem Flower Rasam ,"Neem Flowers, Tamarind, Rasam Powder, Tomato, Jaggery, Ghee, Salt, Ghee, Asafoetida, Rye, Dry Red Chilli, Curry Leaves",12,10,35,45,2,South Indian Recipes,Lunch,Vegetarian
Kara Sevai Recipe (Lemon Vermicelli),"Semiya, Fresh Coconut, Asafoetida, Salt, Sugar, Turmeric Powder, Coconut Oil, Lemon Juice, Coriander, Fresh Coconut, Green Chilli, Mustard Seeds, Sunflower Oil, Mustard Seeds, Chana Dal, White Urad Dal, Raw Peanuts, Curry Leaves",18,15,15,30,2,Indian,Lunch,Vegetarian
"Summer Lettuce Salad with Cucumber, Tomato & Feta Recipe","Lettuce Leaves, Tomato, English Cucumber, Feta Cheese, Extra Virgin Olive Oil, Lemon Juice, Honey, Salt And Pepper",8,25,0,25,4,Continental,Side Dish,Vegetarian
Methi Thalipeeth Recipe (Fresh Fenugreek Leaves Flat Bread),"Whole Wheat Flour, Gram Flour, Jowar Flour, Methi Leaves, Sesame Seeds, Green Chilli, Ginger, Asafoetida, Curd, Salt, Sunflower Oil",11,15,30,45,4,Maharashtrian Recipes,North Indian Breakfast,Vegetarian
Nepalese Chicken Sekuwa Recipe,"Chicken Breasts, Tablespoon Ginger Garlic Paste, Sichuan Peppercorns, Black Pepper Powder, Tablespoon Lemon Juice, Tablespoon Turmeric Powder, Green Chilli, Cup Curd, Tablespoon Garam Masala Powder, Coriander, Salt",11,20,30,50,2,Nepalese,Appetizer,Non Vegeterian
Dry Methi Malai Matar ,"Fenugreek, Green Peas, Cream, , Bay Leaf, Lentil Sugar, Cumin Seeds, Onion, Garlic, Ginger, Green Chilli, Tomato, Tomato Ketchup, Teaspoon Garam Masala Powder, Red Chili Powder, Salt",16,10,30,40,4,North Indian Recipes,Dinner,Vegetarian
Khatua Recipe (Bhojpuri Style Khichdi),"Basmati Rice, Arhar Dal, Onion, Onion, Garlic, Green Chilli, Turmeric Powder, Lemon Juice, Ghee, Salt",10,5,20,25,4,Bihari,Dinner,Vegetarian
One Pot Aloo Gobi ,"Potato, Cabbage, Ginger, Tomato, Cumin Seeds, Turmeric Powder, Garam Masala Powder, Cardamom, Red Chilli Powder, S Of Coriander, Oil, Salt",12,10,30,40,4,North Indian Recipes,Main Course,Eggetarian
Karela Kadhi Recipe,"Flour, Curd, , Salt, Bitter Gourd, Cumin Seeds, Mustard Seeds, Curry Leaves, Onion, Green Chilli, Ginger, Garlic",12,10,20,30,12,Rajasthani,Side Dish,Diabetic Friendly
Tomato Onion Tadka Raita Recipe,"Curd, Tomato, Onion, Cucumber, Salt, Sunflower Oil, Cumin Seeds, Mustard Seeds, Curry Leaves",9,5,5,10,2,Indian,Side Dish,Vegetarian
Saffron Milk Masala Recipe,"Badam, Pistachios, Chironji, Cardamom, Sugar Grind The Cardamom, Nutmeg Powder, Saffron Strands",7,10,0,10,4,Indian,Snack,Vegetarian
Chettinad Style Urulai Roast Recipe - Baby Potato Roast,"Baby Potato, Onion, Tomato, Cumin Seeds, Mustard Seeds, Tamarind Paste, Jaggery, Salt, Sunflower Oil, Coriander, Whole Black Peppercorns, Cinnamon Stick, Cardamom, Cloves, Dry Red Chilli, Fresh Coconut, Curry Leaves",17,5,30,35,4,Tamil Nadu,Lunch,Vegetarian
Jackfruit Seed Korma Recipe,"Jackfruit Seeds, Stone Flower, Star Anise, Cinnamon Stick, Cardamom, Bay Leaves, Fennel Seeds, Onion, Garlic, Ginger, Green Chilli, Red Chilli Powder, Coriander Powder, Turmeric Powder, Garam Masala Powder, Salt, Fresh Coconut, Poppy Seeds",18,10,30,40,4,South Indian Recipes,Lunch,Vegetarian
Chaat Masala Recipe,"Cumin Seeds, Coriander, Whole Black Peppercorns, Black Salt, Amchur, Asafoetida, Salt",7,10,0,10,1,Indian,Vegetarian,Vegetarian
Whole Wheat Carrot Cake Recipe,"Whole Wheat Flour, Jaggery, Whole Eggs, Sunflower Oil, Carrots, Walnuts, Cashew Nuts, Cinnamon Powder, Clove Powder, Baking Powder, Salt, Dry Ginger Powder, Milk, Sugar",14,60,40,100,6,Continental,Dessert,Vegetarian
Kodava Thalia Puttu Recipe - Steamed Rice Coconut Cake,"Rice, Cooked Rice, White Urad Dal, Methi Seeds, Coconut Milk, Sugar, Baking Soda, Salt",8,20,15,35,4,Coorg,South Indian Breakfast,Vegetarian
Dahi Suran Ki Sabzi ,"G Suran, Curd, Cumin Seeds, Turmeric Powder, Red Chilli Powder, Garam Masala Powder, Amchoor, Salt, Oil, Coriander",10,10,30,40,4,North Indian Recipes,Lunch,Vegetarian
Cheesy Spinach Open Toast Recipe,"Spinach, Garlic, Onion, Fresh Cream, Milk, Butter, Red Chilli Flakes, Salt, Black Pepper Powder, Mozzarella Cheese, Whole Wheat Brown Bread Baguette Slices",11,10,30,40,4,Continental,Snack,Vegetarian
Cabbage Bhurji Recipe,"Cabbage, Whole Eggs, Cumin Seeds, Ginger, Garlic, Green Chilli, Coriander Powder, Turmeric Powder, Red Chilli Powder, Black Pepper Powder, Salt, Mint Leaves",12,10,20,30,4,North Indian Recipes,North Indian Breakfast,Eggetarian
Palak Makhana ,"Spinach, Tomato, Makhana, Cumin Seeds, Garam Masala Powder, Red Chilli Powder, Turmeric Powder, Dal Sugar, Tablespoons Milk, Ghee, Salt",11,20,30,50,6,North Indian Recipes,Dinner,No Onion No Garlic (Sattvic)
Parsi Style Scrambled Eggs with Green Peas ,"Eggs, Green Peas, Onion, Tomato, Green Chilli, Ginger Garlic Paste, Turmeric Powder, Curry Powder, Red Chilli Powder, Green Coriander, Oil, Lemon Juice, Ginger, Salt",14,5,10,15,4,Parsi Recipes,Indian Breakfast,Eggetarian
Penne Rigate With Minced Chicken Sauce & Cheese Recipe,"Penne Pasta, Homemade Tomato Puree, Onion, Garlic, Chicken, Dried Basil Leaves, Italian Seasoning, Red Chilli Flakes Black Pepper Powder, Extra Virgin Olive Oil, Parmesan Cheese, Salt",11,20,25,45,4,Italian Recipes,Dinner,Non Vegeterian
Chicken Seekh Kebab Recipe,"Chicken Breast, Potato, Flour, Onion, Mint, Green Coriander, Fennel Seeds, Green Chilli, Cinnamon, Salt",10,30,30,60,4,Hyderabadi,Appetizer,Non Vegeterian
Savory Ricotta Tart Recipe,"Butter, All Purpose Flour, Salt, Lemon Juice Vinegar, Whole Egg, Ricotta Cheese, Sun Dried Tomato, Basil Leaves, Black Olives, Red Chilli Flakes, Salt",11,35,90,125,4,Continental,Dinner,Eggetarian
Papad Raita ,"Curd, Papad, Cumin Powder, Paprika Powder, Spoon Coriander Leaves, Black Saltrock Salt",6,10,10,20,4,Indian,Side Dish,Vegetarian
Keerai Masiyal Recipe (Stir Fried Green with Mustard and Curry Leaves),"Greens, Cumin Seeds, Mustard Seeds, White Urad Dal, Curry Leaves, Asafoetida, Salt, Sunflower Oil",8,15,20,35,4,South Indian Recipes,Side Dish,High Protein Vegetarian
Quick Cauliflower Fried Rice Recipe,"Cauliflower, Onion, Garlic, Red Yellowgreen Bell Pepper, Sweet Corn, Green Peas, Ginger, Garlic, Spring Onion Greens, Soy Sauce, Green Chilli Sauce, Black Pepper Powder, Sunflower Oil, Salt",14,15,15,30,3,Indian,Lunch,Vegetarian
Thai Grilled Pineapple Recipe,"Pineapple, Fresh Coconut, Butter, Lemon Juice, Palm Sugar, Hung Curd",6,15,20,35,4,Thai,Dessert,Vegetarian
Paneer Stuffed Bread Fritters Recipe,"Whole Wheat Brown Bread, Milk, Sooji, Paneer, Potato, Green Chilli, Cumin Seeds, Amchur, Garam Masala Powder, Sunflower Oil, Salt, Onion, Coriander, Sunflower Oil",14,20,40,60,4,Indian,Snack,Vegetarian
Cauliflower Thai Red Curry Recipe,"Cauliflower, Salt, Bay Leaves, Sunflower Oil, Onion, Ginger, Cardamom, Cumin Seeds, Coriander, Thai Red Curry Paste, Coconut Milk, Lemon",12,20,20,40,4,Thai,Dinner,Vegetarian
Gulab Jamun Bread Pudding Recipe,"Gulab Jamun, Milk, Whole Eggs, Cardamom Powder, Whole Wheat Brown Bread, Badam, Sugar, Saffron Strands",8,10,30,40,6,Indian,Dessert,Vegetarian
Potoler Dolma Recipe (Bengali Style Stuffed Pointed Gourd Curry),"Pointed Gourd, Cashew Nuts, Turmeric Powder, Red Chilli Powder, Garam Masala Powder, Cumin Seeds, Mustard Oil, Salt, Paneer, Dried Figs, Dates, Badam, Pistachios, Raisins, Sugar, Salt, Onion, Tomato, Green Chilli, Ginger, Few  Coriander",21,30,20,50,4,Bengali Recipes,Lunch,Vegetarian
Sukhi Urad Dal Sabzi Recipe,"White Urad Dal, Water, Onion, Ginger, Green Chilli, Cumin Seeds, Ssp Asafoetida, Turmeric Powder, Coriander Powder, Garam Masala Powder, Salt, Ghee, Lemon, Coriander",14,10,30,40,2,North Indian Recipes,Lunch,High Protein Vegetarian
Chicken Kappa Biryani Recipe,"Tapioca Root, Chicken, Onion, Garlic, Ginger, Curry Leaves, Green Chilli, Turmeric Powder, Red Chilli Powder, Garam Masala Powder, Black Pepper Powder, Fresh Coconut, Salt, Coconut Oil",14,10,45,55,4,Kerala Recipes,Lunch,Non Vegeterian
Burnt Garlic Veg Fried Rice Recipe,"Cooked Rice, Carrot, Green Bell Peppers, Red Bell Pepper, Onion, Ginger, Garlic, Red Chilli Sauce, Green Chilli Sauce, Chilli Vinegar, Whole Black Peppercorns, Salt, Spring Onion Greens, Sunflower Oil, Garlic, Sunflower Oil",16,10,30,40,4,Indo Chinese,Lunch,Vegetarian
Harive Soppina Saaru Recipe (Karnataka Style Amaranth Leaves Cooked with Lentils),"Green Amaranth Leaves, Arhar Dal, Tomato, Onion, Garlic, Turmeric Powder, Cumin Seeds, Mustard Seeds, Jaggery, Dry Red Chilli, Asafoetida, Curry Leaves, Sunflower Oil, Salt, Fresh Coconut, Tamarind, Byadagi Dried Chilli, Dry Red Chilli, Cumin Seeds, Coriander, White Urad Dal, Chana Dal, Whole Black Peppercorns, Cinnamon Stick, Cloves, Sunflower Oil",26,10,20,30,4,Karnataka,Lunch,Vegetarian
Nutty Pineapple Tutti Frutti Cake Recipe (White Fruitcake),"All Purpose Flour, Baking Powder, Sugar, Butter Cooking Oil, Whole Eggs, Salt, Tutti Frutti, Mixed Nuts, Preserved Pineapple, Milk, Vanilla Extract",11,30,90,120,20,Continental,Snack,Eggetarian
Spicy Stir Fried Broccoli Recipe,"Broccoli, Garlic, Black Pepper Powder, Red Chilli Flakes, Roasted Peanuts, Extra Virgin Olive Oil, Salt",7,10,10,20,4,Asian,Appetizer,Diabetic Friendly
Spinach Egg Muffins Recipe,"Eggs, Onion, Spinach, Salt, Black Pepper Powder, Tomato, Garlic, Oil",8,10,20,30,6,Continental,World Breakfast,Eggetarian
Onion-Tomato Dosa Savoury Waffles Recipe,"Idli Dosa Batter, Onion, Tomato, Coriander, Green Chilli Paste, Salt, Curry Leaves",7,10,10,20,3,Fusion,World Breakfast,Vegetarian
Savoury Kordoi Recipe (Assamese Star Fruit Shaped Snack Recipe),"Whole Wheat Flour, Onion  Finely, Coriander, Carrot, Cumin Seeds, Ajwain, Ghee, Sunflower Oil Deep Fry, Salt",9,20,15,35,4,Assamese,Snack,Vegetarian
Sabsige Millet Pulav Recipe,"Kodo Millet, Dill Leaves  Finely, Potato, Green Peas, Cashew Nuts, Cumin Seeds, Tomato, Salt, Sunflower Oil, Fresh Coconut, Coriander, Cumin Seeds, Green Chilli, Cinnamon Stick",14,15,15,30,3,Indian,Lunch,Vegetarian
Sweet And Tangy Mango Ice-cream Recipe,"Mango, Curd, Sugar, Mango, Curd, Sugar, Green Chilli, Mango",8,15,480,495,6,Continental,Dessert,Vegetarian
Safed Murgh Handi Recipe - Chicken In White Gravy,"Chicken, Onion, Green Chilli, Cashew Nuts, Curd, Sunflower Oil, Ghee, Curry Leaves, Raisins, Coconut Milk, Kadhi Masala, Cumin Powder, White Pepper Powder, Salt, Ginger Garlic Paste, Cardamom, Bay Leaf, Cinnamon Stick, Cumin Seeds",19,20,30,50,6,Indian,Side Dish,High Protein Non Vegetarian
Kanda Kairichi Chutney Recipe - Onion & Raw Mango Chutney,"Mango, Onion, Jaggery, Roasted Peanuts, Red Chilli Powder, Salt, Sunflower Oil, Mustard Seeds, Cumin Seeds, Asafoetida",10,10,10,20,4,Maharashtrian Recipes,Side Dish,Vegetarian
Protein Rich Paneer And Horse Gram Soup Recipe - Kollu/ Kulith Soup,"Paneer, Horse Gram Dal, Broccoli, Cauliflower, Vegetable Stock Water, Star Anise, Carrot, Onion, Ginger, Garlic, Turmeric Powder, Cumin Powder, Italian Seasoning, Dill Leaves, Extra Virgin Olive Oil, Salt And Pepper",16,480,30,510,3,Continental,Main Course,High Protein Vegetarian
Goan Style Podollim Recheado Com Batata Recipe (Snake Gourd Stuffed with Sweet Potato),"Snake Gourd, Salt, Whole Wheat Bread Crumbs, Sweet Potato, Mustard Seeds, Curry Leaves, Onion, Ginger, Garlic, Turmeric Powder, Red Chilli Powder, Salt, Sunflower Oil",13,10,30,40,4,Goan Recipes,Snack,Vegetarian
Thandu Keerai Poriyal Recipe,"Gm Amaranth Leaves, Rye, Cumin Seeds, White Urad Dal, Curry Leaves, Asafoetida, Salt    Spoon Coconut  Tighten",7,20,15,35,4,South Indian Recipes,Lunch,Diabetic Friendly
Punjabi Style Tinda Sabzi Recipe,"Tinda, Onion, Garlic, Tomato, Tomato, Coriander Powder, Cumin Powder, Garam Masala Powder, Red Chilli Powder, Sunflower Oil, Cumin Seeds, Turmeric Powder, Asafoetida, Salt",14,5,15,20,4,Punjabi,Lunch,Vegetarian
Sprouted Moong and Methi Cheela Recipe - A Healthy Breakfast,"Green Moong Sprouts, White Urad Dal, Green Chilli, Fennel Seeds, Ginger, Methi Leaves, Salt, Turmeric Powder, Sunflower Oil",9,280,10,290,4,North Indian Recipes,North Indian Breakfast,Diabetic Friendly
Veggie Chop Burger Recipe,"Carrots, Beetroot, Potato, Green Peas, Sweet Corn, Onion, Green Chilli, Ginger, Cumin Powder, Red Chilli Powder, Salt, Sunflower Oil, Corn Flour, Water, Whole Wheat Bread Crumbs, Burger Buns, Veeba Burger Mayonnaise, Onion, Tomato, Iceberg Lettuce",20,30,30,60,4,Continental,Dinner,Vegetarian
Lemon Parsley Quinoa Recipe,"Quinoa, Water, Extra Virgin Olive Oil, Garlic, Dry Red Chilli, Star Anise, Salt, Parsley Leaves, Lemon, Extra Virgin Olive Oil",10,5,25,30,3,Continental,Main Course,High Protein Vegetarian
Pumpkin Hummus Recipe,"Pumpkin Puree, Kabuli Chana, Garlic, Tahini, Extra Virgin Olive Oil, Lemons, Salt, Cumin Powder, Red Chilli Flakes",9,20,30,50,4,Middle Eastern,High Protein Vegetarian,High Protein Vegetarian
Homemade Dhansak Masala Powder Recipe,"Coriander, Dry Red Chilli, Cloves, Cardamom, Cinnamon Stick, Black Cardamom, Whole Black Peppercorns, Bay Leaf, Star Anise, Mustard Seeds, Poppy Seeds, Nutmeg Powder",12,0,10,10,200,Parsi Recipes,High Protein Vegetarian,High Protein Vegetarian
Quick And Simple Egg Curry Recipe,"Whole Eggs, Tomato, Turmeric Powder, Garam Masala Powder, Coriander Powder, Red Chilli Powder, Sugar, Salt, Coriander, Sunflower Oil, Onion, Ginger, Garlic, Green Chilli",14,25,30,55,4,Indian,Side Dish,Eggetarian
Eggless Bread Omelette Recipe,"Gram Flour, All Purpose Flour, Red Chilli Powder, Salt, Tablespoon Chaat Masala Powder, Water, Baking Powder, Butter Smear, Cup Onion, Green Chilli, Coriander, Tomato, Whole Wheat Brown Bread",13,10,5,15,4,Continental,World Breakfast,Vegetarian
Barnyard Millet and Ragi Khichdi Recipe,"Barnyard Millet, Yellow Moong Dal, Ragi Seeds, Ginger, Turmeric Powder, Cinnamon Stick, Ghee, Asafoetida, Whole Black Peppercorns, Cumin Seeds",10,20,45,65,4,North Indian Recipes,Dinner,Vegetarian
Coffee Recipe With Instant Coffee Powder,"Milk, Fresh Cream, Sugar, Instant Coffee Powder",4,2,2,4,2,Indian,Vegetarian,Vegetarian
Manipuri Style Tan Ngang Recipe - Refined Flour/Maida Indian Puri Recipe,"All Purpose Flour, Hung Curd, Salt, Water Knead",4,10,15,25,4,North East India Recipes,Lunch,Vegetarian
Mini Onion Vada With Vengaya Sambar Recipe - Pan Fried Fritters in Tangy Lentil Curry,"White Urad Dal, Ginger, Green Chilli, Salt, Onion, Coriander, Sunflower Oil, Arhar Dal, Pearl Onion, Mooli Mullangi, Carrot, Tamarind Water, Sambar Powder, Salt, Coriander, Gingelly Oil, Mustard Seeds, Dry Red Chilli, Curry Leaves, Asafoetida",20,190,40,230,4,Tamil Nadu,South Indian Breakfast,Vegetarian
North Kanara Sweet And Sour Raw Mango Chutney Recipe,"Mango, Byadagi Dried Chilli, Fresh Coconut, Asafoetida, Jaggery, Kashmiri Red Chilli Powder, Salt, Sunflower Oil",8,25,5,30,4,Coastal Karnataka,Side Dish,Vegetarian
German Pancakes with Caramelised Apples Recipe,"All Purpose Flour, Butter, Sugar, Milk, Whole Egg, Vanilla Extract, Apples, Cinnamon Powder, Nutmeg Powder, Dry Ginger Powder",10,10,25,35,4,Continental,World Breakfast,Eggetarian
Hariyali Paneer Tikka Masala Gravy ,"Paneer, Fennel, Green Chilli, Green Coriander, Peppermint, Tomato, Ginger, Cardamom, Garam Masala Powder, Bay Leaf, Chaat Masala Powder, Cream, Salt, Butter",14,20,25,45,4,North Indian Recipes,Lunch,High Protein Vegetarian
Dhokla Sandwich With Capsicum And Paneer Recipe,"Poha, Curd, Sooji, Gram Flour, Green Chilli, Cumin Seeds, Ginger, Enos Fruit Salt, Salt, Sunflower Oil, Cumin Seeds, Mustard Seeds, Curry Leaves, Asafoetida, Sunflower Oil, Red Bell Pepper, Yellow Bell Pepper, Green Bell Peppers, Paneer, Green Chutney, Red Chilli Sauce",21,25,30,55,4,North Indian Recipes,Snack,Vegetarian
Phool Makhana Kheer Recipe - Sweetened With Jaggery,"Milk, Lotus Seeds, Jaggery, Badam, Pistachios, Cardamom Powder, Dried Rose Petals, Ghee",8,10,25,35,5,North Indian Recipes,Dessert,Vegetarian
Healthy Kala Chana Pakora Recipe - Black Chickpea Pakora,"Kala Chana, Onion, Green Chilli, Garlic, Ginger, Coriander, Salt, Chaat Masala Powder, Mint Leaves, Amchur, Cumin Powder, Lemon Juice",12,500,15,515,7,Indian,Snack,Vegetarian
Malnad Special Appe Midi Uppinakayi Recipe - Tender Mango Pickle,"Tender Mango, Rock Salt, Byadagi Dried Chilli, Mustard Seeds, Turmeric Powder, Asafoetida, Sunflower Oil",7,5,30,35,10,Karnataka,Side Dish,Vegetarian
Carrot Podi Dosa Recipe,"Idli Dosa Batter, Idli Dosa Podi, Carrots, Sunflower Oil",4,10,20,30,4,South Indian Recipes,South Indian Breakfast,Vegetarian
Cabbage Chana Dal Sabzi - Gobi Chana Dal Recipe,"Cabbage, Green Chilli, Chana Dal, Curry Leaves, Sunflower Oil, Cumin Seeds, Mustard Seeds, Asafoetida, Turmeric Powder, Salt, Kashmiri Red Chilli Powder, Cumin Powder, Garam Masala Powder",13,30,24,54,4,North Indian Recipes,Side Dish,Diabetic Friendly
Tallyanche Suke Recipe - Sardine Dry,"Sardine Fish, Salt, Ginger, Sichuan Peppercorns, Turmeric Powder, Red Chilli Powder, Green Chilli, Kokum, Dry Coconut",9,10,20,30,4,Goan Recipes,Lunch,High Protein Non Vegetarian
South Indian Poli Recipe with Coconut (Obbattu/Bobbattu),"Whole Wheat Flour, Turmeric Powder, Sunflower Oil, Ghee, Chana Dal, Jaggery, Fresh Coconut, Cardamom Powder",8,60,60,120,6,South Indian Recipes,Main Course,Vegetarian
Spicy Moroccan Rice With Chicken Recipe,"Chicken, Onion, Butter, Rice, Chicken Stock, Kabuli Chana, Parsley Leaves, Cumin Seeds, Dry Ginger Powder, Salt, Black Pepper Powder, Cinnamon Stick, Coriander, Red Chilli Powder, All Spice Powder, Cloves",16,30,20,50,4,African,Main Course,High Protein Non Vegetarian
Moong Ki Khichdi Recipe,"Green Moong Dal, Basmati Rice, Chana Dal, Yellow Moong Dal, Mixed Vegetables, Ghee, Cloves, Cumin Seeds, Mustard Seeds, Turmeric Powder, Red Chilli Powder, Salt, Coriander",13,20,30,50,2,Indian,Lunch,Vegetarian
Pineapple Banana & Oat Smoothie Recipe,"Pineapple, Ripe Bananas, Instant Oats, Curd, Dates, Ice Cubes Serve",6,20,0,20,4,Continental,Snack,Vegetarian
Eggless Orange and Apple Ice Cream Recipe,"Fresh Orange Juice, Orange Zest, Apple, Condensed Milk, Heavy Whipping Cream, Caster Sugar, Orange Zest, Canned Cherries",8,15,30,45,2,Continental,Dessert,Vegetarian
Lauki Ke Gatte Recipe - Whole Wheat Bottle Gourd Dumplings,"Bottle Gourd, Whole Wheat Flour, Green Chilli, Garlic, Turmeric Powder, Red Chilli Powder, Salt, Coriander Powder, Coriander, Baking Soda, Water, Coriander, Onion, Curry Leaves, Cumin Seeds, Mustard Seeds, Asafoetida, Dry Red Chilli, Sunflower Oil",19,10,60,70,3,Rajasthani,Snack,Vegetarian
Paneer Jalfrezi Recipe,"Paneer, Onion, Red Bell Pepper, Green Bell Pepper, Carrots, Ginger, Garlic, Tomato, Homemade Tomato Puree, Honey, Turmeric Powder, Garam Masala Powder, Coriander Powder, Stalk Coriander, Butter",15,20,40,60,4,North Indian Recipes,Side Dish,Vegetarian
Soya And Spinach Curry Recipe,"Stalks Spinach Leaves, Soy Chunks, Tomato, Onion, Garlic, Ginger, Green Chilli  Slit Lengthwise, Bajra Flour, Curd, Salt, Garlic, Dry Red Chilli, Sunflower Oil",13,20,30,50,4,North Indian Recipes,Side Dish,High Protein Vegetarian
Bengali Phool Gobhir Paturi Recipe (Cauliflower & Potatoes With Poppy Seed Paste),"Potato, Cauliflower, Cumin Seeds, Poppy Seeds, Turmeric Powder, Green Chilli, Sunflower Oil, Salt",8,10,30,40,4,Bengali Recipes,Lunch,Vegetarian
Kongunadu Style Arisi Paruppu Sadam Recipe,"Rice, Arhar Dal, Cumin Seeds, Fennel Seeds, Curry Leaves, Dry Red Chilli, Onion, Tomato, Garlic, Coriander Powder, Red Chilli Powder, Turmeric Powder, Sambar Powder, Salt, Sunflower Oil Ghee, Coriander",16,30,30,60,4,Tamil Nadu,Lunch,Vegetarian
How To Make Homemade Rose Syrup Recipe,"Rose Petals, Water, Cloves, Sugar",4,15,20,35,200,Indian,Lunch,Vegetarian
Punjabi Garam Masala Powder Recipe,"Cumin Seeds, Cardamom, Coriander, Whole Black Peppercorns, Fennel Seeds, Cinnamon Stick, Cloves, Bay Leaves, Dry Ginger Powder, Nutmeg",10,10,20,30,200,North Indian Recipes,Vegetarian,Vegetarian
Moroccan Spiced Cauliflower And Almond Soup Recipe,"Cauliflower, Badam, Onion, Garlic, Coriander Powder, Cumin Powder, Cinnamon Powder, Pickled Jalapenos, Extra Virgin Olive Oil, Salt, Badam, Spring Onion Greens, Green Chilli Paste",13,10,15,25,2,African,Appetizer,Vegetarian
Gutti Dondakaya Vepudu Recipe - Andhra Style Stuffed Ivy Gourds,"Tindora, Onion, Mustard Seeds, Cumin Seeds, Dry Red Chilli, Asafoetida, Curry Leaves, Sunflower Oil, Salt, White Urad Dal, Raw Peanuts, Coriander, Sesame Seeds, Dry Red Chilli, Sunflower Oil",15,15,20,35,4,Andhra,Side Dish,Vegetarian
"Cherry Tomato, Cucumber, Onion Salad in Red Wine Vinaigrette Dressing Recipe","Cherry Tomato, Cucumber, Onion, Mint Leaves, Red Wine Vinaigrette, Extra Virgin Olive Oil, Salt And Pepper",7,25,0,25,4,Continental,Appetizer,Vegan
Maharashtrian Style Kolhapuri Khichdi Recipe,"Tapioca Flour, Potato, Cumin Seeds, Turmeric Powder, Black Pepper Powder, Sugar, Salt, Sunflower Oil, Roasted Peanuts, Fresh Coconut, Coriander, Green Chilli",12,130,25,155,4,Maharashtrian Recipes,North Indian Breakfast,Vegetarian
Sandesh Panna Cotta Recipe,"Paneer, Milk Powder, Caster Sugar, Milk, Heavy Whipping Cream, Saffron Strands, Gelatin, Pistachios",8,10,10,20,4,Fusion,Dessert,Vegetarian
Aloo Bhajia Recipe - Potato Bajji,"Potato, Gram Flour, All Purpose Flour, Red Chilli Powder, Ajwain, Salt, Sunflower Oil",7,10,20,30,4,North Indian Recipes,Snack,Vegetarian
Tawa Paratha ,"Wheat Flour, Salt, Oil Knead, Ghee",4,10,10,20,2,Indian,Lunch,Vegetarian
Shakshuka With Spinach & Feta Cheese Recipe,"Extra Virgin Olive Oil, Onion, Red Bell Pepper, Garlic, Pickled Jalapenos, Spinach, Homemade Tomato Puree, Tomato, Bay Leaf, Cumin Powder, Red Chilli Powder Roasted Paprika, Salt And Pepper, Sugar, Feta Cheese, Whole Eggs, Coriander",16,15,40,55,4,African,World Breakfast,Eggetarian
Spicy Minced Chicken Keema Balls Curry Recipe,"Chicken, Onion, Ginger Garlic Paste, Coriander, Cashew Nuts, Green Chilli, Whole Eggs, Salt, Sunflower Oil, Onion, Tomato, Mint Leaves, Turmeric Powder, Ginger Garlic Paste, Red Chilli Powder, Garam Masala Powder, Black Pepper Powder, Salt, Lemon Juice, Coriander",20,10,20,30,4,North Indian Recipes,Dinner,Non Vegeterian
Dadpe Pohe Recipe (Maharashtrian Poha),"Poha, Onion, Tomato, Carrot, Coriander, Sev, Fresh Coconut, Sugar, Lemon Juice, Salt, Mustard Seeds, Cumin Seeds, Asafoetida, Curry Leaves, Raw Peanuts, Green Chilli, Sunflower Oil",17,15,2,17,2,Maharashtrian Recipes,Indian Breakfast,Vegetarian
Garlic Chicken Cheese Balls Recipe,"Chicken, Onion Powder, Garlic, Garlic  Finely, Salt, Black Pepper Powder, Dried Oregano, Mozzarella Cheese, All Purpose Flour, Whole Eggs, Sunflower Oil, Whole Wheat Bread Crumbs",12,10,25,35,4,Continental,Appetizer,Non Vegeterian
Kerala Style Nadan Tomato Curry Recipe ,"Tomato, Green Chilli, Turmeric Powder, Red Chilli Powder, Salt, Coconut Oil, Mustard, Cast Curry Leaves, Coconut, Cumin Seeds, Onion",11,10,20,30,4,Kerala Recipes,Side Dish,Vegetarian
Kesar Paneer Ki Kheer Recipe - Cottage Cheese Milk Pudding,"Milk, Paneer, Saffron Strands, Sugar, Cardamom Powder, Badam, Pistachios, Edible Silver Foilleaf",8,20,40,60,4,North Indian Recipes,Dessert,Vegetarian
Yellow Thai Curry Paste Recipe,"Stock Lemon Grass, This Galangal Ginger, Onion, Dry Red Chilli, Kaffir Lime Leaves Basil Leaves, Bud Garlic, Coriander Seeds, Cumin Seeds, Whole Pepper, Turmeric Powder",10,15,0,15,1,Thai,Main Course,Vegetarian
Aubergine And Cranberry Beans Dip Recipe,"Brinjal, Cranberries, Parsley Leaves, Sesame Seeds, Lemon Juice, Salt, Sunflower Oil",7,0,45,45,4,Continental,Appetizer,Vegetarian
Microwave Oats Milk Halwa Recipe,"Instant Oats, Water, Sugar, Cardamom Powder, Pistachios, Ghee",6,10,10,20,2,Indian,Dessert,Vegetarian
Kerala Style Vendakkai Thoran ,"Okra, Small Onion, Coconut, Green Chilli, Curry Leaves, Mustard, Turmeric Powder, Salt, Oil",9,15,15,30,4,Kerala Recipes,Lunch,Diabetic Friendly
Cheesy Veg Paniyaram Recipe With Cheesy Tomato Chutney,"Bajra, Idli Rice, White Urad Dal, Methi Seeds, Salt, Bajra Dosa Batter, Onion, Carrot, Beetroot, Britannia Cheese Cubes, Sunflower Oil, Onion, Green Chilli, Garlic, Tomato, Red Chilli Powder, Salt, Britannia Cheese Spread",18,15,10,25,4,South Indian Recipes,South Indian Breakfast,Vegetarian
Chanar Payesh Recipe,"Paneer, Milk, Sugar, Cardamom Powder, Saffron Strands, Cashew Nuts, Raisins, Badam, Few Pistachios, Mixed Nuts, Rose Petals, Saffron Strands",12,10,40,50,4,Bengali Recipes,Dessert,Vegetarian
Spicy Indian Style Masala Frittata Recipe,"Whole Eggs, Onion, Tomato, Green Bell Pepper, Clove Garlic, Green Chilli, Coriander, Nutralite Cheesy Garlic Mayo, Garam Masala Powder, Red Chilli Flakes Paprika, Cheese, Salt And Pepper, Nutralite Garlic & Oregano Spread",13,15,30,45,2,Italian Recipes,World Breakfast,Eggetarian
Melon Salsa Recipe,"Honey Dew Melon, English Cucumber, Onion, Green Chilli, Coriander, Lemon Juice, Salt",7,0,10,10,4,Continental,Appetizer,Vegetarian
Besan Arbi Roast ,"Gm Arabic, Flour, Red Chilli Powder, Coriander Powder, Turmeric Powder, Mango Powder, Cumin Powder, Salt, Asafoetida, Oil, Oil, Cumin Seeds, Celery, Green Chili, Lemon Juice, Green Coriander",16,20,30,50,4,Indian,World Breakfast,Gluten Free
Giant Skillet Cookie Recipe,"All Purpose Flour, Baking Soda, Salt, Butter, Sugar, Brown Sugar, Whole Egg, Vanilla Extract, Cup Milk, Chocolate Chips",10,15,30,45,4,Continental,Snack,Vegetarian
Spring Onion Pakoda Recipe,"Green Onion, Rice Flour, Green Chilies, Green Coriander, Mint, Coriander Seeds, Turmeric Powder, Ino Fruit Salt, Oil, Salt",10,15,15,30,4,Indian,Snack,Vegetarian
Lal Bhoplyacha Bharit Recipe (Red Pumpkin Raita),"Kaddu, Hung Curd, Sunflower Oil, Cumin Seeds, Green Chilli, Groundnut Powder, Asafoetida, Sugar, Salt, Coriander",10,10,15,25,4,Indian,Side Dish,Vegetarian
Gujarati Style Osaman Dal Recipe,"Arhar Dal, Turmeric Powder, Salt, Mustard Seeds, Cumin Seeds, Cloves, Cinnamon Stick, Cardamom Powder, Green Chilli, Garlic, Curry Leaves, Jaggery, Ghee",13,10,25,35,4,Gujarati Recipesï»¿,Lunch,High Protein Vegetarian
Tomato Mozzarella Bites Recipe,"Cherry Tomato, Mozzarella Cheese, Basil Leaves, Extra Virgin Olive Oil, Salt, Balsamic Vinegar, Black Pepper Powder, Toothpicks, Rosemary",9,0,10,10,4,Italian Recipes,Appetizer,Vegetarian
Chettinad Pattani Kurma Recipe (Chettinad Peas Curry),"Fresh Coconut, Cashew Nuts, Chana Dal, Poppy Seeds, Garlic, Ginger, Cinnamon Stick, Cloves, Cardamom, Fennel Seeds, Green Chilli, Green Peas, Onion, Tomato, Sunflower Oil, Cinnamon Stick, Cloves, Cardamom, Fennel Seeds, Red Chilli Powder, Lemon Juice, Curry Leaves, Salt",23,15,20,35,4,Chettinad,Dinner,Vegetarian
Mustard Mayo Baby Potato Salad Recipe,"Baby Potato, Onion, Green Bell Pepper, Extra Virgin Olive Oil, Black Pepper Powder, Sweet And Spicy Red Chilli Sauce, English Mustard Sauce, Classic Mayonnaise, Chilli Vinegar, Salt, Spring Onion Greens Garnish",11,20,15,35,2,Continental,Appetizer,Vegetarian
Low Fat Aloo Bonda Recipe - Made In Kuzhi Paniyaram Pan,"Gram Flour, Rice Flour, Turmeric Powder, Red Chilli Powder, Baking Soda, Salt, Sunflower Oil, Mustard Seeds, Potato, Green Chilli, Curry Leaves, Ginger, Turmeric Powder, Red Chilli Powder, Asafoetida",15,20,30,50,4,South Indian Recipes,Snack,Vegetarian
Hara Bhara Kebab Recipe with Millets,"Green Peas, Mint Leaves, Ginger, Green Chilli, Barnyard Millet, Potato, Paneer, Gram Flour, Onion, Chaat Masala Powder, Garam Masala Powder, Salt, Sunflower Oil",13,20,40,60,4,North Indian Recipes,Snack,Vegetarian
Easy Tomato And Cheese Mini Pizza Recipe,"All Purpose Flour, Sugar, Salt, Active Dry Yeast, Tablespoon Extra Virgin Olive Oil, Lukewarm Water, Cherry Tomato, Garlic, Mozzarella Cheese, Onion, Tablespoon Extra Virgin Olive Oil, Salt",12,120,20,140,4,Italian Recipes,Dinner,Vegetarian
High Protein Broccoli & Coriander Loaf Recipe,"Broccoli, Instant Oats, Egg Whites, Hung Curd, Baking Powder, Baking Soda, Nutmeg Powder, Dried Thyme Leaves, Coriander, Butter",10,30,45,75,4,Continental,World Breakfast,High Protein Vegetarian
Oats Pesarattu Recipe - Oatmeal & Green Gram Crepes,"Green Moong Dal, Oats Flour, Ginger, Green Chilli, Salt, Sunflower Oil Make Pessaratu",6,10,15,25,2,Andhra,South Indian Breakfast,High Protein Vegetarian
Spiced Beetroot Buttermilk Recipe,"Beetroot, Curd, Water, Ginger, Green Chilli, Chaat Masala Powder, Salt, Rye, Curry Leaf, Oil",10,10,15,25,6,South Indian Recipes,Lunch,Vegetarian
Healthy Tomato Carrot Onion Soup Recipe,"Oil, Tomato, Onion, Carrot, Garlic, Salt, Whole Pepper, Tablespoon Sugar",8,10,20,30,3,Indian,Dinner,Vegetarian
Maharashtrian Ambat Goda Dal Recipe,"Arhar Dal, Tamarind Water, Jaggery, Turmeric Powder, Maharashtrian Goda Masala, Coriander, Mustard Seeds, Cumin Seeds, Methi Seeds, Curry Leaves, Asafoetida, Green Chilli",12,30,30,60,4,Maharashtrian Recipes,Lunch,Vegetarian
Boodida Gummadikaya Pachi Vadiyalu Recipe -Andhra Style Ash Gourd Fritters Recipe,"White Urad Dal, Vellai Poosanikai, Green Chilli, Cooking Soda, Sunflower Oil Deep Fry, Salt",6,10,10,20,4,Andhra,Snack,Vegetarian
Chettinadu Kozhi Kuzhambu Recipe - Chettinadu Chicken Curry,"Chicken, Shallots, Tomato, Curry Leaves, Fennel Seeds, Dry Red Chilli, Green Chilli, Ginger Garlic Paste, Turmeric Powder, Fennel Powder, Coriander Powder, Red Chilli Powder, Black Pepper Powder, Tamarind Water, Salt, Sunflower Oil, Water, Coriander",18,10,45,55,4,Chettinad,Dinner,Non Vegeterian
Karnataka Style Badanekayi Palya Recipe - Long Brinjal In Spicy Coconut Recipe,"Long Green Brinjal, Turmeric Powder, Curry Leaves, Mustard Seeds, Asafoetida, Fresh Coconut, Salt, Sesame, Coriander, Chana Dal, Byadagi Dried Chilli, Cinnamon Stick",12,20,45,65,4,Karnataka,Lunch,Vegetarian
No Bake Fudge Brownies Recipe,"Chocolate Chips, Condensed Milk, Chocolate Wafers Coffee Flavoured Wafer Biscuits, Walnuts Choco Chipscaramel Chips, Vanilla Extract",5,120,15,135,6,Continental,Dessert,Vegetarian
Udupi Style Pelakai Teepe Dose Recipe (Halasina Hanina Dose Recipe),"Jackfruit Raw, Instant Dosa Mix Powder You Can Skip This And Add  Broken Rice, Curd, Fresh Coconut, Jaggery, Salt",6,5,45,50,4,Udupi,Snack,Vegetarian
No Bake White Chocolate Cheesecake Recipe,"Britannia Cream Cheese, Agar Agar, Heavy Whipping Cream, White Chocolate, Vanilla Extract, Sugar, Lemon Zest, Orange Zest, Graham Cracker Crumbs  Crush In Food Processor, Butter, Vanilla Extract",11,15,320,335,4,Continental,Dessert,Vegetarian
Thai Basil Chicken Recipe-Pad Krapow Gai,"Chicken, Whole Egg, Corn Flour, Salt And Pepper, Basil Leaves, Fresh Red Chilli, Garlic, Green Bell Peppers, Sunflower Oil, Red Chilli Sauce, Soy Sauce, Tomato Ketchup, Corn Flour, Water",14,10,30,40,4,Thai,Appetizer,Non Vegeterian
Masoor Dal Makhani Recipe,"Masoor Dal, Onion, Tomato, Garlic, Ginger, Bay Leaf, , Cumin Seeds, Cinnamon, Garam Masala Powder, Red Chilli Powder, Coriander Powder, Ghee, Cream, Salt",15,10,20,30,4,North Indian Recipes,Lunch,High Protein Vegetarian
Snow Drop Cookies Recipe,"Butter, Sesame Seeds, Vivatta Maida, Baking Powder, Dates, Sugar, Salt",7,10,30,40,4,Indian,Snack,Vegetarian
Roasted Cherry Tomato Soup Recipe,"Cherry Tomato, Extra Virgin Olive Oil, Garlic, Rosemary, Salt And Pepper",5,10,45,55,4,Continental,Appetizer,Vegetarian
Kaju Pista Roll Recipe - Cashew Nut Pistachio Fudge,"Cashew Nuts, Pistachios, Condensed Milk, Ghee, Milk Powder, Sugar, Rose Water, Cardamom Powder",8,10,45,55,2,North Indian Recipes,Dessert,Vegetarian
Kathiawadi Dhokli Nu Shaak Recipe,"Gram Flour, Salt, Turmeric Powder, Red Chilli Powder, Ajwain, Water, Sunflower Oil, Curry Leaves, Cumin Seeds, Mustard Seeds, Asafoetida, Salt, Garam Masala Powder, Red Chilli Powder, Buttermilk, Coriander",16,15,30,45,4,Gujarati Recipesï»¿,Lunch,Vegetarian
Chocolate Chip Scone Recipe,"All Purpose Flour, Cocoa Powder, Sugar, Baking Powder, Butter, Badam, Chocolate Chips, Fresh Cream, Whole Eggs, Vanilla Extract, Recipe Chocolate Ganache",11,15,30,45,2,Continental,Snack,Eggetarian
Eggless Date And Cashew Cake Recipe,"All Purpose Flour, Whole Wheat Flour, Sunflower Oil, Caster Sugar, Dates, Cashew Nuts, Baking Soda, Salt",8,20,40,60,4,Continental,Dessert,Vegan
Doodhibhoplyacha Bharit Recipe - Maharashtrian Style Lauki Bharta,"Bottle Gourd, Curd, Rock Salt, Sugar, Sunflower Oil, Mustard Seeds, Cumin Seeds, Asafoetida, Groundnut Powder, Dry Red Chilli, Coriander",11,10,15,25,2,Maharashtrian Recipes,Lunch,Vegetarian
Cabbage Carrot Onion Pudina Thepla Recipe,"Cabbage, Carrot, Onion, Whole Wheat Flour, Green Chilli, Mint Leaves, Cumin Powder, Salt, Water Knead, Sunflower Oil Knead",10,10,30,40,4,Indian,Lunch,Vegetarian
Kolhapuri Palak Egg Curry Recipe,"Eggs, Cumin, Bay Leaf, , Dry Red Chilli, Turmeric Powder, Garam Masala Powder, Khus Khus, Coconut, Tomato, Spinach, Salt, Oil, Onion, Ginger, Garlic, Green Chilli, Almonds",18,10,45,55,4,North Indian Recipes,Lunch,Eggetarian
Cabbage Capsicum Sabzi Recipe - Simla Mirch Patta Gobi Sabzi,"Cabbage, Green Bell Pepper, Sunflower Oil, Mustard Seeds, Cumin Seeds, Dry Red Chilli, Asafoetida, Turmeric Powder, Coriander Powder, Red Chilli Powder, Salt, Lemon Juice",12,5,15,20,3,North Indian Recipes,Main Course,No Onion No Garlic (Sattvic)
Spinach Ricotta Stuffed Ravioli Recipe Tossed In Cheesy Pumpkin Sauce,"All Purpose Flour, Whole Egg, Extra Virgin Olive Oil, Baking Powder, Salt, Lukewarm Water, Spinach, Ricotta Cheese, Garlic, Extra Virgin Olive Oil, Salt And Pepper, Kaddu, Butter, Salt, Sugar, Black Pepper Powder, Cinnamon Powder, Fresh Cream, Mozzarella Cheese, Ginger Garlic Paste, Mixed Vegetables, Black Olives, Mozzarella Cheese",23,30,60,90,6,Italian Recipes,Main Course,Vegetarian
Doodh Dudhi Recipe- Bottle Gourd In Milk Curry,"Bottle Gourd, Cumin Seeds, Turmeric Powder, Red Chilli Powder, Garam Masala Powder, Milk, Sugar, Sunflower Oil, Salt, Coriander",10,10,30,40,4,Indian,Lunch,Diabetic Friendly
Beetroot & Sesame Thepla Recipe,"Beetroot, Whole Wheat Flour, Cumin Powder, Amchur, Garam Masala Powder, Red Chilli Powder, Green Chilli, Ghee, Sesame Seeds, Salt, Chilled Water",11,15,25,40,4,North Indian Recipes,Side Dish,Vegetarian
Capsicum Usili Recipe (Tamil Nadu Style Capsicum cooked with lentils spice mix),"Yellow Moong Dal, Green Bell Pepper, Dry Red Chilli, Fennel Seeds, Mustard Seeds, White Urad Dal, Curry Leaves, Asafoetida, Salt",9,15,20,35,4,Tamil Nadu,Lunch,Vegetarian
Kathirikai Sundakkai Vathal Kuzhambu Recipe,"Sundakkai, Sesame, Mustard Seeds, Methi Seeds, Curry Leaves, Asafoetida, Pearl Onion, Brinjal, Tamarind, Sambar Powder, Water, Jaggery, Salt",13,5,30,35,4,Chettinad,Lunch,Vegetarian
Mutton Keema Recipe,"Mutton, Sunflower Oil, Cumin Seeds, Bay Leaves, Whole Black Peppercorns, Cardamom, Onion, Ginger Garlic Paste, Green Chilli, Tomato, Coriander Powder, Kashmiri Red Chilli Powder, Cumin Powder, Salt, Garam Masala Powder, Mint Leaves",16,10,30,40,4,North Indian Recipes,Dinner,Non Vegeterian
Kesar Elaichi Shrikand Recipe,"Curd, Sugar  Adjustable, Cardamom Powder, Saffron Strands, Milk, Pistachios  Crushed",6,20,15,35,4,Indian,Dessert,Vegetarian
Dappalam Recipe- Andhra Vegetable Stew Recipe,"Bottle Gourd, Carrot, Sweet Potato, Drumstick, Green Chilli, Tamarind Water, Jaggery, Turmeric Powder, Red Chilli Powder, Rice Flour, Sunflower Oil, Mustard Seeds, Yellow Fenugreek Seeds, Asafoetida, Curry Leaves",15,10,19,29,4,Andhra,Lunch,Vegetarian
White Chickpeas In Spicy Gravy ,"Of Chickpea Chickpeachickpeas, Black Tea, Tomato, Green Chilli, Oil, Ghee Butter, Star Anise, Bay Leaf, Lentil Sugar, Fenugreek Seeds, Asafoetida, Kashmiri Red Chilli Powder, Cumin Powder, Coriander Powder, Turmeric Powder, Turmeric Powder, Chana Masala Powder, Onion, Garlic, Ginger, Large Cardamom, Chaat Masala Powder, Salt, Coriander, Kasuri Methi",25,20,30,50,3,Punjabi,Dinner,High Protein Vegetarian
Spinach Corn Pasta Recipe In Creamy White Sauce,"Penne Pasta, Spinach, Sweet Corn, Extra Virgin Olive Oil, Red Chilli Flakes, Dried Oregano, Extra Virgin Olive Oil, Onion, Garlic, Milk, Whole Wheat Flour, Black Pepper Powder, Salt",13,15,40,55,4,Italian Recipes,Dinner,Vegetarian
Dhaniya Pudina Chicken Tikka Recipe,"Chicken, Lemon Juice, Chaat Masala Powder, Oil, Green Coriander, Mint, Hung Curd, Green Chilli, Ginger, Garlic, Salt",11,20,20,40,2,North Indian Recipes,Appetizer,High Protein Non Vegetarian
Palak Tovve Recipe,"Spinach, Tur Dal, Coconut, Green Chilli, Coriander Leaves, Ghee, Mustard, Cumin Seeds, Asafoetida, ",10,20,30,50,4,South Indian Recipes,Side Dish,High Protein Vegetarian
Udupi Style Huli Podi Recipe (Sambar Powder),"White Urad Dal, Chana Dal, Coriander, Cumin Seeds, Methi Seeds, Curry Leaves, Dry Red Chilli, Asafoetida, Sunflower Oil",9,5,10,15,4,Udupi,Snack,Vegetarian
Cheesy Sweet Corn Grilled Sandwich Recipe,"Whole Wheat Brown Bread, Butter, Sweet Corn, Green Bell Pepper, Tomato, Whole Black Peppercorns, Dried Oregano, Mozzarella Cheese, Salt",9,10,30,40,3,Continental,World Breakfast,Vegetarian
Yellow Pumpkin Pulao Recipe,"Basmati Rice, Water, Kaddu, Fresh Coconut, Green Chilli, Salt, Turmeric Powder, Sugar, Bay Leaves, Star Anise, Cloves, Cinnamon Stick, Cumin Seeds, Sunflower Oil",14,15,15,30,2,Indian,Lunch,Vegetarian
Eggless Coffee Souffle Recipe With Chocolate Sauce,"Cup Dark Chocolate, Milk, Cup Caster Sugar, All Purpose Flour, Cup Condensed Milk, Butter, Cup Heavy Whipping Cream, Instant Coffee Powder, Chocolate Sauce, Icing Sugar",10,10,15,25,2,French,Dessert,Vegetarian
Oats and Green Moong Dal Dahi Vada Recipe,"Green Moong Dal, White Urad Dal, Instant Oats, Baking Soda, Salt, Curd, Sugar, Water, Red Chilli Powder, Coriander Powder, Green Moong Sprouts",11,500,60,560,4,North Indian Recipes,Snack,Vegetarian
Rajasthani Hare Chane Ka Halwa Recipe (Choliya Halwa),"Fresh Green Chickpeas, Sugar, Ghee, Cardamom, Ghee, Pistachios, Raisins",7,5,45,50,4,Rajasthani,Dessert,Vegetarian
Hyderabadi Marag Recipe,"Mutton, Onion, Ajwain, Whole Black Peppercorns, Cinnamon Stick, Cardamom, Cloves, Bay Leaf, Ginger Garlic Paste, Turmeric Powder, Salt, Sunflower Oil, Ghee, Water, Green Chilli, Curd, Coriander Powder, Garam Masala Powder, Coriander, Mint Leaves, Water, Cashew Nuts, Dry Coconut",23,10,20,30,3,Hyderabadi,Lunch,Non Vegeterian
Pan Fried Corn & Cheese Bites Recipe -Corn & Paneer Balls,"Paneer, Potato, Sweet Corn, Green Chilli, Coriander, Fennel Seeds, Chaat Masala Powder, Cumin Powder, Sesame Seeds",9,15,30,45,4,Continental,Snack,Vegetarian
Potato & Basil Frittata Recipe,"Coconut Oil, Butter, Baby Potato Any Potato, Salt And Pepper, Whole Eggs, Basil Leaves",6,10,30,40,2,Italian Recipes,World Breakfast,Eggetarian
Churma Ladoo Recipe With Badam & Flaxseed - High Protein Snack,"Whole Wheat Flour, Sooji, Badam, Flax Seeds, Dry Coconut, Jaggery, Ghee, Milk",8,10,60,70,4,Rajasthani,Dessert,High Protein Vegetarian
Suran Jo Kheemo Recipe-Sindhi Style Grated Yam Sabzi,"Elephant Yam, Sunflower Oil, Cumin Seeds, Onion, Tomato, Ginger, Green Chilli, Turmeric Powder, Red Chilli Powder, Cumin Powder",10,15,15,30,4,Sindhi,Lunch,Vegetarian
Lentil Tabbouleh Recipe (Middle Eastern Vegetarian Salad With Lentils),"Masoor Dal, Cherry Tomato, English Cucumber, Coriander, Mint Leaves, Lemon Juice, Extra Virgin Olive Oil, Whole Black Peppercorns, Salt",9,10,20,30,2,Middle Eastern,Side Dish,High Protein Vegetarian
Double Chocolate Coconut Fudge Recipe,"Dessicated Coconut, White Chocolate, Double Cream, Butter, Dark Chocolate, Double Cream, Walnuts, Salt",8,30,30,60,2,Continental,Dessert,Vegetarian
Pepe Chingri Recipe - Green Papaya Prawn Curry Recipe,"Raw Papaya, Prawns, Onion, Bay Leaf, Turmeric Powder, Red Chilli Powder, Cumin Powder, Mustard Oil, Salt, Coriander",10,10,30,40,4,Bengali Recipes,Lunch,Non Vegeterian
Makai Dhokla Recipe - Savoury Steamed Corn Cake,"Sweet Corn, Corn Meal, Curd, Green Chilli, Ginger, Asafoetida, Turmeric Powder, Enos Fruit Salt, Lemon Juice, Sugar, Salt, Coriander, Sunflower Oil, Sunflower Oil, Mustard Seeds, Cumin Seeds, Curry Leaves, Asafoetida, Red Chilli Powder",19,20,45,65,4,Gujarati Recipesï»¿,Snack,High Protein Vegetarian
Maharashtrian Dinkache Ladoo Recipe (Whole Wheat Flour Truffles With Edible Gum & Dry Fruits),"Whole Wheat Flour, White Urad Dal, Dessicated Coconut, Dry Dates Powder, Sugar  Powdered Jaggery, Ghee, Mixed Nuts, Gond, Cardamom Powder, Nutmeg Powder, Dry Ginger Powder",11,30,30,60,35,Maharashtrian Recipes,Snack,Vegetarian
Wheat Paratha Recipe With Pizza Topping,"Whole Wheat Flour, Sunflower Oil, Salt, Water, Mozzarella Cheese, Homemade Pizza And Pasta Sauce, Green Bell Pepper, Red Bell Pepper, Yellow Bell Pepper, Onion, Sweet Corn, Dried Oregano, Red Chilli Flakes",13,20,30,50,4,Indian,Main Course,Vegetarian
Mysore Masala Dosa Made With Ragi Dosa Batter,"Idli Rice, Ragi Seeds, White Urad Dal, Methi Seeds, Water, Onion, Roasted Gram Dal, Dry Red Chilli, Garlic, Ginger, Salt, Potato, Cumin Seeds, Curry Leaves, Asafoetida, Onion, Turmeric Powder, Coriander, Salt",19,20,40,60,4,Karnataka,South Indian Breakfast,Vegetarian
Matar Chi Usal Recipe - Green Peas In A Onion Tomato Gravy,"Green Peas, Potato, Onion, Tomato, Garlic, Ginger, Sunflower Oil, Mustard Seeds, Asafoetida, Curry Leaves, Turmeric Powder, Red Chilli Powder, Kashmiri Red Chilli Powder, Garam Masala Powder, Coriander, Salt",16,35,40,75,5,Maharashtrian Recipes,Lunch,Vegetarian
Omurice Recipe - Japanese Omelette Rice,"Cooked Rice, Onion, Chicken Thigh, Extra Virgin Olive Oil, Mixed Vegetables, Soy Sauce, Red Chilli Sauce, Salt, Black Pepper Powder, Whole Eggs, Milk, Extra Virgin Olive Oil, Cheddar Cheese, Roasted Tomato Pasta Sauce",14,10,20,30,5,Japanese,World Breakfast,High Protein Non Vegetarian
Sriracha Spiced Deviled Eggs Recipe,"Whole Eggs, Sriracha Sauce, Classic Mayonnaise, Black Pepper Powder",4,15,10,25,4,Japanese,Dinner,Eggetarian
Strawberry Bundt Cake with Muesli and Oats Recipe,"Muesli, Wheat Berries Whole Wheat, Instant Oats, Baking Powder, Baking Soda, Salt, Extra Virgin Olive Oil, Whole Egg, Vanilla Extract, Milk, Water, Date Syrup Honey, Strawberries",13,20,45,65,4,Continental,Dessert,Eggetarian
Beetroot Garlic Lemon Rasam Recipe,"Beetroot, Water, Salt, Black Pepper Powder, Cumin Seeds, Coriander, Dry Red Chilli, Garlic, Coriander, Curry Leaves, Coriander, Sunflower Oil, Mustard Seeds, Cumin Seeds, Dry Red Chilli, Asafoetida, Salt, Garlic, Coriander",19,10,20,30,4,South Indian Recipes,Lunch,Vegetarian
Spicy Matar Masala ,"Green Peas, Oil, Cumin Seeds, Mustard, Curry Leaves, Green Chilli, Bay Leaf, , Cardamom, Tablespoon Ginger Garlic Paste, Onion, Make  Onion, Tomato Puree, Red Chili Powder, Turmeric Powder, , Salt",17,30,30,60,4,Indian,Dinner,Vegetarian
Dondakkai / Kovakkai Poriyal Recipe - Tindora Poriyal,"Tindora, Mustard Seeds, White Urad Dal, Curry Leaves, Asafoetida, Fresh Coconut, Salt",7,20,30,50,4,South Indian Recipes,Side Dish,No Onion No Garlic (Sattvic)
Egg Roast Masala Dosa Recipe - With Moong Dal Dosa Batter,"Yellow Moong Dal, Idli Rice, Methi Seeds, Salt, Boiled Egg, Coconut Oil, Methi Seeds, Mustard Seeds, Onion, Garlic, Ginger, Green Chilli, Curry Leaves, Tomato, Garam Masala Powder, Red Chilli Powder, Coriander Powder, Turmeric Powder, Salt",19,15,15,30,12,South Indian Recipes,South Indian Breakfast,Eggetarian
Spiced Chocolate And Beetroot Tea Cake Recipe,"All Purpose Flour, Baking Powder, Baking Soda, Cinnamon Powder, Dry Ginger Powder, Nutmeg Powder, Salt, Cocoa Powder, Whole Eggs, Vanilla Extract, Sugar, Beetroot",12,15,30,45,4,Continental,Snack,Vegetarian
Hariyali Chicken Tikka Wrap Recipe,"Whole Wheat Tawa Paratha, Onion, Lahsun Ki Chutney, Chicken Breasts, Red Chilli Powder, Turmeric Powder, Garam Masala Powder, Amchur, Cumin Powder, Curd, Salt, Coriander, Mint Leaves, Green Chilli",14,80,45,125,4,North Indian Recipes,Snack,High Protein Non Vegetarian
Brinjal Prawns Masala Curry Recipe - Baingan Prawn Masala,"Prawns, Brinjal, Homemade Tomato Puree, Onion, Garlic, Ginger, Coriander, Green Chilli, Turmeric Powder, Red Chilli Powder, Sambar Powder, Tamarind, Salt, Sunflower Oil",14,20,20,40,4,Indian,Lunch,Non Vegeterian
Awadhi Style Taheri Recipe - Vegetable Rice Pulao Recipe,"Basmati Rice, Potato, Carrot, Green Peas, Cauliflower, Green Beans, Onion, Onion, Green Chilli, Ginger, Garlic, Curd, Mint Leaves, Coriander, Red Chilli Powder, Coriander Powder, Turmeric Powder, Salt, Sunflower Oil, Bay Leaves, Black Cardamom, Whole Black Peppercorns, Cardamom, Cloves, Cinnamon Stick",25,15,35,50,4,Awadhi,Lunch,Vegetarian
Oats and Rajma Cutlet Recipe,"Rajma, Paneer, Rolled Oats Or Instant Oats, Green Chilli, Ginger, Garlic, Garam Masala Powder, Fennel Seeds, Coriander, Salt, Sunflower Oil, Egg Whites, Whole Wheat Bread Crumbs",13,10,45,55,4,North Indian Recipes,Snack,High Protein Vegetarian
Caramelised Onion Rosemary Chicken Recipe,"Chicken Breasts, Ginger, Garlic, Salt, Paprika Powder, Rosemary, Butter, Onion, Rosemary, Salt, Sugar, Red Chilli Flakes, Honey, Mixed Herbs, Black Pepper Powder, Corn Flour, Water",17,20,25,45,2,Continental,Main Course,High Protein Non Vegetarian
Chicken Keema Samosa Recipe,"Boneless Chicken, Onion, Garlic, Ginger, Green Chilli, Mint Leaves, Red Chilli Powder, Garam Masala Powder, Amchur, Chaat Masala Powder, Sunflower Oil, All Purpose Flour, Ghee, Salt, Ajwain, Water Knead",16,30,30,60,6,Indian,Appetizer,Non Vegeterian
Beetroot Cupcakes Recipe With Oreo Frosting,"Vivatta Maida, Cocoa Powder, Baking Powder, Baking Soda, Sugar, Whole Eggs, Beetroot, Butter, Buttermilk, Lemon, Vanilla Extract, Butter, Caster Sugar, Vanilla Extract, Heavy Whipping Cream, Oreo Biscuits",16,30,20,50,20,Continental,Dessert,Eggetarian
Buckwheat Vegetable Khichdi Recipe,"Buckwheat Flour, Yellow Moong Dal, Carrots, Green Beans, Potato, Green Peas, Ajwain, Green Chilli, Cloves, Whole Black Peppercorns, Salt, Water, Sunflower Oil, Ghee, Onion, Garlic",16,120,30,150,4,Indian,Lunch,Vegetarian
Idli Chaat Recipe,"Idli, Idli Dosa Podi, Sunflower Oil, Onion, Curd, Green Chutney, Sweet Chutney, Sev, Coriander, Black Salt, Chaat Masala Powder, Lemon",12,30,0,30,2,Fusion,Snack,Vegetarian
Bruschetta With Coriander Mint Pesto And Red Bell Peppers Recipe,"Whole Wheat Brown Bread, Red Bell Pepper, Onion, Dried Oregano, Red Chilli Flakes, Salt, Coriander, Mint Leaves, Badam, Green Chilli, Garlic  Peeled, Extra Virgin Olive Oil, Parmesan Cheese, Salt",14,10,20,30,4,Italian Recipes,Appetizer,Vegetarian
Palak Kadhi Recipe - Spinach Kadhi,"Curd, Gram Flour, Turmeric Powder, Salt, Spinach, Green Chilli, Ginger, Cumin Seeds, Cumin Seeds, Mustard Seeds, Asafoetida, Curry Leaves, Dry Red Chilli, Sunflower Oil",14,5,25,30,4,Rajasthani,Lunch,Vegetarian
Restaurant Style Chicken 555 Recipe,"Chicken, Red Chilli Powder, Turmeric Powder, Garam Masala Powder, Salt, Rice Flour, Sooji, Sunflower Oil Cook, Curry Leaves",9,10,10,20,2,Indian,Appetizer,High Protein Non Vegetarian
Kerala Tomato Fry ,"Tomato, Oil, Rye, Dry Red Chilli, Curry Leaves, Onion, Ginger Garlic Paste, Green Chilli, Kashmiri Red Chilli Powder, Turmeric Powder, Salt, Green Coriander",12,10,20,30,4,Kerala Recipes,Dinner,Vegetarian
Dum Ke Shami Kebab Recipe,"Mutton, Chana Dal, Whole Black Peppercorns, Kababchini, Cumin Seeds, Ginger Garlic Paste, Onion, Coriander, Sunflower Oil Shallow Fry, Whole Egg, Charcoal, Red Chilli Powder, Salt, Cumin Powder, Raw Papaya",15,15,40,55,4,North Indian Recipes,Appetizer,Non Vegeterian
Meat Masala Stuffed Bharwa Baingan Recipe,"Brinjal, Meat Masala, Salt, Onion, Tomato, Ginger Garlic Paste, Mustard Oil, Cumin Seeds, Asafoetida",9,10,15,25,4,Indian,Lunch,Vegetarian
Bhapa Ilish Recipe (Steamed Hilsa),"Hilsa Fish, Mustard Seeds, Yellow Mustard Seeds, Curd, Salt, Turmeric Powder, Green Chilli, Mustard Oil",8,10,20,30,4,Bengali Recipes,Dinner,High Protein Non Vegetarian
Onion Pakora Roll Recipe,"Tortillas Large Roti, Veeba Carrot Cucumber Sandwich Spread, Tomato, Cucumber, Onion, Chaat Masala Powder, Gram Flour, Rice Flour, Onion, Coriander, Green Chilli, Ajwain, Salt, Enos Fruit Salt, Red Chilli Powder, Turmeric Powder, Sunflower Oil, Coriander, Mint Leaves, Curry Leaves, Roasted Peanuts, Ginger, Green Chilli, Sugar, Lemon Juice, Salt",26,10,30,40,4,Indian,Snack,Vegetarian
Banarasi Gobhi Ki Sabzi Recipe -Cauliflower Cooked With Nigella,"Cauliflower, Onion, Kalonji, Cumin Seeds, Methi Seeds, Fennel Seeds, Turmeric Powder, Black Pepper Powder, Coriander, Mustard Oil, Salt, Garlic, Ginger, Dry Red Chilli, Cumin Seeds",15,10,20,30,4,Uttar Pradesh,Side Dish,Vegetarian
Makka Cholam Sundal Recipe (Spicy Sweet Corn Recipe),"Sweet Corn, Fresh Coconut, Cumin Powder, Mustard Seeds, White Urad Dal, Asafoetida, Green Chilli, Dry Red Chilli, Curry Leaves, Salt, Sunflower Oil",11,15,15,30,2,South Indian Recipes,Side Dish,Vegetarian
Mullangi Poriyal recipe - South Indian Style Radish Stir Fry,"Mooli Mullangi, Sesame, Mustard Seeds, Curry Leaves, Dry Red Chilli, Tamarind Paste, Sambar Powder, Salt, Fresh Coconut",9,10,20,30,6,South Indian Recipes,Lunch,Vegetarian
Anhui Bang Tofu Salad Recipe,"Ginger, Soy Sauce, Peanut Butter, Red Chilli Sauce, Honey, Corn Flour, Tofu, Corn Flour, Salt, Black Pepper Powder, Sesame Seeds, Cabbage, Spring Onion, Cucumber, Salt, Sunflower Oil",16,15,20,35,4,Chinese,Side Dish,Vegetarian
Red Wine Chocolate Cake Recipe,"All Purpose Flour, Butter, Brown Sugar, Whole Egg, Egg Yolks, Red Wine, Vanilla Extract, Cocoa Powder, Baking Powder, Salt, Cinnamon Powder, Icing Sugar",12,15,45,60,6,Continental,Dessert,Eggetarian
Jaipuri Aloo Pyaz Ki Sabzi ,"Potato, Small Onion, Cumin Seeds, Tomato Puree, Turmeric Powder, Kashmiri Red Chilli Powder, Coriander Powder, Small Spoon Garam Masala Powder, Bay Leaf, Salt, Oil, Coriander, Onion, Garlic, Ginger, Green Chilli",16,10,45,55,6,Rajasthani,Lunch,Vegetarian
Tagliatelle Pasta Recipe With Fresh Tomato Basil Sauce,"Tagliatelle Pasta, Basil Leaves, Extra Virgin Olive Oil, Salt, Parmesan Cheese, Tomato, Garlic, Onion, Sugar, Whole Black Pepper Corns, Red Chilli Flakes, Basil Leaves, Salt, Red Chilli Powder, Garam Masala Powder, Amchur, Onion, Sugar, Methi Seeds, Dry Red Chilli, Garlic, Ginger",22,25,30,55,2,Italian Recipes,Main Course,Vegetarian
One Pot Vegetable Biryani Recipe In Preethi Electric Pressure Cooker,"Green Beans, Carrots, Potato, Garlic, Ginger, Onion, Green Chilli, Basmati Rice, Tomato, Cloves, Cinnamon Stick, Cardamom, Bay Leaves, Turmeric Powder, Red Chilli Powder, Coriander Powder, Salt, Sunflower Oil, Mint Leaves",19,15,30,45,4,Tamil Nadu,Lunch,Vegetarian
Fada Ni Khichdi Recipe,"Broken Wheat, Yellow Moong Dal, Turmeric Powder, Garam Masala Powder, Ghee, Carrot, Green Beans, Salt, Whole Black Peppercorns, Cloves, Cardamom, Cinnamon Stick, Curry Leaves, Ginger, Green Chilli, Cumin Seeds, Dry Red Chilli, Asafoetida",18,20,30,50,4,Gujarati Recipesï»¿,Lunch,Vegetarian
Lavand-E-Murgh Recipe - Afghani Chicken In Yoghurt Gravy,"Chicken, Sunflower Oil, Onion, Green Chilli, Cardamom, Cinnamon Stick, Cloves, Ginger Garlic Paste, Salt, Black Pepper Powder, Turmeric Powder, Coriander Powder, Garam Masala Powder, Water, Curd, Coriander, Badam, Fresh Pomegranate Fruit Kernels",18,15,25,40,4,Afghan,Dinner,High Protein Non Vegetarian
Raw Mango Dal Fry Recipe,"Tur Dal, Raw Mango, Turmeric Powder, Red Chilli Powder, Tomato, Green Chilli, Curry Leaf, Onion, Dried Red Chilli, Garlic, Salt, Ghee",12,10,30,40,2,North Indian Recipes,Side Dish,High Protein Vegetarian
Mixed Vegetable Curry Roll Recipe,"Hot Dog Bread, Sunflower Oil, Onion, Garlic, Green Chilli, Green Bell Pepper, Tomato, Mixed Vegetables, Water, Curry Powder, Red Chilli Powder, Salt, Britannia Cheese Block, Coriander, Lemon Juice, Butter",16,10,30,40,3,Indian,Snack,Vegetarian
Cheese Crackers Recipe,"Cheddar Cheese, Butter, All Purpose Flour, Salt, Paprika Powder, Chilled Water",6,70,20,90,6,Continental,Snack,Vegetarian
Mango Jalapeno Bruschetta Recipe,"Baguette, Mango, Pickled Jalapenos, Mint Leaves, Hung Curd, Lemon Juice, Garlic, Salt",8,15,0,15,4,Italian Recipes,Appetizer,Vegetarian
Kollu Pachadi Recipe (Sprouted Horse gram Raita Recipe),"Horse Gram Dal, Tomato, Onion, Cucumber, Curd, Mustard Seeds, Curry Leaves, Green Chilli, Red Chilli Powder, P Asafoetida",10,10,10,20,4,Tamil Nadu,Side Dish,Diabetic Friendly
Homemade Pan Pizza With Perfectly Crispy Crust Recipe,"Whole Wheat Flour, Salt, Sugar, Active Dry Yeast, Extra Virgin Olive Oil, Water, Onion, Mozzarella Cheese, Onion, Green Bell Peppers, Tomato, Sooji, Homemade Pizza And Pasta Sauce",13,60,60,120,4,Italian Recipes,Lunch,Vegetarian
Horsegram Sesame Chutney Recipe,"Horse Gram Dal, Sesame Seeds, Arhar Dal, Chana Dal, Pearl Onion, Coriander, Methi Seeds, Tamarind, Fresh Coconut, Fresh Red Chilli, Garlic, Salt, Sunflower Oil, Mustard Seeds, Chana Dal, White Urad Dal, Curry Leaves",17,10,15,25,4,Tamil Nadu,South Indian Breakfast,High Protein Vegetarian
Kerala Style Rich Creamy Egg Cashew Curry Recipe,"Whole Eggs, Cashew Nuts, Onion, Tomato, Potato, Ginger, Garlic, Coriander Powder, Red Chilli Powder, Turmeric Powder, Garam Masala Powder, Fennel Seeds, Coriander, Curry Leaves, Sunflower Oil, Salt",16,15,30,45,2,Kerala Recipes,Dinner,Eggetarian
Egg Bhurji Stuffed Pita Pockets Recipe,"Whole Eggs, Onion, Tomato, Green Capsicum, Green Chilli, Red Chilli Paste, Ginger, Garlic, Cumene Seeds, Pav Bhaji Masala, Turmeric Powder, Ghee, Sunflower Oil, Salt, Coriander, Whole Wheat Pita Bread  Â Whole Wheat Pita Bread, Onion, Tomato, Lemon, Chaat Masala Powder",20,20,0,20,4,Fusion,Snack,Eggetarian
Almond Butter Recipe,"Badam, Extra Virgin Olive Oil",2,60,0,60,4,Continental,Vegan,Eggetarian
Yellow Cucumber Pachadi Recipe,"Mangalorean Cucumber, Sunflower Oil, Mustard Seeds, Methi Seeds, Masoor Dal, Dry Red Chilli, Salt, Turmeric Powder, Tamarind, Asafoetida",10,20,5,25,6,South Indian Recipes,Side Dish,Vegetarian
Goan style Caril De Camarao Recipe (Prawn Curry Recipe),"Prawns, Onion, Coconut Milk, Turmeric Powder, Red Chilli Powder, Coriander Powder, Tamarind Paste, Lemon Juice, Salt, Sunflower Oil",10,5,20,25,4,Goan Recipes,Lunch,Non Vegeterian
Tamil Nadu Style Masala Dal Vada Recipe,"Chana Dal, White Urad Dal, Fennel Seeds, Green Chilli, Ginger, Garlic, Curry Leaves, Mint Leaves, Coriander, Onion, Sunflower Oil Brush, Salt, Asafoetida",13,10,250,260,2,South Indian Recipes,Snack,High Protein Vegetarian
Sticky Cranberry Gingerbread Recipe,"Cranberries, Brown Sugar, Jaggery, Honey, Butter, Milk, All Purpose Flour, Ginger, Cinnamon Powder, Baking Powder, Salt, Black Pepper Powder, Whole Eggs",13,10,60,70,4,Continental,Dessert,Eggetarian
Paruppu Thogayal Recipe -Toor & Bengal Gram Chutney,"Arhar Dal, Roasted Gram Dal, Whole Black Peppercorns, Dry Red Chilli, Onion, Fresh Coconut, Salt, Jaggery, Tamarind Paste, Sunflower Oil, Asafoetida, Salt",12,20,15,35,4,South Indian Recipes,Side Dish,Vegetarian
Mushroom Do Pyaza Recipe,"Button Mushrooms, Onion, Onion, Tomato, Ginger, Garlic, Green Chilli, Red Chilli Powder, Turmeric Powder, Coriander Powder, Cumin Powder, Garam Masala Powder, Salt, Sunflower Oil",14,10,30,40,4,North Indian Recipes,Lunch,Vegetarian
Buttermilk Cinnamon Rolls Recipe,"Whole Wheat Flour, All Purpose Flour, Buttermilk, Active Dry Yeast, Honey, Butter, Salt, Water, Butter, Cinnamon Powder, Caster Sugar, Brown Sugar, Buttermilk, Icing Sugar",14,60,180,240,4,Continental,World Breakfast,Vegetarian
Sorakaya Masala Curry Recipe - Andhra Style Sorakaya Curry,"Bottle Gourd, Sunflower Oil, Mustard Seeds, Sesame Seeds, White Urad Dal, Curry Leaves, Dry Red Chilli, Sambar Powder, Salt",9,10,10,20,2,South Indian Recipes,Lunch,Diabetic Friendly
Dark Chocolate Pots De CrÃ¨me Recipe,"Dark Chocolate, Fresh Cream, Caster Sugar, Instant Coffee Powder, Salt, Egg Yolks, Vanilla Extract",7,15,40,55,4,French,Dessert,Vegetarian
Spicy and Creamy Achari Mushroom Open Toast Recipe,"Nutralite Garlic & Oregano Spread, Whole Wheat Brown Bread, Button Mushrooms, Onion, Spring Onion Greens  Finely, Garlic, Ginger, Achari Mayo",8,10,20,30,4,Continental,World Breakfast,Vegetarian
Mango Greek Yogurt Cheesecake with Muesli Crumble Recipe,"Mango, Hung Curd, Honey, Dry Ginger Powder, Muesli, Whole Wheat Flour, Butter, Mango, Muesli",9,60,30,90,2,Continental,Dessert,Sugar Free Diet
Mumbai Style Tawa Pulao Recipe With Moong Sprouts,"Brown Rice, Ginger, Garlic, Green Bell Pepper, Onion, Tomato, Potato, Green Peas, Green Moong Sprouts, Chaat Masala Powder, Pav Bhaji Masala, Salt, Extra Virgin Olive Oil, Coriander, Sev Bhujia For Serving, Lemon",16,25,30,55,3,Maharashtrian Recipes,Lunch,Vegetarian
Healthy Creamy Chicken Soup With Vegetables Recipe,"Chicken Breasts, Lukewarm Water, Onion, Clove Garlic, Stalks Celery, Carrots, Green Peas, Sweet Potato, Green Beans, Rolled Oats Or Instant Oats, Black Pepper Powder, Cinnamon Stick, Bay Leaves, Salt, Lemon Juice, Sunflower Oil, Parsley Leaves",17,10,60,70,4,Continental,Appetizer,Non Vegeterian
Gujarati Valsadi Vada Recipe - Multigrain Masala Vada,"Wheat Berries Whole Wheat, Rice, Jowar Seeds, Arhar Dal, Chana Dal, White Urad Dal, Curd, Ginger, Green Chilli, Turmeric Powder, Asafoetida, Salt, Sunflower Oil",13,10,45,55,4,Gujarati Recipesï»¿,Snack,Vegetarian
Maharashtrian Tindora Sabzi With Peanuts Recipe,"Tindora, Garlic, Green Chilli, Coriander, Roasted Peanuts, Turmeric Powder, Mustard Seeds, Sunflower Oil, Lemon Juice, Salt",10,10,15,25,4,Maharashtrian Recipes,Side Dish,Diabetic Friendly
Goan Soya Mince Potato Chop Recipe,"Soy Chunks, Onion, Green Chilli, Green Peas, Ginger, Garlic, Coriander Powder, Red Chilli Powder, Turmeric Powder, Garam Masala Powder, Coriander, Potato, Corn Flour, Wheat Bran, Salt, Sunflower Oil",16,20,30,50,4,Goan Recipes,Appetizer,Vegetarian
Chickpea Salad Recipe With Raw Mango,"Kabuli Chana, Onion, Tomato, Mango, Green Chilli, Red Chilli Powder, Chaat Masala Powder, Sunflower Oil, Salt, Lemon Juice, Coriander, Mint Leaves",12,10,25,35,2,Indian,Appetizer,High Protein Vegetarian
Kerala Style Beetroot Pachadi Recipe,"Beetroot, Curd, Turmeric Powder, Salt, Fresh Coconut, Dry Red Chilli, Ginger, Mustard Seeds, Cumin Seeds, Sunflower Oil, Mustard Seeds, Curry Leaves, Dry Red Chilli",13,15,20,35,4,Indian,Side Dish,Vegetarian
Karela Masala Sabzi Recipe,"Karela, Onion, Garlic, Ginger, Tomato, Turmeric Powder, Amchur, Garam Masala Powder, Coriander Powder, Salt, Red Chilli Powder, Jaggery Sugar, Sunflower Oil",13,10,15,25,4,Bengali Recipes,Lunch,Vegetarian
Foxtail Millet Podi Dosa Recipe,"Foxtail Millet, Idli Rice, White Urad Dal, Methi Seeds, Idli Dosa Podi",5,520,45,565,4,South Indian Recipes,South Indian Breakfast,Diabetic Friendly
Bhaja Pithe Recipe,"Yellow Moong Dal, Sweet Potato, Rice Flour, Whole Wheat Flour, Cumin Powder, Salt, Sesame Seeds, Sunflower Oil Deep Fry, Fresh Coconut, Nolen Gur, Cardamom, Jaggery",12,30,90,120,5,Bengali Recipes,Dessert,Vegetarian
Saag Tofu Recipe (Tofu Simmered in Spiced Mustard & Spinach Leaves),"Tofu, Spinach Leaves, Mustard Greens, Ginger, Green Chilli, Homemade Tomato Puree, Garlic, Cumin Seeds, Asafoetida, Turmeric Powder, Garam Masala Powder, Salt, Makki Ka Atta, Dry Red Chilli, Sunflower Oil, Ghee, Water",17,15,45,60,4,North Indian Recipes,Lunch,High Protein Vegetarian
Vietnamese Lemongrass Shrimp Skewers Recipe,"Shrimps, Red Bell Pepper, Shallots, Garlic, Fresh Red Chilli, Fish Sauce, Soy Sauce, Rice Flour, Salt, Coriander, Lemongrass, Nutralite Garlic & Oregano Spread",12,10,30,40,4,Vietnamese,Appetizer,Non Vegeterian
Classic Indian Sliced Salad Recipe,"Cucumber, Carrots, Tomato, Onion, Lemon Juice, Salt, Black Pepper Corns",7,10,0,10,4,Indian,Side Dish,Vegetarian
Goan Kaju Curry Recipe (Spicy Goan Cashew Nut Curry),"Cashew Nuts, Tomato, Green Bell Pepper, Turmeric Powder, Sunflower Oil, Coriander, Salt, Fresh Coconut, Onion, Garlic, Coriander, Byadagi Dried Chilli, Whole Black Peppercorns, Cumin Seeds, Cloves, Tamarind",16,10,45,55,3,Goan Recipes,Lunch,Vegetarian
Summer Squash Pasta Recipe,"Salt, Black Pepper Powder, Penne Pasta, Yellow Squash, Green Peas, Butter, Lemon Juice, Parmesan Cheese, Parsley Leaves",9,10,30,40,2,Italian Recipes,Dinner,Vegetarian
Mexican Beans Salad Recipe,"Kabuli Chana, Black Eyed Beans, Rajma, Green Bell Pepper, Sweet Corn, Iceberg Lettuce, Purple Cabbage, Onion, Extra Virgin Olive Oil, Vinegar, Sugar, Salt, Garlic, Lemon Juice, Coriander, Cumin Seeds, Black Pepper Powder, Cumin Seeds, Tomato Ketchup",19,0,30,30,2,Mexican,Side Dish,Vegetarian
Chettinad Paruppu Urundai Kuzhambu (Steamed Lentil Balls Cooked in a Tangy Curry) Recipe,"Chana Dal, Arhar Dal, Onion, Dry Red Chilli, Fennel Seeds, Cumin Seeds, Asafoetida, Coriander, Curry Leaves  Finely, Salt, Fresh Coconut, White Urad Dal, Fennel Seeds, Dry Red Chilli, Onion, Garlic, Tomato, Tamarind Water, Coriander Powder, Turmeric Powder, Coriander, Mustard Seeds, Fennel Seeds, Asafoetida, Sesame, Curry Leaves, Salt",27,10,30,40,4,South Indian Recipes,Lunch,Vegetarian
Ilish Er Tel Jhol Recipe - Bengali Hilsa Fish Curry,"Hilsa Fish, Green Chilli, Turmeric Powder, Kalonji, Mustard Oil, Salt",6,5,15,20,4,Bengali Recipes,Dinner,High Protein Non Vegetarian
Spinach And Corn Pasta Salad In Jar Recipe,"Penne Pasta, Sweet Corn, Spinach, Yellow Bell Pepper, Red Bell Pepper, Blanched Tomato, Green Bell Pepper, Garlic, Dry Red Chilli, Vinegar, Extra Virgin Olive Oil, Mixed Herbs, Salt, Pumpkin Seeds, Italian Seasoning, Mozzarella Cheese, Basil Leaves, Black Olives",18,10,30,40,2,Italian Recipes,Lunch,Vegetarian
Kaacha Gola Recipe (Bengali Sweet Cottage Cheese Balls),"Chenna, Sugar, Cardamom Powder, Saffron Strands, Milk, Milk, Lemon Juice",7,10,25,35,2,Bengali Recipes,Dessert,Vegetarian
Assamese Style Walking Catfish In Curry Leaf Gravy Recipe,"Walking Catfish, Garlic, Green Chilli, Turmeric Powder, Mustard Oil Cook, Salt, Black Pepper Powder, Curry Leaves, Hot Water",9,20,20,40,2,Assamese,Side Dish,Non Vegeterian
Khumb Kakuri Potli Kebab Recipe With Sandwich Spread,"Roomali Roti, Button Mushrooms, Del Monte Sandwich Spread, Cashew Nuts, Fresh Cream, Cheese, Whole Black Peppercorns, Salt",8,20,20,40,4,North Indian Recipes,Appetizer,Vegetarian
Bajra Ka Kheech Recipe,"Bajra, Yellow Moong Dal, Water, Turmeric Powder, Salt, Cup Mixed Vegetables",6,10,15,25,2,Rajasthani,Lunch,Diabetic Friendly
Potato Latkes Recipe,"Potato, Onion, Clove Garlic, Whole Egg, Whole Black Peppercorns, Salt, Extra Virgin Olive Oil",7,10,30,40,2,Indian,Snack,Vegetarian
Chettinad Vegetable Biryani Recipe,"Cloves, Cardamom, Cinnamon Stick, Whole Black Peppercorns, Fennel Seeds, Star Anise, Stone Flower, Rice, Carrot, Green Beans, Potato, Green Peas, Pearl Onion, Tomato, Garlic, Ginger, Bay Leaf, Mint Leaves, Red Chilli Powder, Coriander Powder, Ghee, Salt, Ghee, Cashew Nuts",24,15,40,55,2,Chettinad,Lunch,Vegetarian
Asian Style Rice Noodle Salad Recipe With Vegetables Recipe,"Rice Noodles, Broccoli, Green Peas, Green Beans, Spring Onion, Thai Basil Leaves, Ginger, Garlic, Sesame, Lemon Juice, Soy Sauce, Honey, Red Chilli Sauce",13,10,25,35,4,Asian,Dinner,Vegetarian
Banarasi Chooda Matar/Chura Matar Recipe,"Poha, Milk, Fresh Cream, Green Chilli, Green Peas, Cumin Seeds, Ginger, Garam Masala Powder, Black Pepper Powder, Coriander, Lemon Juice, Ghee Clarified Butter, Salt",13,10,20,30,2,North Indian Recipes,North Indian Breakfast,Non Vegeterian
Kashmiri Saag Recipe - Kashmiri Style Spinach / Palak,"Spinach Leaves, Garlic, Black Cardamom, Kashmiri Dry Red Chilli, Fennel Powder, Cumin Seeds, Mustard Oil, Asafoetida, Salt",9,10,20,30,4,Kashmiri,Side Dish,Vegetarian
Kolhapuri Palak Egg Curry Recipe,"Whole Egg, Cumin Seeds, Bay Leaf, Cloves, Dry Red Chilli, Turmeric Powder, Garam Masala Powder, Poppy Seeds, Fresh Coconut, Tomato, Spinach, Salt, Sunflower Oil, Onion, Ginger, Garlic, Green Chilli, Badam",18,10,45,55,4,North Indian Recipes,Lunch,Eggetarian
Keema Bhindi Masala Recipe - Okra & Minced Meat Curry,"Bhindi, Salt, Mustard Oil, Chicken, Mustard Oil, Green Chilli, Onion, Ginger, Garlic, Homemade Tomato Puree, Turmeric Powder, Red Chilli Powder, Coriander Powder, Garam Masala Powder, Salt, Kasuri Methi, Coriander",17,15,30,45,4,North Indian Recipes,Dinner,High Protein Non Vegetarian
Mushroom Empanadas Recipe,"All Purpose Flour, Butter, Salt, Chilled Water, Sunflower Oil, Onion, Carrot, Button Mushrooms, Garlic, Green Bell Pepper, Parsley Leaves, Basil Leaves, Soy Sauce, White Pepper Powder, Salt, Milk",16,60,30,90,6,Fusion,Appetizer,Vegetarian
Uttarkhand Style Mixed Bhaddu Dal Recipe,"Rajma, White Urad Dal, Sunflower Oil, Ginger Garlic Paste, Cardamom, Bay Leaf, Whole Black Peppercorns, Cloves, Cinnamon Stick, Coriander, Homemade Tomato Puree, Cumin Seeds, Fresh Cream, Salt",14,315,25,340,4,North Indian Recipes,Lunch,High Protein Vegetarian
Cape Gooseberry Salad Recipe,"Cape Gooseberries, Fresh Figs, Onion, Cucumber, Iceberg Lettuce, Fresh Herbs, Extra Virgin Olive Oil, Honey, Lemon Juice, Lemon Zest, Black Pepper Powder, Salt",12,10,0,10,2,Continental,Dinner,Vegetarian
Crisp Baked Tandoori Mayo Cheddar Chicken Recipe,"Boneless Chicken, Del Monte Tandoori Mayo, Cheddar Cheese, Egg White, Green Chilli, Coriander, Extra Virgin Olive Oil, Salt, Black Pepper Powder, Corn Flakes",10,25,45,70,5,North Indian Recipes,Dinner,Non Vegeterian
Amrood Ni Kari Recipe (Parsi Style Dry Guava Curry Recipe),"Guava, Mustard Seeds, Asafoetida, Red Chilli Powder, Coriander Powder, Turmeric Powder, Jaggery, Salt, Sunflower Oil",9,15,30,45,4,Parsi Recipes,Lunch,Vegetarian
Ratalu Pakora Recipe - Purple Yam Pakora/Fritters,"Purple Yam, Gram Flour, Water, Salt, Turmeric Powder, Red Chilli Powder, Asafoetida, Baking Soda, Sunflower Oil",9,15,25,40,15,Gujarati Recipesï»¿,Snack,Vegetarian
Shahi Tindora Recipe - Tindora In Cashew Nut Gravy,"Tindora, Red Chilli Powder, Turmeric Powder, Garam Masala Powder, Fresh Cream, Kasuri Methi, Sunflower Oil, Ghee, Onion, Cashew Nuts, Tomato, Garlic, Ginger, Cardamom, Cloves, Cinnamon Stick, Green Chilli, Ajwain",18,10,45,55,4,North Indian Recipes,Lunch,Vegetarian
Cinnamon Sugar Focaccia Bread Recipe,"Lukewarm Water, Sugar, Active Dry Yeast, All Purpose Flour, Lukewarm Water, Extra Virgin Olive Oil, Sugar, All Purpose Flour, Sea Salt, Cinnamon Sugar, Raisins, Cranberries",12,30,200,230,4,Italian Recipes,Snack,Vegetarian
Spinach And Corn Au Gratin Recipe With Cheesy Dip,"Spinach Leaves, Sweet Corn, Corn Flour, Milk, Dried Oregano, Red Chilli Flakes, Del Monte Cheesy Dip, Cheddar Cheese, Salt, Extra Virgin Olive Oil",10,20,30,50,4,French,One Pot Dish,Vegetarian
Egg Rolls With Moringa Leaves Recipe-Eggs with Drumstick Leaves,"Whole Eggs, All Purpose Flour, Salt, Black Pepper Powder, Green Chilli, Cheddar Cheese, Drumstick Leaves, Butter Oil For Cooking",8,10,30,40,2,Indian,Side Dish,Eggetarian
Brown Rice Flakes Pudding / Desi Poha Kheer Recipe,"Brown Rice Flakes, Water, Milk, Condensed Milk, Cardamom Powder",5,20,40,60,4,Indian,Dessert,Vegetarian
Cardamom Macaroons Recipe,"Confectioners Sugar, Almond Meal, Egg Whites  Aged For  Days At Room Temperature, Sugar, Cardamom Powder, Food Color, Chocolate Bar, Double Cream, Butter, Vanilla Extract",10,10,60,70,4,French,Snack,Vegetarian
Chilli Cheese Mushroom Momo Recipe,"Button Mushrooms, Onion, Ginger, Green Chilli, Garlic, Black Pepper Powder, Cheese, Salt, Spring Onion, All Purpose Flour, Water Knead",11,25,25,50,4,Indo Chinese,Appetizer,Vegetarian
Goan Style Bimblanche Sasav Recipe,"Bimbla, Cup Fresh Coconut, Green Chilli, Mustard Seeds, Jaggery, Cup Water, Tablespoon Sunflower Oil, Salt",8,10,5,15,4,Goan Recipes,Side Dish,Vegetarian
Chickoo - Sapota Puree Recipe For Babies And Toddlers,Chikoo,1,5,0,5,2,Continental,Snack,Vegetarian
Chettinad Eral Thokku Recipe - Prawn Masala,"Prawns, Shallots, Tomato, Curry Leaves, Green Chilli, Ginger Garlic Paste, Red Chilli Powder, Coriander Powder, Black Pepper Powder, Turmeric Powder, Lemon Juice, Salt, Sunflower Oil, Coriander",14,10,30,40,4,Chettinad,Lunch,Non Vegeterian
Kadai Chole Recipe- Dry Chickpeas Masala with Capsicum,"Kabuli Chana, Onion, Green Bell Pepper, Garlic, Ginger, Green Chilli, Tomato, Cinnamon Stick, Cloves, Bay Leaf, Black Cardamom, Coriander Powder, Cumin Powder, Kashmiri Red Chilli Powder, Amchur, Garam Masala Powder, Ajwain, Ghee, Salt",19,15,40,55,4,North Indian Recipes,Lunch,Vegetarian
Minced Meat & Corn Stuffed Bell Peppers Recipe,"Yellow Bell Pepper, Chicken, Sweet Corn, Pickled Jalapenos, Onion, Garlic, Black Pepper Powder, Mozzarella Cheese, Coriander, Extra Virgin Olive Oil, Salt",11,10,45,55,2,Continental,Appetizer,High Protein Non Vegetarian
Greek Style Vegan Moussaka Recipe,"Brinjal, Salt, Black Pepper Powder, Dried Oregano, Kala Chana, Masoor Dal, Homemade Tomato Puree, Onion, Garlic, Cumin Powder, Cinnamon Powder, Sugar, Lemon Juice, Salt, Black Pepper Powder, Potato, Garlic, Extra Virgin Olive Oil, Salt, Black Pepper Powder",20,25,60,85,4,Greek,Main Course,Vegan
Delicious Italian Chicken Cacciatore Recipe with Mushrooms & Olives - (Poultry & Vegetable Hunter's Stew),"Chicken Breasts, Button Mushrooms, Onion, Garlic, Del Monte Black Olives, Basil Leaves, Rosemary, Extra Virgin Olive Oil, Homemade Tomato Puree, Dry White Wine, Parsley Leaves",11,10,45,55,4,Italian Recipes,Dinner,High Protein Non Vegetarian
Vegetable Manchow Soup Recipe,"Carrots, Green Beans, Cabbage, Spring Onion, Ginger, Garlic, Dark Soy Sauce, White Vinegar, Salt, Black Pepper Powder, Sesame, Corn Flour, Water, Spring Onion Greens, Rice Noodles",15,15,25,40,4,Indo Chinese,Dinner,Vegetarian
Himachali Style Pahari Aloo Palda Recipe - Potatoes In Yogurt Gravy,"Potato, Onion, Cumin Seeds, Asafoetida, Black Cardamom, Cloves, Cinnamon Stick, Turmeric Powder, Coriander Powder, Red Chilli Powder, Salt, Garam Masala Powder, Mustard Oil, Rice, Cardamom Powder, Curd",16,10,25,35,4,Himachal,Lunch,Vegetarian
Chocolate Marble Cake Recipe Using Preethi Electric Pressure Cooker,"Butter, Caster Sugar, Whole Eggs, All Purpose Flour, Cocoa Powder, Baking Powder, Milk, Vanilla Extract",8,20,20,40,6,Continental,Dessert,Eggetarian
Nungu Payasam Recipe - Ice Apple/ Tender Palm Fruit Payasam,"Palm Fruit, Condensed Milk, Milk, Whole Cashews, Badam, Cardamom Powder, Rose Petals",7,60,30,90,4,South Indian Recipes,Dessert,Vegetarian
Mangalorean Style Cheenikayi Kadubu Recipe (Pumpkin sweet idli Recipe),"Kaddu, Fresh Coconut, Broken Raw Rice, Cardamom Powder, Salt, Water, Water",7,10,45,55,4,Mangalorean,South Indian Breakfast,Diabetic Friendly
Aval Upma Recipe - South Indian Style Poha,"Poha, Sunflower Oil, Asafoetida, Mustard Seeds, Cumin Seeds, Black Urad Dal, Onion, Green Chilli, Ginger, Curry Leaves, Turmeric Powder, Salt, Lemon Juice, Roasted Peanuts, Coriander",15,15,15,30,4,South Indian Recipes,South Indian Breakfast,Vegetarian
Shahjahani Khichdi Recipe - Spiced Green Moong Dal Khichdi,"Green Moong Dal, Rice, Onion, Fresh Coconut, Salt, Cardamom, Cloves, Cinnamon Stick, Cumin Seeds, Cashew Nuts, Ghee",11,30,30,60,4,Mughlai,Lunch,High Protein Vegetarian
Aloo Bhindi Recipe Flavored With Mustard And Poppy Seeds,"Bhindi, Potato, Turmeric Powder, Red Chilli Powder, Salt, Mustard Oil, Poppy Seeds, Mustard Seeds",8,20,40,60,4,Bengali Recipes,Lunch,Vegetarian
Irani Chai Recipe,"Assam Tea Leaves, Milk, Fresh Cream, Star Anise, Cardamom, Black Cardamom, Cinnamon Stick, Cloves, Whole Black Peppercorns, Sugar, Chilled Water",11,5,15,20,4,Middle Eastern,Appetizer,Vegetarian
Drumstick Leaves Ragi Roti Recipe - Moringa Millet Flat Bread,"Ragi Flour, Whole Wheat Flour, Green Chilli, Ginger, Drumstick Leaves, Black Pepper Powder, Salt, Ghee",8,20,30,50,4,Karnataka,South Indian Breakfast,Diabetic Friendly
Hariyali Matar Recipe,"Green Peas, Paneer, Cumin Seeds, Asafoetida, Sunflower Oil, Salt, Coriander, Green Chilli, Garlic, Ginger, Lemon Juice",11,5,15,20,4,North Indian Recipes,Side Dish,High Protein Vegetarian
Rasawala Dhokla Recipe,"Gram Flour, Curd, Green Chilli, Ginger, Lemon Juice, Enos Fruit Salt, Salt, Sunflower Oil, Mustard Seeds, Cumin Seeds, Asafoetida, Green Chilli, Red Chilli Powder, Turmeric Powder, Jaggery, Tamarind Paste, Salt, Coriander, Sunflower Oil, Mustard Seeds, Cumin Seeds, Asafoetida, Green Chilli, Red Chilli Powder, Turmeric Powder, Jaggery, Tamarind Paste, Salt, Coriander",29,5,10,15,4,Gujarati Recipesï»¿,North Indian Breakfast,Vegetarian
Oats Methi Muthia Recipe-Healthy Diabetic Friendly Muthia,"Instant Oats, Jowar Flour, Gram Flour, Sooji, Curd, Methi Leaves, Green Chilli, Ginger, Turmeric Powder, Salt, Sunflower Oil, Mustard Seeds, Sesame Seeds, Asafoetida, Curry Leaves",15,15,20,35,4,Gujarati Recipesï»¿,Snack,Diabetic Friendly
Keerai Vadai Recipe Made With Figaro Pure Olive Oil,"Chana Dal, Spinach, Onion, Green Chilli, Garlic, Ginger, Cumin Seeds, Salt, Figaro Pure Olive Oil",9,140,30,170,4,South Indian Recipes,Snack,Vegetarian
Chicken Chops Recipe,"Chicken, Onion, Green Chilli, Whole Eggs, Ginger Garlic Paste, Coriander, Mint Leaves, Red Chilli Powder, Turmeric Powder, Coriander Powder, Salt, Lemon Juice, Sunflower Oil, Whole Wheat Bread Crumbs",14,10,25,35,3,Indian,Appetizer,Non Vegeterian
Caramelized Banana French Toast Recipe,"Whole Wheat Brown Bread, Butter, Whole Eggs, Milk, Vanilla Extract, Sugar, Cinnamon Powder, Salt, Butter, Sugar, Ripe Bananas, Vanilla Extract",12,10,10,20,4,French,World Breakfast,Eggetarian
Spicy Hot Chocolate Recipe - Perfect Drink For A Rainy Day or Winters,"Milk, Dark Chocolate, Cinnamon Powder, Black Pepper Powder, Cayenne Pepper, Vanilla Extract, Fresh Cherries, Slivered Almonds",8,10,10,20,4,Continental,Snack,Vegetarian
Aam Peda Recipe - Delicious Mango Peda Recipe,"Cups Mango Pulp, Cup Milk Powder, Cup Condensed Milk, Ghee, Cardamom Powder, Corn Flour, Slivered Almonds",7,10,20,30,30,Indian,Dessert,Vegetarian
Tamil Nadu Style Milagu Thattai Recipe (Peppered Dal-Rice Fritters),"Rice Flour, Urad Dal Flour, Butter, Sesame Seeds, Whole Black Peppercorns  Freshly Powdered, Curry Leaves  Pat Dried And Finely, Chana Dal, Asafoetida, Salt, Sunflower Oil",10,40,20,60,15,Tamil Nadu,Snack,Vegetarian
Vanilla Panna Cotta Recipe with Cocoa & Mint,"Fresh Cream, Milk, Caster Sugar, Vanilla Extract, Gelatin, Cocoa Powder",6,400,60,460,4,Continental,Dessert,Non Vegeterian
Doi Shorshe Chingri - Prawn Mustard Curry Recipe,"Prawns, Green Chilli, Turmeric Powder, Kashmiri Red Chilli Powder, Curd, Mustard Oil, Yellow Mustard Seeds, Poppy Seeds, Green Chilli, Water, Salt",11,15,20,35,4,Bengali Recipes,Lunch,Non Vegeterian
Paneer and Green Peas Paratha Recipe,"Green Peas, Paneer, Ginger, Green Chilli, Turmeric Powder, Red Chilli Powder, Amchur, Coriander Powder, Salt, Whole Wheat Flour, Salt, Sunflower Oil, Lukewarm Water",13,20,45,65,4,North Indian Recipes,North Indian Breakfast,High Protein Vegetarian
Mooli And Wadi Ki Sabzi Recipe,"Mooli Mullangi, Badi, Onion, Mustard Seeds, Mustard Oil, Cumin Seeds, Turmeric Powder, Red Chilli Powder, Salt, Coriander",10,15,15,30,4,Punjabi,Lunch,Vegetarian
Moong Dal Dosa Recipe,"Green Moong Dal, Rice, Salt, Water, Ghee, Ginger, Sunflower Oil, Salt",8,360,40,400,12,South Indian Recipes,South Indian Breakfast,Diabetic Friendly
Bengali Style Chicken Rezala Recipe - Chicken Korma Recipe,"Onion, Cashew Nuts, Sesame Seeds, Bay Leaf, Cloves, Cardamom, Cinnamon Stick, Dry Red Chilli, Garam Masala Powder, Black Pepper Powder, Salt, Mustard Oil, Chicken, Curd, Sugar, Saffron Strands",16,10,35,45,4,Bengali Recipes,Lunch,Non Vegeterian
Afghani Dhoog Recipe - Cucumber Mint Buttermilk/ Chaas,"Curd, Mint Leaves, Cucumber, Cumin Powder, Salt, Ice Cubes",6,10,0,10,2,Afghan,Snack,Vegetarian
Bhoplya Cha Bharit Recipe â Maharashtrian Pumpkin Sabzi,"Kaddu, Cumin Seeds, Mustard Seeds, Curry Leaves, Asafoetida, Turmeric Powder, Red Chilli Powder, Garam Masala Powder, Salt, Sunflower Oil",10,15,30,45,4,Maharashtrian Recipes,Main Course,Vegetarian
Mixed Vegetable Pulao Recipe,"Brown Rice, Ghee, Garlic, Green Chilli, Cloves, Cardamom, Cinnamon Stick, Bay Leaf, Salt, Mint Leaves, Green Beans, Cauliflower, Carrots",13,20,40,60,4,Indian,Dinner,Vegetarian
Bow Tie Pasta With Baby Spinach Recipe,"Del Monte Farfalle Pasta, Baby Spinach, Homemade Tomato Puree, Onion, Garlic, Italian Seasoning, Black Pepper Powder, Basil Leaves, Parsley Leaves, Butter, Extra Virgin Olive Oil, Chenna, Mustard Flowers",13,10,40,50,4,Italian Recipes,Lunch,Vegetarian
Bread Toast Recipe,"Whole Wheat Brown Bread, Butter",2,5,15,20,4,Continental,World Breakfast,Vegetarian
Cheesy Stuffed Schezwan Pav Recipe,"Cabbage, Green Bell Pepper, Carrot, Sweet Corn, Onion, Garlic, Green Chilli, Stalks Spring Onion, Schezwan Sauce, Veeba Sweet Chilli Sauce, Mozzarella Cheese, Butter, Pav Buns, Sunflower Oil, Salt",15,15,20,35,6,Indo Chinese,Snack,Vegetarian
Mushroom Baby Corn Kaalimirri Recipe - Pepper Cashew Gravy,"Cloves, Cinnamon Stick, Cumin Seeds, Cardamom, Whole Black Peppercorns, Whole Cashews, Poppy Seeds, Sunflower Oil, Button Mushrooms, Salt, Ghee, Onion, Ginger, Garlic, Whole Cashews, Poppy Seeds, Fresh Cream, Milk, Salt, Whole Black Pepper Corns",20,20,40,60,4,Indian,Main Course,Vegetarian
Fluffy & Crispy Cheese Herbed Biscuits Recipe,"All Purpose Flour, Corn Flour, Baking Powder, Sea Salt, Sugar, Parsley Leaves, Dried Basil Leaves, Cheddar Cheese, Mozzarella Cheese, Butter, Milk, Extra Virgin Olive Oil",12,30,30,60,4,Continental,Snack,Vegetarian
Bhopli Mirchi Chi Peeth Perun Bhaji Recipe,"Green Bell Pepper, Gram Flour, Onion, Green Chilli, Turmeric Powder, Red Chilli Powder, Salt, Amchur, Coriander Powder, Cumin Powder, Garam Masala Powder, Mustard Seeds, Cumin Seeds, Curry Leaves, Asafoetida, Dry Red Chilli, Sunflower Oil",17,10,20,30,4,Maharashtrian Recipes,Side Dish,High Protein Vegetarian
No Onion No Garlic Cabbage Kofta Curry Recipe,"Cabbage, Gram Flour, Green Chilli, Coriander, Cumin Powder, Red Chilli Powder, Garam Masala Powder, Turmeric Powder, Salt, Sunflower Oil, Tomato, Ginger, Gram Flour, Fresh Cream, Curd, Coriander Powder, Red Chilli Powder, Turmeric Powder, Cumin Powder, Garam Masala Powder, Bay Leaf, Cardamom, Salt, Sunflower Oil, Coriander",25,20,45,65,4,Indian,Dinner,Vegetarian
Karuveppilai Kuzhambu Recipe (Tangy & Spicy Curry Leaves Curry),"Curry Leaves, Methi Seeds, White Urad Dal, Coriander, Dry Red Chilli, Fresh Coconut, Tamarind Water, Pearl Onion, Turmeric Powder, Jaggery, Salt, Sesame, Curry Leaves, Mustard Seeds, White Urad Dal",15,10,40,50,4,South Indian Recipes,Lunch,Vegetarian
No Bake Marie Biscuit Energy Bites Recipe,"Marie Biscuit, Peanut Butter, Honey, Coconut Oil, Vanilla Extract, Sesame Seeds",6,90,10,100,12,Continental,Snack,Vegetarian
Goan Style Mushroom Vindaloo Recipe,"Button Mushrooms, Onion, Garlic, Ginger, Turmeric Powder, Sunflower Oil, Salt, Dry Red Chilli, Coriander, Cumin Seeds, Whole Black Peppercorns, Cardamom, Cloves",13,20,30,50,4,Goan Recipes,Dinner,Vegetarian
Eggless Coffee Caramel Cake With Walnuts Recipe,"Cups Vivatta Maida, Cup Sugar, Curd, Baking Soda, Baking Powder, Cup Sunflower Oil, Instant Coffee Powder, Caramel Sauce, Cup Walnuts",9,10,30,40,8,Continental,Snack,Vegetarian
Saunf Wale Aloo Baingan Recipe - Fennel Spiced Potato And Eggplant,"Brinjal, Potato, Onion, Cumin Seeds, Ginger Garlic Paste, Red Chilli Powder, Turmeric Powder, Sunflower Oil, Coriander, Salt, Coriander, Fennel Seeds",12,10,20,30,2,Indian,Lunch,Vegetarian
Oatmeal Cherry Cookies Recipe,"All Purpose Flour, Instant Oats, Baking Powder, Salt, Butter, Caster Sugar, Curd, Vanilla Extract, Canned Cherries",9,20,60,80,6,Continental,Snack,Vegetarian
Oatmeal Banana Mini Muffins Recipe,"All Purpose Flour, Instant Oats, Baking Powder, Baking Soda, Cinnamon Powder, Salt, Sugar, Butter, Sunflower Oil, Whole Eggs, Milk, Vanilla Extract, Ripe Bananas",13,15,15,30,24,Continental,Dessert,Eggetarian
Chocolate Lover's Cheesecake Recipe,"Bourbon Biscuits, Chocolate Wafers Bournvita Biscuits, Caster Sugar, Butter  Melted, Dark Chocolate, Heavy Whipping Cream, Dark Chocolate Chips, Fresh Cherries, Cocoa Powder, Icing Sugar",10,20,25,45,6,Continental,Dessert,Vegetarian
Batata nu Shaak Recipe - Aloo Tamatar Ki Sabzi,"Potato, Sunflower Oil, Kalonji, Ginger, Onion, Cinnamon Stick, Bay Leaf, Tomato, Turmeric Powder, Red Chilli Powder, Garam Masala Powder, Coriander Powder, Salt",13,10,10,20,4,Gujarati Recipesï»¿,Lunch,Vegetarian
Red Wine Sauce Over Baked Sol Fish Recipe,"Lb Fish Fillet, Garlic, Tablespoons Onion, Tablespoon Butter, Salt, Garlic, Black Pepper Powder, Salt, Cup Water, Cup Red Wine, Sprig Fresh Thyme Leaves, Black Pepper Powder, Tablespoons All Purpose Flour, Salt",14,20,20,40,2,Continental,Dinner,High Protein Non Vegetarian
Lemongrass Flavored Tofu Fried Rice Recipe,"Basmati Rice, Coconut Milk, Stalks Lemon Grass, Ginger, Turmeric Powder, Salt, Garlic, Ginger, Onion, Red Bell Pepper, Green Chilli, Spring Onion Greens, Soy Sauce, Green Chilli Sauce, Black Pepper Powder, Salt, Sunflower Oil",17,10,30,40,4,Asian,Lunch,Vegetarian
Bhel Puri With Raw Mango Recipe,"Puffed Rice, Onion, Tomato, Mango, Coriander, Raw Peanuts, Yellow Moong Dal, Lahsun Ki Chutney, Green Chutney, Sweet Chutney, Salt",11,15,0,15,2,North Indian Recipes,Snack,Vegetarian
Broccoli Pakora Masala Recipe - Broccoli In Spicy Yogurt Gravy,"Broccoli, Onion, Rice Flour, Gram Flour, Baking Soda, Lemon Juice, Turmeric Powder, Red Chilli Powder, Garam Masala Powder, Water, Salt, Curd, Water, Gram Flour, Mustard Seeds, Cumin Seeds, Asafoetida, Sunflower Oil, Turmeric Powder, Red Chilli Powder, Coriander Powder, Salt",22,10,20,30,4,North Indian Recipes,Lunch,Vegetarian
Long Brinjal Poriyal Masala Recipe - Green Baingan Sabzi,"Long Green Brinjal, Tomato, Coriander, Curry Leaves, Sambar Powder, Turmeric Powder, Red Chilli Powder, Salt, Sunflower Oil",9,10,20,30,4,South Indian Recipes,Lunch,Vegetarian
Menthi Vankaya Recipe - Andhra Style Fenugreek Spiced Baingan,"Small Brinjal, Tamarind Paste, Water, Salt, Sunflower Oil, White Urad Dal, Curry Leaves, Coriander, Chana Dal, White Urad Dal, Sesame Seeds, Cumin Seeds, Methi Seeds, Dry Red Chilli, Raw Peanuts",15,10,10,20,2,Andhra,Lunch,Vegetarian
Baale Dindu Kadale Palya - Banana Stem Curry With Chickpeas Recipe,"Banana Stem, Kala Chana, Fresh Coconut, Cumin Seeds, Coriander, Red Chilli Powder, Onion, Clove Garlic, Curry Leaves, Salt, Sunflower Oil, Coriander, Green Chilli, Lemon Juice",14,25,40,65,4,Coastal Karnataka,Lunch,Vegetarian
Gujarati Lasaniya Batata Recipe - Garlic Potato Curry,"Baby Potato, Garlic, Sunflower Oil, Cumin Seeds, Gram Flour, Coriander Powder, Garam Masala Powder, Red Chilli Powder, Turmeric Powder, Curd, Salt, Coriander",12,20,25,45,2,Gujarati Recipesï»¿,Side Dish,Vegetarian
Healthy Lauki Kofta Curry Recipe | Non Fried Bottle Gourd Kofta Curry | Dhoodi Kofta,"Bottle Gourd, Gram Flour, Red Chilli Powder, Coriander, Turmeric Powder, Garam Masala Powder, Salt, Sunflower Oil, Garlic, Ginger, Green Chilli, Onion, Cinnamon Stick, Bay Leaf, Brown Cardamom, Stone Flower, Tomato, Turmeric Powder, Coriander Powder, Red Chilli Powder, Garam Masala Powder, Honey, Coriander, Salt, Ghee",25,20,40,60,6,North Indian Recipes,Dinner,Vegetarian
Corn And Peas Curry Recipe,"Corn Cob, Salt, Water, Cumin Seeds, Coriander Seeds, Dry Red Chilies, Oil, Bud Garlic, Ginger, Onion, Coconut, Oil, Rye, Curry Leaves, Tomato Puree, Salt, Turmeric Powder, Garam Masala Powder, Kashmiri Red Chilli Powder, Green Peas",20,15,40,55,4,Indian,Main Course,Vegetarian
Tomato Basil Chicken Curry Recipe,"Chicken Breasts, Carrot, Onion, Garlic, Homemade Tomato Puree, Basil Leaves, Rosemary, Dried Thyme Leaves, Paprika Powder, Cumin Powder, Sugar, Salt, Extra Virgin Olive Oil",13,5,30,35,4,Continental,One Pot Dish,Non Vegeterian
Kerala Style Eggplant Curry ,"Brinjals, Mustard, Onion, Green Chilli, Turmeric Powder, Coriander Powder, Fennel Cumin, Fenugreek Seeds, Tomato, Coconut Milk, Coconut Oil, Curry Leaves, Coriander",13,15,35,50,4,Kerala Recipes,Lunch,Vegetarian
Grilled Chicken Wings Recipe,"Chicken Wings, Garlic, Sweet And Spicy Red Chilli Sauce, Homemade Tomato Puree, Red Chilli Flakes, Rosemary, Honey, Lemon Juice, Sunflower Oil, Salt",10,10,60,70,4,Continental,Appetizer,Non Vegeterian
Veechu Parotta Or Ceylon Parotta Recipe,"All Purpose Flour, Whole Wheat Flour, Curd, Salt, Sunflower Oil",5,30,25,55,4,Sri Lankan,Side Dish,Vegetarian
Mawa Gujiya With Badam and Pista Recipe,"All Purpose Flour, Sooji, Sugar, Baking Soda, Ghee, Water, Saffron Strands, Milk Soak Saffron, Khoya, Dessicated Coconut, Badam, Pistachios, Sugar, Milk Egg As A Wash For The Pastry, Badam, Sugar, Water, Saffron Strands",18,45,15,60,20,North Indian Recipes,Snack,Vegetarian
Chettinad Rasam Powder Recipe,"Dry Red Chilli, Coriander, Arhar Dal, Cumin Seeds, Whole Black Peppercorns, Methi Seeds, Sesame",7,5,30,35,100,Chettinad,South Indian Breakfast,High Protein Vegetarian
Paneer Stuffed Bhindi In Ajwain Tomato Gravy Recipe,"Bhindi, Paneer, Red Chilli Powder, Coriander Powder, Chaat Masala Powder, Salt, Onion, Ginger, Garlic, Ajwain, Green Chilli, Red Chilli Powder, Coriander Powder, Turmeric Powder, Garam Masala Powder, Homemade Tomato Puree, Kasuri Methi, Sunflower Oil, Salt",19,15,20,35,4,North Indian Recipes,Lunch,Vegetarian
Asian Style Stuffed Omelette Recipe,"Whole Eggs, Spring Onion Greens, Salt And Pepper, Ginger, Garlic, Baby Corn, Red Bell Pepper, Green Bell Peppers, Soy Sauce, Green Chilli Sauce, Chilli Vinegar",11,10,20,30,4,Asian,World Breakfast,Eggetarian
Aluchi Bhaji Recipe - Maharashtrian Style Colocasia Leaves Curry,"Colocasia Leaves, Raw Peanuts, Chana Dal, Sunflower Oil, Cumin Seeds, Mustard Seeds, Asafoetida, Dry Coconut, Amchur, Turmeric Powder, Jaggery, Green Chilli, Salt",13,10,20,30,4,Maharashtrian Recipes,Lunch,High Protein Vegetarian
Amritsari Fish Fry Recipe,"Seer Fish, Turmeric Powder, Red Chilli Powder, Amchur, Garam Masala Powder, Ajwain, Ginger Garlic Paste, Kasuri Methi, Gram Flour, Lemon Juice, Salt, Nutralite Classic Spread",12,60,15,75,2,Punjabi,Side Dish,High Protein Non Vegetarian
Chickpea Sundal Recipe,"Kala Chana, Sunflower Oil, Mustard Seeds, Green Chilli, Ginger, Asafoetida, Fresh Coconut, Coriander, Salt",9,20,20,40,5,South Indian Recipes,Snack,High Protein Vegetarian
Thai Coconut Curry Soup Recipe,"Poppy Seeds, Sesame Seeds, Cashew Nuts, Cumin Seeds, Coconut Milk, Vegetable Stock, Ginger, Garlic, Green Chilli, Onion, Stalk Lemon Grass, Kaffir Lime Leaves, Bay Leaves, Coconut Oil, Salt, Sugar, Coriander, Wheat Noodles Rice Noodles Boiled, Raisins",19,20,30,50,3,Thai,Appetizer,Vegetarian
Inji Thogayal Recipe - Spicy & Delicious Ginger Chutney,"Ginger, Green Chilli, Methi Seeds, White Urad Dal, Dry Red Chilli, Tamarind, Garlic, Jaggery, Salt, Sesame, Mustard Seeds, White Urad Dal, Asafoetida",13,5,15,20,4,South Indian Recipes,Side Dish,Vegetarian
Diwali Cornflakes Mixture Recipe - A Savory Evening Tea Snack,"Corn Flakes, Poha, Boondi, Curry Leaves, Badam, Cashew Nuts, Raisins, Raw Peanuts, Salt, Caster Sugar, Kashmiri Red Chilli Powder, Asafoetida, Sunflower Oil",13,15,30,45,4,Indian,Snack,Vegetarian
Kaju Pakoda Recipe (Cashew Nut Fritters),"Cashew Nuts, Gram Flour, Rice Flour, Red Chilli Powder, Ginger Garlic Paste, Mint Leaves, Fennel Seeds, Sunflower Oil, Salt",9,10,20,30,2,Indian,Snack,Vegetarian
South Indian Grilled Fish With Spicy Fusion Sauce Recipe,"Fish, Ginger, Curd, Red Mustard Seeds, Tamarind Paste, Dry Red Chilli, Green Chilli, Fresh Coconut, Coconut Oil Sunflower Oil, Sunflower Oil, Mustard Seeds, Chana Dal, Curry Leaves, Black Salt, Salt",15,70,30,100,2,South Indian Recipes,Dinner,High Protein Non Vegetarian
Methi Moong Dal Palak Recipe,"Yellow Moong Dal, Methi Leaves, Asafoetida, Cumin Seeds, Onion, Tomato, Coriander Powder, Turmeric Powder, Red Chilli Powder, Salt, Sunflower Oil",11,30,15,45,4,North Indian Recipes,Lunch,High Protein Vegetarian
Sindhi Style Chicken Curry Recipe Using Preethi Electric Pressure Cooker,"Chicken, Black Cardamom, Bay Leaf, Cinnamon Stick, Cardamom, Cloves, Onion, Green Chilli, Ginger, Garlic, Tomato, Curd, Turmeric Powder, Red Chilli Powder, Coriander, Garam Masala Powder, Coriander Powder, Salt, Coriander, Sunflower Oil",20,10,60,70,4,Sindhi,Dinner,Non Vegeterian
Indian Style Jeera Biscuit Recipe,"All Purpose Flour, Baking Powder, Salt, Butter, Cumin Seeds, Lukewarm Water",6,20,30,50,4,Continental,Snack,Vegetarian
Pudina Moong Dal Recipe (Mint Moong Dal),"Yellow Moong Dal, Red Chilli Powder, Turmeric Powder, Cumin Seeds, Asafoetida, Ghee, Mint Leaves, Water, Salt",9,10,25,35,2,North Indian Recipes,Lunch,High Protein Vegetarian
Shrimp Spinach Cheese Swirl Recipe,"Puff Pastry Sheet, Whole Egg, Cup Spinach, Cup Shrimps, Spring Onion, Tablespoon Cayenne Pepper, Coriander Powder, Garlic Powder, Tablespoon Tomato Ketchup, Sriracha Sauce, Tablespoon Sunflower Oil, Cup Cheddar Cheese, Salt",13,60,15,75,10,Indian,Appetizer,Non Vegeterian
Matar Poha Recipe (Flattened Rice Stir Fry with Green Peas),"Poha, Green Peas, Onion, Green Chilli, Turmeric Powder, Mustard Seeds, Cumin Seeds, Curry Leaves, Asafoetida, Salt, Coriander, Lemon Juice",12,15,10,25,4,North Indian Recipes,North Indian Breakfast,Vegetarian
Udupi Style Thondekayi And Badnekayi Sambar Recipe - Ivy Gourd & Brinjal Sambar,"Tindora, Brinjal, Carrot, Arhar Dal, Udupi Sambar Powder, Tamarind Water, Jaggery, Turmeric Powder, Salt, Mustard Seeds, White Urad Dal, Dry Red Chilli, Curry Leaves, Sunflower Oil",14,10,30,40,4,Udupi,Lunch,Vegetarian
Kumaon Style Thechwani Recipe-Mooli Aloo Sabzi,"Potato, Mooli Mullangi, Onion, Tomato, Green Chilli, Dry Red Chilli, Cumin Seeds, Methi Seeds, Cardamom, Turmeric Powder, Cumin Powder, Coriander Powder, Red Chilli Powder, Salt, Green Chilli, Garlic, Ginger",17,10,25,35,4,Uttarakhand-North Kumaon,Main Course,Vegetarian
Chicken Ranch Wraps Recipe,"Tortillas, Chicken Breasts, Dried Oregano, Onion, Red Chilli Flakes, Cherry Tomato, Cucumber, Tablespoon Black Pepper Powder, Cup Cheese, Lettuce Leaves, Ranch Sauce, Salt",12,20,20,40,4,Continental,Snack,Non Vegeterian
Arbi Ka Achaar Recipe (Instant Colocasia pickle),"Colocasia Root, Ajwain, Cumin Seeds, Methi Seeds, Kalonji, Methi Powder, Mustard Powder, Red Chilli Powder, Turmeric Powder, Asafoetida, Vinegar, Mustard Oil, Salt",13,15,20,35,4,North Indian Recipes,Side Dish,Vegetarian
Olive & Tofu In Harissa Curry Recipe,"Extra Virgin Olive Oil, Garlic, Onion, Cumin Powder, Harissa Paste, Homemade Tomato Puree, Salt, Honey, Water, Black Pepper Powder, Black Olives, Tofu",12,10,20,30,4,Continental,Main Course,High Protein Vegetarian
Chiroti Recipe - Delicious Crispy Layered Sweet Puri,"All Purpose Flour, Ghee, Water, Sugar, Water, Cardamom Powder, Ghee, Rice Flour, All Purpose Flour, Badam, Pistachios, Cashew Nuts",12,15,30,45,4,Indian,Dessert,Vegetarian
Paneer Malai Makhani Biryani Recipe,"Basmati Rice, Ghee, Ginger Garlic Paste, Onion, Biryani Masala, Lemon Juice, Salt, Paneer, Turmeric Powder, Red Chilli Powder, Homemade Tomato Puree, Hung Curd, Lemon Juice, Ginger Garlic Paste, Sunflower Oil, Salt",16,30,40,70,4,Indian,Dinner,High Protein Vegetarian
Raw Mango Carrot Cucumber Salad Recipe With Peanuts,"Mango, Carrot, Cucumber, Tomato, Roasted Peanuts, Coriander, Mint Leaves, Salt, Black Pepper Powder, Chaat Masala Powder, Cumin Powder",11,15,0,15,4,Indian,Appetizer,Vegan
Dried Cranberry & White Chocolate Chip Biscotti Recipe,"All Purpose Flour, Baking Powder, Butter, Caster Sugar, Whole Eggs, Vanilla Extract, Cranberries, White Chocolate",8,20,60,80,4,Continental,Snack,Vegetarian
Andhra Style Sorakaya Kura Recipe - Bottle Gourd And Toor Dal Recipe,"Bottle Gourd, Arhar Dal, Mustard Seeds, Curry Leaves, Asafoetida, Cumin Seeds, Tomato, Green Chilli, Black Pepper Powder, Turmeric Powder, Red Chilli Powder",11,10,25,35,4,Andhra,Lunch,Vegetarian
Delhi Style Matar Chaat Recipe - Spicy & Tangy Green Peas Chaat,"Dried Green Peas, Ginger, Red Chilli Powder, Tomato, Cumin Powder, Amchur, Turmeric Powder, Fennel Seeds, Cinnamon Stick, Bay Leaves, Salt, Lemon, Onion, Ginger, Green Chilli, Coriander, Coriander",17,500,45,545,4,North Indian Recipes,Snack,Vegetarian
Kongunadu Style Senai Kilangu Masala Recipe - Yam in Spicy Gravy,"Elephant Yam, Turmeric Powder, Mustard Seeds, Curry Leaves, Salt, Sunflower Oil, Cinnamon Stick, Garlic, Ginger, Poppy Seeds, Coconut Oil, Dry Red Chilli, Curry Leaves",13,10,30,40,4,Tamil Nadu,Side Dish,Vegetarian
No Onion No Garlic Aloo Gajar Ki Sabzi Recipe,"Potato, Carrots, Sunflower Oil, Cumin Seeds, Ginger, Green Chilli, Turmeric Powder, Red Chilli Powder, Coriander Powder, Lemon Juice, Salt Kala Namak, Coriander",12,10,30,40,4,Indian,Lunch,Vegetarian
Konkani Style Karate Batate Puddi Sagle Recipe - Bitter Gourd & Potato Curry,"Karela, Potato, Mustard Seeds, Fresh Coconut, Coriander, White Urad Dal, Dry Red Chilli, Methi Seeds, Tamarind Water, Salt",10,10,30,40,4,Konkan,Dinner,Vegetarian
Olya Kaju Chi Amti Recipe - Malvani Cashew Nut Curry,"Cashew Nuts, Arhar Dal, Masoor Dal, Salt, Turmeric Powder, Ghee, Mustard Seeds, Cumin Seeds, Asafoetida, Dry Red Chilli, Jaggery, Fresh Coconut, Cumin Seeds, Dry Red Chilli, Garlic",15,10,30,40,4,Malvani,Main Course,Vegetarian
Chettinad Mint Potato Biryani Recipe,"Basmati Rice, Onion, Tomato, Garlic, Ginger, Green Chilli, Potato, Paneer, Curd, Garam Masala Powder, Biryani Masala Powder, Coriander Powder, Red Chilli Powder, Salt, Sunflower Oil, Cinnamon Stick, Cloves, Cardamom, Bay Leaf, Onion, Mint Leaves, Fennel Seeds",22,10,25,35,4,Chettinad,Dinner,High Protein Vegetarian
Puffed Lotus Seed Pakoras Recipe - Makhana Pakora,"Phool Makhana, Gram Flour, Onion, Green Chilli, Cumin Seeds, Red Chilli Powder, Turmeric Powder, Salt, Coriander, Curry Leaves",10,10,30,40,4,Indian,Snack,Vegetarian
Thengai Paal Kurma Recipe - Mixed Vegetables In Coconut Gravy,"Potato, Green Peas, Cauliflower, Onion, Green Chilli, Cinnamon Stick, Cardamom, Cloves, Bay Leaf, Ghee, Coconut Milk, Salt",12,15,35,50,4,Chettinad,Dinner,Vegetarian
Kala Chana Pilaf Recipe,"Basmati Rice, Kala Chana, Onion, Tomato, Green Chilli, Ginger Garlic Paste, Bay Leaf, Cinnamon Stick, Black Cardamom, Cloves, Cumin Seeds, Red Chilli Powder, Garam Masala Powder, Fennel Powder, Curd, Water Leftover Water Of Cooked Chana, Ghee, Mint Leaves, Sugar, Salt",20,15,25,40,4,Pakistani,Main Course,Vegetarian
Drumstick Leaves Fried Rice Recipe,"Rice, Carrots, Green Bell Pepper, Drumstick Leaves, Green Chilli Sauce, Soy Sauce, Tomato Ketchup, Salt, Sunflower Oil",9,25,10,35,4,Indian,Lunch,Vegan
Meen Varuthathu Recipe - Kerala Style Fish Fry,"Fish Fillet, Ginger Garlic Paste, Red Chilli Powder, Turmeric Powder, Black Pepper Powder, Lemon, Salt, Coconut Oil, Curry Leaves",9,50,15,65,2,Kerala Recipes,Appetizer,Non Vegeterian
Meetha Daliya With Milk & Fruits Recipe - Broken Wheat Porridge,"Broken Wheat, Water, Milk, Fennel Seeds, Sugar Drizzle With Honey, Fresh Fruits, Mixed Nuts",7,5,10,15,4,Indian,Indian Breakfast,Vegetarian
Whole Wheat Naan Recipe,"Whole Wheat Flour, Active Dry Yeast, Lukewarm Water, Sugar, Curd, Salt",6,140,30,170,4,North Indian Recipes,Dinner,Diabetic Friendly
Amritsari Murgh Makhani Recipe- Chicken Makhani Recipe,"Red Chilli Powder, Turmeric Powder, Homemade Tomato Puree, Fresh Cream, Cashew Nuts, Coriander, Salt, Sunflower Oil, Coriander, Cumin Seeds, Cinnamon Stick, Cloves, Bay Leaf, Cardamom, Black Cardamom, Whole Black Peppercorns, Dry Ginger Powder, Nutmeg Powder, Chicken Breasts, Turmeric Powder, Curd, Lemon Juice, Onion, Green Chilli, Ginger, Garlic",26,10,45,55,4,North Indian Recipes,Dinner,Non Vegeterian
Thai Lemongrass Rice Recipe,"Jasmine Rice, Stalk Lemon Grass, Cardamom",3,10,60,70,4,Thai,Lunch,Vegetarian
Semolina Vegetable Chilla Recipe,"Sooji, Whole Wheat Flour, Water, Onion, Tomato, Curd, Carrot, Raw Papaya, Cabbage, Green Bell Pepper, Green Chilli, Coriander, Black Pepper Powder, Salt, Extra Virgin Olive Oil",15,15,30,45,2,Indian,Indian Breakfast,Vegetarian
How To Make Homemade Kashmiri Masala/ Spice Mix Recipe,"Cumin Seeds, Cardamom, Coriander, Whole Black Peppercorns, Fennel Seeds, Cinnamon Stick, Cloves, Bay Leaves, Nutmeg, Whole Turmeric, Garlic Powder, Dry Ginger Powder, Kashmiri Red Chilli Powder",13,15,30,45,2,Indian,Indian Breakfast,Vegetarian
Pumpkin Coconut Ladoo Recipe,"Kaddu, Dessicated Coconut, Cane Sugar, Nutmeg Powder, Cardamom Powder, Ghee",6,5,10,15,4,Indian,Dessert,Vegetarian
Raw Banana Tikkis Recipe,"Raw Banana, Onion, Green Chilli, Ginger, Coriander Powder, Cumin Seeds, Clove Powder, Cinnamon Powder, Cardamom Powder, Gram Flour, Amchur, Lemon Juice, Ghee, Dates, Whole Cashews, Ginger, Green Chilli",17,15,30,45,4,Indian,Snack,Vegetarian
Katachi Amti Recipe (Spicy Accompaniment To Maharashtrian Puran Poli),"Dal Stock, Water, Cloves, Whole Black Peppercorns, Mustard Seeds, Cumin Seeds, Bay Leaf, Curry Leaves, Jaggery, Tamarind Paste, Maharashtrian Goda Masala, Sunflower Oil, Coriander, Salt",14,10,15,25,4,Maharashtrian Recipes,Lunch,Vegetarian
Maharashtrian Vegetable Amboli Recipe (Savory Lentil Pancake Topped With Vegetables),"Brown Rice  Soaked In Water For  Hours, White Urad Dal, Methi Seeds, Red Poha, Sunflower Oil Ghee For Cooking, Salt, Red Bell Pepper, Del Monte Whole Corn Kernels, Coriander, Cajun Spice Mix Chutney Podi For Sprinkling On Top",10,360,20,380,6,Maharashtrian Recipes,Indian Breakfast,Vegetarian
Amrood Raita Recipe,"Guava, Curd, Salt, Rye, Urad Dal, Curry Leaves, Red Chili, Asafetida, Oil",9,15,0,15,4,Indian,Side Dish,Vegetarian
Achari Aloo ,"à¤à¤²à¥, à¤à¥à¤à¤¾ à¤à¤®à¤à¥à¤ à¤¹à¥à¤à¤, à¤à¥à¤à¤¾ à¤à¤®à¤à¥à¤ à¤à¥à¤°à¤¾, à¤¸à¥à¤à¥ à¤²à¤¾à¤² à¤®à¤¿à¤°à¥à¤, à¤¬à¥à¥ à¤à¤®à¤à¥à¤ à¤à¤à¤¾à¤°, à¤¬à¥à¥ à¤à¤®à¤à¥à¤ à¤¸à¤¿à¤°à¤à¤¾, à¤à¥à¤à¤¾ à¤à¤®à¤à¥à¤ à¤¶à¤à¥à¤à¤°, à¤¤à¥à¤²",8,15,15,30,4,North Indian Recipes,Dinner,Vegetarian
Goan Style Kulkuls Recipe (Honey glazed wheat Curls Recipe),"Whole Wheat Flour, All Purpose Flour, Sooji, Caster Sugar, Sunflower Oil, Salt, Whole Egg, Coconut Milk, Sunflower Oil",9,15,45,60,4,Goan Recipes,Snack,Eggetarian
Pumpkin Cheesecake Recipe,"Graham Cracker Crumbs, Butter, Fl Oz Britannia Cream Cheese, Whole Eggs, Vanilla Extract, Sugar, Pumpkin Puree, Butter, Vivatta Maida, Brown Sugar, Cinnamon Powder",11,60,90,150,12,Continental,Dessert,Eggetarian
Tofu Fried Rice Recipe,"Basmati Rice, Tofu, Bay Leaf, Cinnamon Powder, Onion, Spring Onion, Spring Onion Greens, Red Yellowgreen Bell Pepper, Carrot, Button Mushrooms, Garlic, Ginger Garlic Paste, Green Chilli Sauce, Soy Sauce, Sunflower Oil, Salt",16,20,60,80,3,Chinese,Lunch,Vegetarian
Stuffed Strawberries Recipe With Grated Paneer,"Strawberries, Cup Paneer, Tablespoons Condensed Milk, Saffron Strands",4,5,8,13,2,Fusion,Appetizer,Vegetarian
Mango Phirni Recipe - Mango Rice Pudding Recipe,"Mango, Milk, Rice, Sugar, Pistachios, Badam, Cardamom Powder, Saffron Strands",8,10,45,55,4,North Indian Recipes,Dessert,Vegetarian
Spicy Mushroom Veggie Burger Recipe,"Button Mushrooms, Onion, Garlic, Green Chilli, Red Chilli Flakes, Soy Sauce, Red Chilli Sauce, Sunflower Oil, Salt, Burger Buns, Onion, Tomato, Red Chilli Sauce, Iceberg Lettuce Salad Lettuce Leaves, Butter",15,20,30,50,2,Continental,Main Course,Vegetarian
Healthy Amaranth Potato Thyme Croquette Recipe,"Potato, Amaranth Seeds, Fresh Thyme Leaves, Green Chilli, Garlic, Black Pepper Powder, Butter, Sunflower Oil, Salt",9,10,40,50,4,Continental,Snack,Vegetarian
Herbed Buttered Rice Recipe With Green Peas,"Rice, Green Peas, Cumin Seeds, Butter, Garlic, Dried Oregano, Dried Thyme Leaves, Red Chilli Flakes, Salt And Pepper",9,10,25,35,4,Continental,Dinner,Vegetarian
Stuffed Kathal Recipe,"Jackfruit Raw, Mustard Oil, Onion, Tomato, Garlic, Ginger, Garam Masala Powder, Coriander, Cloves, Kashmiri Red Chilli Powder, Turmeric Powder, Curd, Salt, Onion, Fennel Seeds, Mustard Oil, Garlic Butter, Paneer, Black Pepper Powder, Salt, Mozzarella Cheese",21,15,45,60,4,Indian,Lunch,Vegetarian
Gujarati Meetha Pudla Recipe With Caramelized Bananas,"Cup Jaggery, Water, Whole Wheat Flour, Nutralite Classic Spread, Nutralite Classic Spread, Ripe Bananas, Jaggery, Cardamom Powder, Fresh Coconut, Cashew Nuts",10,10,30,40,10,Gujarati Recipesï»¿,Dessert,Vegetarian
Stuffed Idli Ke Pakode Recipe,"Gram Flour, Idli, Onion, Cumin Seeds, Green Bell Pepper, Green Peas, Carrot, Green Beans, Cabbage, Potato, Salt, Green Chilli, Black Pepper Powder, Coriander, Lemon Juice, Turmeric Powder, Sunflower Oil",17,10,65,75,5,Fusion,Snack,Vegetarian
Rajgira Puri Recipe (Navratri Fasting/Vrat Recipe),"Rajgira Flour, Potato, Black Pepper Powder, Rock Salt Salt, Sunflower Oil Fry",5,25,30,55,4,North Indian Recipes,Indian Breakfast,Vegetarian
Spiced Rajma Pulao Recipe - Spiced Kidney Bean Rice,"Basmati Rice, Rajma, Garlic, Cloves, Bay Leaf, Cinnamon Stick, Cardamom, Black Pepper Powder, Ghee, Salt",10,20,45,65,4,Indian,Dinner,Vegetarian
Kashmiri Style Apple Tamatar Sabzi Recipe - No Onion No Garlic,"Apples, Tomato, Turmeric Powder, Coriander Powder, Red Chilli Powder, Cinnamon Stick, Bay Leaf, Salt Black Salt, Coriander, Sunflower Oil",10,20,30,50,4,Kashmiri,Dinner,No Onion No Garlic (Sattvic)
Eggless Marble Cake Recipe,"All Purpose Flour, Flax Seed Powder, Baking Powder, Butter, Caster Sugar, Milk, Vanilla Extract, Cocoa Powder",8,15,30,45,5,Continental,Dessert,Eggetarian
Gulkand Kala Jamun Recipe,"Khoya, All Purpose Flour, Sooji, Cooking Soda, Sunflower Oil Deep Fry, Gulkand, Cardamom Powder, Cashew Nuts, Water, Sugar, Saffron Strands, Rose Water, Cardamom Powder, Edible Silver Foilleaf, Rose Petals",15,15,20,35,10,Rajasthani,Dessert,Vegetarian
Mutton Ghee Roast Recipe,"Mutton, Curd, Turmeric Powder, Lemon Juice, Salt, Dry Red Chilli, Cloves, Whole Black Peppercorns, Methi Seeds, Coriander, Cumin Seeds, Garlic, Tamarind Paste, Ghee, Curry Leaves, Jaggery, Salt",17,30,21,51,4,Mangalorean,Appetizer,Non Vegeterian
Karnataka Style Churumuri Recipe-Spicy Puffed Rice Recipe,"Puffed Rice, Mango, Carrot, Cucumber, Onion, Tomato, Raw Peanuts, Chivda, Coriander, Green Chilli, Garlic",11,10,15,25,4,Karnataka,Snack,Vegetarian
Eggless Whole Wheat Tutti Frutti Cake Recipe,"Whole Wheat Flour, Brown Sugar, Baking Powder, Baking Soda, Salt, Curd, Water, Sunflower Oil, Vanilla Extract, Tutti Frutti",10,15,45,60,4,Continental,Dessert,Vegetarian
Hare Chane Ka Pulav Recipe,"Ghee, Cumin Seeds, Cloves, Dry Red Chilli, Potato, Onion, Green Chilli, Rice, Hara Chana, Turmeric Powder, Red Chilli Powder, Salt, Lemon Juice, Coriander",14,30,30,60,4,North Indian Recipes,Lunch,Vegetarian
Carrot Ribbon Salad With Asian Sesame Dressing Recipe,"Carrots, Red Onion, Garlic, Ginger, Sesame, Groundnut Oil, Rice Wine Vinegar, Honey, Black Pepper Powder, Fresh Red Chilli, Fresh Orange Juice Lemon Juice, Salt, Coriander, Mint Leaves, Sesame Seeds",15,10,10,20,2,Continental,Side Dish,Vegetarian
Maharashtrian Achar Ka Masala (Pickle Mix Recipe),"Kashmiri Red Chilli Powder, Mustard Seeds, Fennel Seeds, Methi Powder, Turmeric Powder, Salt, Asafoetida, Peanut Oil",8,0,20,20,400,Maharashtrian Recipes,Side Dish,Vegetarian
Thai Style Curried Corn Fritters Recipe,"Sweet Corn, Coriander, Thai Red Curry Paste, Baking Powder, Whole Egg, Salt, Red Chilli Sauce, Sunflower Oil",8,5,25,30,4,Thai,Appetizer,Vegetarian
Strawberry Cheesecake Muffins Recipe,"Britannia Cream Cheese, All Purpose Flour, Caster Sugar, Baking Powder, Salt, Whole Egg, Milk, Butter, Strawberries, Vanilla Extract",10,15,40,55,6,Continental,Dessert,Eggetarian
Perfect Gooey Mozzarella Garlic Bread Recipe,"Pav Buns, Extra Virgin Olive Oil, Salted Butter, Garlic, Black Pepper Powder, Mozzarella Cheese, Parsley Leaves, Mixed Herbs, Coriander",9,10,10,20,4,Fusion,Appetizer,Vegetarian
Bengali Style Dhokar Dalna Recipe (Spiced Lentil Cakes in Tomato Gravy Recipe),"Chana Dal, White Urad Dal, Ginger, Green Chilli, Cumin Seeds, Salt, Sugar, Tomato, Potato, Ginger, Green Chilli, Turmeric Powder, Red Chilli Powder, Cumin Powder, Coriander Powder, Bay Leaf, Cardamom, Cinnamon Stick, Cumin Seeds, Ghee",20,180,45,225,4,Bengali Recipes,Main Course,Vegetarian
Gan Bian Dou Jiao Recipe (Dry Fried Sichuan Haricot Beans),"Green Beans, Red Chilli Sauce, Garlic, Ginger, Spring Onion Greens, Honey, Soy Sauce, Salt",8,10,15,25,4,Sichuan,Appetizer,Vegetarian
Karnataka Style Sorakkai Palya ,"Gourd, Tomato, Cumin Seeds, Turmeric Powder, Red Chilli Powder, Sambar Powder, Curry Leaves, Salt, Oil",9,10,30,40,3,Karnataka,Lunch,Vegetarian
Dahi Suran Ki Kadhi Recipe - Yam Cooked In Yogurt Curry,"Elephant Yam, Curd, Gram Flour, Mustard Seeds, Methi Seeds, Turmeric Powder, Red Chilli Powder, Coriander Powder, Whole Black Peppercorns, Cinnamon Stick, Bay Leaf, Salt, Sunflower Oil",13,15,30,45,4,North Indian Recipes,Dinner,Vegetarian
Raw Mango And Spring Onion Chutney Recipe,"Green Onion Leaves, Raw Mango, Dry Red Chilli, Cumin, Oil, Sugar, Salt",7,20,20,40,4,Indian,Side Dish,Vegetarian
Punjabi Style Egg Curry Recipe,"Oil, , Bay Leaf, Big Cardamom, Cardamom, Ginger Garlic Paste, Onion, Green Chili, Onion, Tomato, Turmeric Powder, Red Chilli Powder, Coriander Powder, Garam Masala Powder, Water, Eggs, Green Coriander",17,10,30,40,2,Punjabi,Lunch,Eggetarian
Mango Shrikhand Taco Recipe - Sweet Mango Yogurt Dip Taco,"Mango Shrikhand, Hard Taco Shells, Mango, Salt Sprinkle, Red Chilli Powder Sprinkle, Mint Leaves",6,15,0,15,4,Mexican,Dessert,Vegetarian
Black Eyed Bean Lemon Bruschetta Recipe,"Baguette, Black Eyed Beans, Extra Virgin Olive Oil, Lemon Zest, Lemon Juice, Mint Leaves, Salt And Pepper, Extra Virgin Olive Oil",8,10,20,30,6,Italian Recipes,Dinner,Vegetarian
Pav Bhaji Pizza Recipe,"Raw Banana, Tomato, Onion, Green Bell Pepper, Green Chilli, Green Peas, Red Chilli Powder, Turmeric Powder, Coriander Powder, Pav Bhaji Masala, Salt, Cumin Seeds, Sunflower Oil, Water, Lemon Juice, Onion, Mozzarella Cheese, Coriander, Pizza Base Whole Wheat Pizza, Butter",20,30,45,75,2,Fusion,Dinner,Vegetarian
Fenugreek & Egg Fried Rice Recipe (Anda Methi Chawal),"Cooked Rice, Methi Leaves, Garlic, Onion, Green Chilli, Cumin Seeds, Extra Virgin Olive Oil, Whole Eggs, Coriander",9,20,30,50,3,Indo Chinese,Lunch,Eggetarian
Cheesy Tawa Pizza Recipe With Corn And Broccoli,"Whole Wheat Flour, Salt, Cooking Soda, Water Knead, Homemade Pizza And Pasta Sauce, Del Monte Whole Corn Kernels, Del Monte Black Olives, Onion, Broccoli, Yellow Bell Pepper, Sunflower Oil, Salt, Black Pepper Powder, Mixed Herbs",14,10,30,40,4,Italian Recipes,Snack,Vegetarian
Cabbage Poricha Kootu Recipe (Red Cabbage) - South Indian Cabbage Dal,"Cabbage, Yellow Moong Dal, Turmeric Powder, Salt, Fresh Coconut, Cumin Seeds, Whole Black Pepper Corns, Mustard Seeds, White Urad Dal, Curry Leaves, Coconut Oil",11,15,20,35,4,Tamil Nadu,Lunch,Vegetarian
Pyaaz Ki Kachori Recipe,"Onion, All Purpose Flour, Whole Wheat Flour, Cumin Seeds, Kalonji, Fennel Seeds, Kasuri Methi, Asafoetida, Garam Masala Powder, Coriander Powder, Red Chilli Powder, Amchur, Ginger Garlic Paste, Whole Black Peppercorns, Baking Soda, Sunflower Oil, Sunflower Oil, Salt, Coriander",19,45,15,60,4,North Indian Recipes,Snack,Vegetarian
Mexican Cottage Cheese Chicken Enchilada Recipe,"Chicken Breasts, Tortillas, Sour Cream, Paneer, Cheddar Cheese, Tomato Basil Pasta Sauce, Salt, Black Pepper Powder, Extra Virgin Olive Oil, Onion, Pickled Jalapenos, Taco Seasoning, Green Bell Pepper",13,15,60,75,4,Mexican,Main Course,Non Vegeterian
Mango Tofu Smoothie Recipe,"Ripe Bananas, Mango, Tofu, Turmeric Powder, Fresh Orange Juice, Coconut Milk, Black Sesame Seeds, Kiwi, Basil Leaves",9,5,5,10,2,Indian,World Breakfast,High Protein Vegetarian
Carrot Soup Recipe,"Carrots, Onion, Potato, Celery, Ginger, Coriander Powder, Whole Pepper, Of Olive Oil, Lemon",9,10,15,25,2,Continental,Dinner,Vegetarian
Keerai Karamani Kuzhambu- Palak Lobia Curry Recipe,"Coriander, Dry Red Chilli, Cumin Seeds, Methi Seeds, Black Pepper Corns, Fresh Coconut, Tamarind, Black Eyed Beans, Turmeric Powder, Coconut Oil, Pearl Onion, Salt, Spinach Leaves, Coconut Oil, Mustard Seeds, Dry Red Chilli, Curry Leaves, Garlic",18,10,20,30,4,South Indian Recipes,Lunch,Diabetic Friendly
Onion Rava Bhakri Recipe (Goan Kanyachi Bhakri),"Sooji, Onion, Fresh Coconut, Jaggery, Salt, Coriander, Green Chilli, Turmeric Powder, Ghee Oilsmear While Cooking",9,15,30,45,4,Goan Recipes,Lunch,Vegetarian
Chatpatti Makai Masala Recipe,"Sweet Corn, Peanuts, Make  Tomato, Ginger, Cumin Seeds, Asafoetida, Turmeric Powder, Red Chili Powder, Garam Masala Powder, Green Chilli  Finely, Oil, Salt, Coriander",13,10,30,40,2,Indian,Lunch,Vegetarian
Bedmi Poori Recipe - Spiced Split Black Lentil Pooris,"Black Urad Dal, Whole Wheat Flour, Asafoetida, Ginger, Fennel Powder, Dry Red Chilli, Coriander, Cumin Seeds, Amchur, Green Chilli Paste, Sunflower Oil, Salt, Sunflower Oil Deep Fry, Water Knead",14,20,60,80,6,Indian,Indian Breakfast,Vegetarian
Instant Cucumber Pickle Recipe,"Cucumber, Red Chilli Powder, Asafoetida, Turmeric Powder, Methi Seeds, Sugar, Lemon",7,10,0,10,6,Indian,Appetizer,Vegetarian
Chicken BÃ¡nh MÃ¬ Recipe - Vietnamese Grilled Chicken Sandwich,"Baguette, Classic Mayonnaise, Sriracha Sauce, Coriander, Stalks Spring Onion, Extra Virgin Olive Oil, English Cucumber, Red Bell Pepper, Green Bell Pepper, Carrot, Mooli Mullangi, Pickled Jalapenos, Chilli Vinegar, Sugar, Salt And Pepper, Chicken Breasts, Soy Sauce, Red Chilli Sauce, Honey, Black Pepper Powder, Dry Ginger Powder",21,10,35,45,4,Vietnamese,Snack,Non Vegeterian
Rajasthani Khoya Matar Sabzi Recipe,"Green Peas, Tomato, Ginger, Khoya, Cumin Seeds, Cloves, Turmeric Powder, Kashmiri Red Chilli Powder, Garam Masala Powder, Ghee, Coriander, Salt",12,10,20,30,3,Rajasthani,Lunch,Vegetarian
Black Bean Noodles Recipe,"Cups Hakka Noodles, Green Beans, Onion, Red Bell Pepper, Tablespoon Black Beans Sauce, Tablespoon Tomato Ketchup, Salt, Extra Virgin Olive Oil",8,15,15,30,2,Asian,Dinner,Vegetarian
Pudina Quinoa Recipe,"Kinua, Onion, Garlic, Cinnamon, , Cardamom, Mint Leaves, Salt, Green Chili, Ghee",10,10,20,30,4,Indian,Lunch,Vegetarian
Goan Chana Ros Recipe (White Peas Curry),"Dried Green Peas, Onion, Fresh Coconut, Dry Red Chilli, Coriander, Cloves, Tamarind, Turmeric Powder, Salt",9,500,30,530,3,Goan Recipes,Lunch,Vegetarian
Palak And Peas Kachori Recipe,"Whole Wheat Flour, Sooji, Spinach Leaves, Ajwain, Sunflower Oil, Salt, Chilled Water, Green Peas, Asafoetida, Red Chilli Powder, Amchur, Fennel Seeds, Garam Masala Powder, Salt, Sunflower Oil",15,15,30,45,15,North Indian Recipes,Snack,Vegetarian
Veggie Rava Idli ,"Semolina, Yogurt, Ginger, Sweet Corn, Green Peas, Carrots, Coriander, Green Chilli, Mustard, Chana Dal, Curry Leaves, Red Chilli Flakes, Oil, Salt, Ino Fruit Salt, Water",16,15,30,45,15,South Indian Recipes,South Indian Breakfast,Vegetarian
Moong Dal Idli With Thengai Milagai Podi Recipe,"Yellow Moong Dal, Idli Rice, Methi Seeds, Salt, Dry Coconut, Chana Dal, White Urad Dal, Asafoetida, Sesame Seeds, Dry Red Chilli, Kashmiri Red Chilli Powder, Tamarind, Salt, Curry Leaves, Mustard Seeds, Black Urad Dal, Ghee",17,20,20,40,4,South Indian Recipes,South Indian Breakfast,Vegetarian
Curried Sweet Potato Mexican Fajita Recipe,"Whole Wheat Flour Tortilla, Sweet Potato, Red Bell Pepper, Red Onion, White Onion, Red Chilli Powder, Cumin Powder, Coriander Powder, Feta Cheese, Coriander, Iceberg Lettuce  Torn Into Bitesized Pieces, Extra Virgin Olive Oil, Rice Vinegar, Sour Cream Hung Yogurt",14,15,45,60,6,Mexican,Dinner,Vegetarian
Bhakarwadi Chaat Recipe - Maharashtrian Spiced Chaat,"Bhakarwdis, Curd, Onion, Carrot, Green Chutney, Sweet Chutney, Cumin Powder, Red Chilli Powder Sprinkle, Chaat Masala Powder Sprinkle, Salt, Sev Garnish",11,20,0,20,3,Fusion,Appetizer,Vegetarian
Ghoogri Recipe - Jowar Upma,"Jowar Seeds, Green Bell Pepper, Green Peas, Carrot, Onion, Cumin Seeds, Green Chilli, Garlic, Ginger, Garam Masala Powder, Lemon Juice, Sugar, Salt, Ghee Oil, Water, Coriander",16,10,90,100,4,Rajasthani,Snack,Vegetarian
Pineapple Ladoo Recipe,"Pineapple, Dessicated Coconut, Milk Powder, Caster Sugar, Ghee, Cardamom Powder, Mixed Nuts",7,15,15,30,5,Indian,Dessert,Vegetarian
Kalyana Veetu Senai Curry Recipe,"Suran, Tomato, Coconut, Curry Leaves, Rye, Red Chili Powder, Coriander Powder, Garam Masala Powder, Turmeric Powder, Salt, Asafoetida, Oil",12,30,30,60,4,Tamil Nadu,Side Dish,Vegetarian
One Pot Vangi Bhath Recipe In Hindi,"Rice, Eggplant, Salt, Oil, White Urad Dal, Chana Dal, Coriander Seeds, Cumin Seeds, Teaspoon Sesame Seeds, Fenugreek Seeds, Dry Red Chilies, Oil, Mustard, Asafoetida, Turmeric Powder, Curry Leaves",16,10,20,30,4,South Karnataka,Lunch,Vegetarian
Baked Yogurt With Honey Cinnamon Grilled Fruits Recipe,"Curd, Fresh Cream, Condensed Milk, Vanilla Extract, Pineapple, Pears, Peaches, Plum, Strawberries, Mango, Butter, Cinnamon Powder",12,30,30,60,4,Continental,Dessert,Vegetarian
High Protein Grilled Rajma Corn Sandwich Recipe,"Whole Wheat Brown Bread, Sunflower Oil, Onion, Garlic, Turmeric Powder, Red Chilli Powder, Mixed Herbs, Rajma, Sweet Corn, Cheese, Salt, Butter",12,10,30,40,4,Continental,World Breakfast,High Protein Vegetarian
Mexican Style Cemita Recipe - Sesame Sandwich Bun,"All Purpose Flour, Active Dry Yeast, Lukewarm Water, Salt, Sugar, Butter, Whole Eggs, Extra Virgin Olive Oil, Sesame Seeds",9,240,30,270,4,Mexican,Side Dish,Vegetarian
Hunan Style Sweet Sour Chicken Recipe,"Chicken Breasts, Extra Virgin Olive Oil Sesame Oil, Black Pepper Powder, Red Bell Pepper, Yellow Bell Pepper, Corn Flour, Water, Pineapple, Pineapple Juice, Salt, Brown Sugar, Vinegar, Chicken Stock, Sesame Seeds, Iceberg Lettuce",15,15,15,30,2,Hunan,Dinner,High Protein Non Vegetarian
Maharashtrian Style Dudhi Kajuchi Sonari Amti Recipe - Bottle Gourd And Cashew Nut Sabzi,"Bottle Gourd, Onion, Cinnamon Stick, Asafoetida, Turmeric Powder, Salt, Gram Flour, Coconut Milk, Coriander, Cinnamon Stick, Cloves, Coriander, Mustard Seeds, Whole Black Peppercorns, Dry Red Chilli",15,5,30,35,4,Maharashtrian Recipes,Lunch,Vegetarian
Tomato Chutney ,"Onion, Tomato, Coconut, Green Chilli, Dry Red Chilli, Chickpea Lentil, Green Coriander, Oil, Dry Kashmiri Chilli, Salt, Oil",11,20,15,35,8,South Indian Recipes,South Indian Breakfast,Vegetarian
Sabbasige Soppu Dosa Recipe (Dill Leaves Sweet Dosa),"Dill Leaves  With Stem, Dosa Rice, Poha, Methi Seeds, Jaggery, Salt, Sunflower Oil, Ghee, Water",9,180,45,225,4,Karnataka,South Indian Breakfast,Vegetarian
Fried Poha Chivda Recipe - Flatten Rice Spicy Mixture,"Poha, Roasted Peanuts, Roasted Gram Dal, Boondi, Red Chilli Powder Be Adjusted Based On OneâS Preference, Curry Leaves, Dry Coconut, Salt",8,10,20,30,3,North Indian Recipes,Snack,Vegetarian
Spiced Prune Chutney Recipe,"Prune, Onion, Tomato, Cinnamon Powder, Nutmeg Powder, Celery, Red Chilli Flax, Honey, Vinegar, Salt",10,10,20,30,4,Indian,Side Dish,Vegetarian
Chow Chow Thoran (Poriyal) Recipe,"Chayote, Fresh Coconut, Green Chilli, Curry Leaves, Cumin Seeds, Mustard Seeds, Turmeric Powder, Salt",8,10,20,30,4,Kerala Recipes,Lunch,Vegetarian
Kabuli Chana Rasam Recipe,"Tomato, Kabuli Chana, Chana Stock, Lemon Juice, Turmeric Powder, Salt, Asafoetida, Coriander, Ghee, Mustard Seeds, Clove Garlic, Curry Leaves, Curry Leaves, Whole Black Pepper Corns, Cumin Seeds, Dry Red Chilli",16,10,20,30,2,South Indian Recipes,Lunch,High Protein Vegetarian
Cheesy Chicken Tikka Recipe,"Boneless Chicken, Ginger, Garlic, Black Pepper Powder, Lemon Juice, Salt, Whole Egg, Cheese, Fresh Cream, Corn Flour, Green Chilli, Coriander, Nutmeg Powder, Mace Powder, Garam Masala Powder, Salt, Butter, Tomato, Onion",19,60,15,75,3,Indian,Appetizer,Non Vegeterian
Masoor Dal Gassi Recipe - Lentils in Tangy Coconut Curry,"Masoor Dal, Turmeric Powder, Salt, Fresh Coconut, Tamarind, Dry Red Chilli, Coriander, Mustard Seeds, Garlic",9,10,40,50,4,Mangalorean,Dinner,High Protein Vegetarian
Jowar Atta Pyaz Thepla Recipe â Sorghum Wheat Onion Thepla,"Whole Wheat Flour, Jowar Flour, Onion, Green Chilli, Coriander Powder, Garam Masala Powder, Amchur, Turmeric Powder, Salt, Sunflower Oil",10,10,25,35,4,North Indian Recipes,Side Dish,Diabetic Friendly
Vegetarian Pad Thai Recipe - Thai style Stir fried Vegetarian Rice Noodle Dish,"Tofu, Rice Noodles, Onion, Garlic, Spring Onion Greens, Bean Sprouts, Whole Eggs, Sesame, Lemon, Roasted Peanuts, Coriander, Salt And Pepper, Soy Sauce, Sugar, Red Chilli Flakes",15,20,25,45,3,Thai,Dinner,Eggetarian
Chicken Stuffed Bread Recipe,"Vivatta Maida, Sugar, Active Dry Yeast, Salt, Sunflower Oil, Milk, Lukewarm Water, Whole Egg, Chicken, Butter, All Purpose Flour, Milk, Cheese, Salt, Black Pepper Powder, Dried Oregano, Dried Oregano",17,25,40,65,8,Continental,Snack,Non Vegeterian
Sweet Potato & Spinach Hash brown Recipe,"Sweet Potato, Spinach, Onion, Fennel Powder, Salt, Dried Oregano, Dried Thyme Leaves, Red Chilli Flakes, Salt And Pepper, Sunflower Oil",10,10,30,40,4,Continental,World Breakfast,Vegetarian
Kerala Style Kanji Payar Recipe,"Red Matta Rice, Green Moong Dal, Fresh Coconut, Garlic, Cumin Seeds, Green Chilli, Turmeric Powder, Curry Leaves, Salt, Papad",10,10,45,55,2,Kerala Recipes,Lunch,Vegetarian
Green Chana Chutney ,"Green Gram, Green Chilli, Garlic, Salt, Water, Oil, Cumin Seeds, Curd",8,5,10,15,4,Rajasthani,Side Dish,Vegetarian
Pattani Kootu Recipe (Green Peas Curry),"Green Peas, Onion, Fresh Coconut, Green Chilli, Cumin Seeds, Curry Leaves, Fennel Seeds, Mustard Seeds, Salt, Sunflower Oil",10,10,25,35,4,Kerala Recipes,Side Dish,Vegetarian
Asparagus Broccoli Fettuccine Pasta With Roasted Almonds Recipe,"Fettuccine Pasta, Stalks Asparagus, Broccoli, Garlic, Extra Virgin Olive Oil, Fresh Cream, Butter, Homemade Basil Pesto, Salt And Pepper, Cheddar Cheese, Badam, Cheddar Cheese, Basil Leaves",13,10,30,40,4,Italian Recipes,Lunch,Vegetarian
Chenai Kizhangu Masiyal-South Indian Style Yam Masiyal,"Elephant Yam, Tamarind Water, Turmeric Powder, Salt, Raw Peanuts, Sesame, Mustard Seeds, White Urad Dal, Ssp Asafoetida, Curry Leaves, Green Chilli, Salt, Turmeric Powder, Red Chilli Powder",14,5,20,25,4,Tamil Nadu,Main Course,Vegetarian
Stuffed Potato Cutlet Recipe With Mint Mayo,"Potato, Del Monte Mint Mayo, Cheese, Red Chilli Powder, Dried Oregano, S Coriander, Coriander Powder, Amchur, Corn Flour, Whole Wheat Bread Crumbs, Sunflower Oil",11,5,40,45,4,Indian,Appetizer,Vegetarian
Chicken Steak Recipe With Pan Roasted Vegetables & Potato Mash,"Chicken Breasts, Garlic, Mixed Herbs, Lemon Juice, Extra Virgin Olive Oil, Tabasco Original, Red Chilli Flakes, Parsley Leaves, Honey, Salt, Carrot, Green Zucchini, Baby Corn, Green Beans, Red Bell Pepper, Extra Virgin Olive Oil, Mixed Herbs, Garlic, Parsley Leaves, Salt, Potato, Salt, Butter, Black Pepper Powder, Lemon Juice, All Purpose Flour, Water",27,30,20,50,2,Continental,Main Course,High Protein Non Vegetarian
Zucchini & Red Pepper Muffin Recipe,"Green Zucchini, Spring Onion Greens, Garlic, Dill Leaves, Red Bell Pepper, Potato, Salt, Black Pepper Powder, Parmesan Cheese, Whole Wheat Bread Crumbs, Extra Virgin Olive Oil, Baking Powder",12,15,30,45,5,Continental,Snack,Vegetarian
Arbi Cutlet Recipe (Spiced Colocasia Patties),"Colocasia Root, Onion, Green Chilli, Red Chilli Powder, Turmeric Powder, Cumin Powder, Garam Masala Powder, Sugar, Gram Flour, Coriander, Whole Wheat Bread Crumbs, Salt, Sunflower Oil",13,10,30,40,4,North Indian Recipes,Snack,Vegetarian
No Bake Lemon Bars Recipe,"Graham Cracker Crumbs, Butter, Caster Sugar, Lemon Zest, Lemon Juice, Corn Flour, Agar Agar, Water, Sugar, Fresh Cream Milk, Yellow Food Colour, Icing Sugar, Mint Leaves",13,10,40,50,2,Continental,Dessert,Vegetarian
Broccoli Stir Fry ,"Broccoli, Onion, Mustard, Cumin Seeds, Turmeric Powder, Red Chilli Powder, Curry Leaves, Salt",8,15,15,30,4,Tamil Nadu,Side Dish,Vegetarian
Pan Fried Onion Pakora Recipe - A Perfect Diwali & Evening Snack,"Gram Flour, Rice Flour, Onion, Coriander, Green Chilli, Ginger, Turmeric Powder, Red Chilli Powder, Ajwain, Asafoetida, Salt, Sunflower Oil, Chaat Masala Powder",13,10,30,40,4,Indian,Snack,Vegetarian
Oats Chivda Recipe- Oats Poha Mixture- No Onion No Garlic,"Instant Oats, Poha, Extra Virgin Olive Oil, Mustard Seeds, Cumin Seeds, Raw Peanuts, Dry Red Chilli, Green Chilli, Red Chilli Powder, Turmeric Powder, Salt, Sugar, Green Moong Sprouts, Flax Seeds",14,34,45,79,4,Indian,Snack,Vegetarian
Orange Rasam Recipe,"Tur Dal, Tomato, Orange Juice, Lemon Juice, Turmeric Powder, Salt, Coriander, Asafoetida, Orange Zest, Ghee, Rye, Whole Black Pepper, Cumin Seeds, Curry Leaves, Red Chili Powder, Arhar Dal",16,10,25,35,2,South Indian Recipes,Lunch,Vegetarian
Methi Malai Matar Recipe - Fenugreek Peas Curry With Cream,"Methi Leaves, Green Peas, Onion, Green Chilli, Cashew Nuts, Garlic, Ginger, Milk, Coriander Powder, Fresh Cream, Cardamom Powder, Sugar, Kasuri Methi, Salt, Ghee Oil, Cardamom, Cloves, Cumin Seeds, Whole Black Peppercorns, Cinnamon Stick, Mace, Black Cardamom",22,20,20,40,2,North Indian Recipes,Dinner,Vegetarian
Kashmiri Rogan Josh Recipe - Mutton in Red Curry,"Mutton, Curd, Salt, Mustard Oil, Black Cardamom, Cardamom, Cloves, Cinnamon Stick, Bay Leaf, Black Pepper Powder, Fennel Powder, Asafoetida, Kashmiri Red Chilli Powder, Ratan Jot, Fennel Seeds, Cinnamon Powder, Kashmiri Red Chilli Powder, Black Pepper Powder, Cardamom Powder",19,10,120,130,4,Kashmiri,Dinner,Non Vegeterian
Chocolate Doughnut Recipe,"Milk, Sugar, Active Dry Yeast, All Purpose Flour, Baking Powder, Butter, Salt, Water, Sunflower Oil Deep Fry And Grease, Caster Sugar, Cocoa Powder, Vanilla Extract, Milk",13,120,15,135,16,Continental,Dessert,Vegetarian
Spring Onion and Peanut Raita Recipe,"Curd, Milk, Spring Onion Greens, Roasted Peanuts, Cumin Powder, Salt",6,15,0,15,4,Indian,Side Dish,Vegetarian
Macaroni Chaat Recipe,"Macaroni Pasta, Onion, Tomato, Sweet Corn, Roasted Peanuts, Red Chilli Powder, Chaat Masala Powder, Green Chutney, Sweet Chutney, Lemon Juice, Salt, Sev, Coriander",13,20,10,30,2,Fusion,Snack,Vegetarian
Tuvar Ni Dal Recipe - Parsi Toovar Dal,"Arhar Dal, Salt, Turmeric Powder, Onion, Tomato, Ghee, Coriander, Green Chilli, Ginger, Garlic, Dry Red Chilli, Cumin Seeds, Coriander, Cinnamon Stick, Cloves, Whole Black Peppercorns, Poppy Seeds, Ghee, Cumin Seeds",19,10,20,30,4,Parsi Recipes,Main Course,High Protein Vegetarian
Vietnamese Rice Noodle Salad Recipe,"Rice Noodles, Water, Salt, Sunflower Oil, Onion, Sunflower Oil, Butter, Sugar, Salt, Tofu, Salt Sprinkle, Garlic, Ginger, Red Chilli Flakes, Vinegar, Soy Sauce, Honey, Brown Sugar, Salt, Lemon Juice, Roasted Peanuts, Coriander, Lemon Juice, Carrots, English Cucumbers, Spring Onion Greens",26,15,7,22,4,Vietnamese,Appetizer,High Protein Vegetarian
Whole Wheat Onion Stuffed Kulcha Recipe,"Whole Wheat Flour, Active Dry Yeast, Sugar, Garlic, Salt, Lukewarm Water, Onion, Coriander, , Garlic, Salt, Red Chilli Powder, Turmeric Powder",13,150,40,190,4,North Indian Recipes,Dinner,Vegetarian
Caramelized Carrots & Pumpkin Seeds Cake Recipe,"Whole Wheat Flour, Pumpkin Seeds, Baking Powder, Baking Soda, Salt, Cinnamon Powder, Sugar, Whole Eggs, Carrots, Sunflower Oil, Milk, Butter, Water, Vanilla Extract",14,30,30,60,8,Continental,Dessert,Eggetarian
Ulundhu Kali Recipe (Urad Dal Sweet),"White Urad Dal, Methi Seeds, Cardamom, Dry Ginger Powder, Palm Jaggery, Water, Salt, Gingelly Oil",8,5,20,25,5,Indian,Snack,Vegetarian
Kollu Vada Kurma Recipe (Horse Gram Fritters Spicy & Tangy Curry),"Horse Gram Dal, Onion, Green Chilli, Ginger, Curry Leaves, Fennel Seeds, Salt, Sunflower Oil, Onion, Tomato, Ginger, Garlic, Coriander Powder, Red Chilli Powder, Turmeric Powder, Cloves, Cinnamon Stick, Cardamom, Fennel Seeds, Mint Leaves, Bay Leaves, Sunflower Oil, Poppy Seeds, Fresh Coconut, Cashew Nuts",25,10,45,55,4,South Indian Recipes,Lunch,Vegetarian
Padpe Uppukari -  Harive Soppu Palya Recipe,"Spinach, Fresh Coconut, Onion, Garlic, Dry Red Chilli, Mustard Seeds, White Urad Dal, Curry Leaves, Ssp Asafoetida, Salt",10,10,20,30,4,Mangalorean,Side Dish,Vegetarian
One Pot Chickpea And Brinjal Curry Recipe,"Kabuli Chana, Brinjal, Mango, Onion, Garlic, Star Anise, Cardamom, Cinnamon Stick, Sichuan Peppercorns, Red Chilli Powder, Turmeric Powder, Black Pepper Powder, Sugar, Coconut Milk, Salt",15,5,30,35,4,Thai,Lunch,Vegetarian
Green Chilli Vegetable Recipe,"Green Chilli, Sunflower Oil, Mustard Seeds, Salt, Turmeric Powder, Red Chilli Powder, Fennel Powder, Coriander Powder, Lemon Juice, Sugar",10,10,10,20,4,Rajasthani,Lunch,Vegetarian
Frozen Strawberry Yogurt Recipe,"Strawberries, Hung Curd, Sugar",3,45,5,50,2,Continental,Dessert,Vegetarian
Masala Cheese Bread Loaf Recipe With Garam Masala & Herbs,"All Purpose Flour, Active Dry Yeast, Sugar, All Purpose Flour, Salt, Caster Sugar, Active Dry Yeast, Garam Masala Powder, Turmeric Powder, Butter, Coriander, Mint Leaves, Cheese",13,120,40,160,12,Fusion,Snack,Vegetarian
Milk Peda Recipe,"Milk Powder, Condensed Milk, Ghee, Cardamom Powder, Saffron Strands, Milk",6,30,15,45,6,Indian,Dessert,Vegetarian
Oriya Style Ambila Recipe-Sweet & Spicy Mixed Vegetable Sabzi,"Kaddu, Mooli Mullangi, Colocasia Root, Brinjal, Carrot, Bhindi, Drumstick, Tomato, Curd, Gram Flour, Turmeric Powder, Red Chilli Powder, Dry Red Chilli, Curry Leaves, Panch Phoran Masala, Tamarind Paste, Garlic, Salt, Sunflower Oil",19,20,40,60,4,Oriya Recipes,Lunch,Vegetarian
Khatti Meethi Tinda Sabzi ,"Tinda, Mustard, Cumin Seeds, Coriander Powder, Cumin Powder, Red Chilli Powder, Turmeric Powder, Asafoetida, Amchoor Powder  Add As Per Your Requirement, Jaggery, Curry Leaves, Oil, S Of Green Coriander, Peanuts, Salt",15,10,30,40,4,Indian,Lunch,Vegetarian
Coca Cola Bundt Cake Recipe,"All Purpose Flour, Caster Sugar, Coca Cola, Cocoa Powder, Instant Coffee Powder, Sunflower Oil, Buttermilk, Butter, Salt, Baking Powder, Vanilla Extract, Butter, Coca Cola, Cocoa Powder, Caster Sugar, Salt, Filter Coffee Powder, Vanilla Extract",18,20,50,70,4,Continental,Dessert,Vegetarian
Vegetarian Watermelon Jello Recipe,"Watermelon, Agar Agar, Sugar",3,15,45,60,4,Continental,Dessert,Vegetarian
Aloo Bhindi Masala Gravy Recipe,"Okra, Potato, Onion, Tomato, Garlic, Ginger, Green Chili, Curry Leaves, Coriander Powder, Cumin Powder, Turmeric Powder, Red Chilli Powder, Rye, Cumin, Water, Sugar, Salt, Asafoetida, Oil, Green Coriander, Lemon Juice",21,15,20,35,4,North Indian Recipes,Lunch,Vegetarian
Turai Baingan Ki Sabzi Recipe,"Eggplants, Trumpet, Onion, Garlic, Tomato, Jaggery, Turmeric Powder, , Dhansak Masala, Salt",10,10,45,55,4,Parsi Recipes,Lunch,Vegetarian
Homemade Hoisin Sauce Recipe,"Soy Sauce, Honey, Peanut Butter, Red Wine Vinaigrette, Sesame, Red Chilli Sauce, Black Pepper Powder, Clove Garlic, Chinese  Spice Powder",9,0,15,15,4,Chinese,Vegetarian,Vegetarian
Dry Navratan Korma Recipe,"Cauliflower, Carrots, Green Beans, Green Peas, Green Bell Pepper, Potato, Onion, Ginger, Garlic, Green Chilli, Tomato, Coriander Powder, Garam Masala Powder, Red Chilli Powder, Salt, Sunflower Oil, Bay Leaves, Cinnamon Stick, Cardamom, Ajwain, Paneer, Fresh Cream, Cashew Nuts, Pineapple  Bitesize Chunks, Anardana Powder, Raisins, Cashew Nuts, Coriander, Coriander",29,20,20,40,4,North Indian Recipes,Lunch,Vegetarian
Apple Onion Chutney ,"Apples, Onion, Ginger, Dates, All Spice Powder, Jaggery, Cup Red Wine Vinaigrette, Salt   Oil Butter, Thyme Leaves",9,10,25,35,6,Indian,Side Dish,Vegetarian
Ragi Masala Twisters Recipe-Healthy Snack,"Whole Wheat Flour, Ragi Flour, Coriander, Curd, Ginger, Garlic, Green Chilli, Sugar, Sunflower Oil Butter, Cumin Seeds, Turmeric Powder, Salt",12,37,30,67,4,South Indian Recipes,Snack,Vegetarian
Ellu Sadam ,"Rice  Cooked, Salt, Oil, Sesame, Coconut, Dry Red Chilli, White Urad Dal, Rye, Cashew Nuts, Curry Leaves, Asafoetida",11,20,30,50,4,South Indian Recipes,Lunch,Vegetarian
Berry Focaccia with Mascarpone Cheese Recipe(Italian bread topped with mixed berries and served with Sweetened Mascarpone Cheese),"Whole Wheat Flour, All Purpose Flour, Active Dry Yeast, Extra Virgin Olive Oil, Salt, Honey, Sage, Water, Mixed Berries, Granulated Sugar, Extra Virgin Olive Oil, Mascarpone Cheese, Honey, Orange Zest",14,15,150,165,4,Italian Recipes,Side Dish,Vegetarian
Eggless Fresh Cherry Cake Recipe,"Vivatta Maida, Caster Sugar, Milk, Butter, Baking Powder, Baking Soda, Salt, Vanilla Extract, Fresh Cherries, Flax Seed Powder",10,10,40,50,4,Continental,Dessert,Vegetarian
Green Moong Dal Sabzi ,"Green Moong Dal Green Moong, Cumin Seeds, Curry Leaves  Finely, Ginger, Green Chilli, Turmeric Powder, Lemon Juice, Coriander, Oil, Salt",10,15,45,60,4,Gujarati Recipesï»¿,Side Dish,High Protein Vegetarian
Gutti Vankaya Recipe,"Brinjals, Tamarind Paste, Onion, , Peanuts, Sesame Seeds, Spoon Coconut, , Cumin Seeds, Cardamom, Garlic, Chickpea Lentils, Oil, Bay Leaves, Cumin Seeds, Curry Leaves",16,15,40,55,4,Andhra,Lunch,Vegetarian
Methi Turai Ki Sabzi ,"Of Trumpet, Fenugreek, Onion, Cumin Seeds, Dry Red Chilli, Garlic, Green Chilli, Coriander Powder, Turmeric Powder, Lemon Juice, Garam Masala Powder, Oil",12,10,20,30,4,Indian,Dinner,Vegetarian
Apple Danish Pastry Recipe,"Puff Pastry Sheet, Apple, Cinnamon Powder, Caster Sugar, Butter, Sugar, Milk, Whole Egg",8,20,20,40,2,Continental,Dessert,Eggetarian
Ajwain Puri Recipe - Puri Flavoured With Carom Seeds,"Whole Wheat Flour, Ajwain, Turmeric Powder, Salt, Sunflower Oil",5,25,30,55,4,Indian,Indian Breakfast,Vegetarian
Paneer Chilli Dosa Recipe - Spicy Cottage Cheese Dosa,"Idli Dosa Batter, Paneer, Green Bell Pepper, Spring Onion Greens, Onion, Tomato, Cabbage, Tomato Ketchup, Sweet And Spicy Red Chilli Sauce, Soy Sauce, Sunflower Oil Butter A Few Drops For Cooking Dosa",11,10,25,35,2,Fusion,Indian Breakfast,High Protein Vegetarian
Kashmiri Anardan Chetin Recipe (Pomegranate Seeds Chutney),"Anardana Powder, Onion, Coriander, Mint Leaves, Green Chilli, Cumin Seeds, Chaat Masala Powder, Salt, Sugar, Lemon Juice, Water",11,20,10,30,4,Kashmiri,Side Dish,Vegetarian
Karnataka Style Sabbasige Rasam Recipe - Dill leave & Toor Dal Rasam,"Arhar Dal, Dill Leaves, Fresh Coconut, Poppy Seeds, Onion, Tomato, Cinnamon Stick, Coriander, Sambar Powder, Mustard Seeds, Curry Leaves, Jaggery, Sunflower Oil, Salt",14,10,30,40,4,Karnataka,Lunch,Vegetarian
Mexican Style Capirotada Recipe-Bread Pudding Recipe,"Whole Wheat Brown Bread, Cashew Nuts, Raisins, Jaggery, Cinnamon Powder, Ripe Bananas, Fresh Cream",7,10,30,40,4,Mexican,Dessert,Vegetarian
Sweet Corn & Avarakkai Sundal Recipe,"Sweet Corn, Avarekalu  Lilva Beans, Fresh Coconut, Cumin Powder, Mustard Seeds, Asafoetida, Green Chilli, Dry Red Chilli, Curry Leaves, Salt, Sunflower Oil",11,15,10,25,4,Tamil Nadu,Appetizer,Vegetarian
Pepper Cauliflower ,"Gobi, Onion, Garlic, Black Pepper Powder, Cumin Powder, Red Chili Powder, Coriander Leaves, Salt, Mustard, Curry Leaves, Black Urad Dal, Red Chili, Oil",13,10,20,30,4,Indian,Dinner,Vegetarian
Fresh Apple Bundt Cake Recipe,"Cups All Purpose Flour, Baking Soda, Salt, Cinnamon Powder, Sugar, Cup Sunflower Oil, Whole Eggs, Vanilla Extract, Apple",9,20,30,50,4,Continental,Dessert,Eggetarian
Vagharela Chawal Recipe - Parsi Style Brown Rice,"Rice  Washed, Onion, Cardamom, Cloves, Cinnamon Stick, Salt, Ghee",7,5,20,25,4,Parsi Recipes,Main Course,Vegetarian
French Madeleine Recipe,"Whole Eggs, Sugar, All Purpose Flour, Baking Powder, Lemon Zest, Vanilla Extract, Butter, Icing Sugar, Chocolate Ganache",9,30,50,80,8,French,Snack,Eggetarian
Traditional Maharashtrian Bhakarwadi Recipe,"All Purpose Flour, Gram Flour, Turmeric Powder, Red Chilli Powder, Baking Soda, Asafoetida, Salt, Dessicated Coconut, Sugar, Turmeric Powder, Coriander Powder, Red Chilli Powder, Amchur, Fennel Seeds, Cumin Powder, Sesame Seeds, Garam Masala Powder, Poppy Seeds, Salt, Sunflower Oil  For Deepfrying, Tamarind Paste Tomato Ketchup",21,20,20,40,4,Maharashtrian Recipes,Snack,Vegetarian
Ribbon Pakoda Recipe - South Indian Tea Time Snack,"Gram Flour, Rice Flour, Urad Dal Flour, Asafoetida, Turmeric Powder, Cumin Powder, Red Chilli Powder, Butter, Water, Salt, Sunflower Oil",11,20,40,60,6,Indian,Snack,Vegetarian
Chocolate Kaju Katli Recipe - Chocolate Kaju Barfi,"Cashew Nuts, Sugar, Water, Milk Chocolate Dark Chocolate",4,10,40,50,10,Indian,Dessert,Vegetarian
Indo-Chinese Paneer Manchurian Recipe,"Paneer, All Purpose Flour, Corn Flour, Ginger, Garlic, Soy Sauce, Water, Salt, Black Pepper Powder, Sunflower Oil, Spring Onion, Garlic, Ginger, Green Chilli, Soy Sauce, Sriracha Sauce, Rice Vinegar, Homemade Tomato Puree, Corn Flour",19,10,30,40,4,Indo Chinese,Appetizer,Vegetarian
Grilled Cheese Sandwich Recipe With Paneer & Potato,"Whole Wheat Brown Bread, Potato, Paneer, Green Chilli, Onion, Salt, Butter",7,5,30,35,4,Continental,Snack,Vegetarian
Bendekayi Koddel/Bolu Huli Recipe - Mangalorean Style Bhindi Sambar Recipe,"Bhindi, Arhar Dal, Turmeric Powder, Green Chilli, Tamarind, Jaggery, Rasam Powder, Salt, Coconut Oil, Mustard Seeds, Cumin Seeds, Asafoetida, Curry Leaves",13,15,15,30,4,Mangalorean,Side Dish,Vegetarian
Homemade Lemon Sevai Recipe - Lemon Idiyappam Recipe,"Idli Rice, Lemon Juice, Turmeric Powder, Mustard Seeds, White Urad Dal, Roasted Peanuts, Green Chilli, Curry Leaves, Ginger, Sesame",10,120,40,160,2,South Indian Recipes,South Indian Breakfast,Vegetarian
Mavinakayi Chutney Recipe - South Canara Raw Mango Chutney,"Mango, Dry Red Chilli, Mustard Seeds, Methi Seeds, Cumin Seeds, Asafoetida, Coconut Oil, Salt",8,5,10,15,2,Karnataka,Side Dish,Vegetarian
Atta Biscuit Recipe (Whole Wheat Flour Cookies Spiced with Cardamom),"Whole Wheat Flour, Wheat Bran, Caster Sugar, Cardamom, Butter, Salt, Milk, Cashew Nuts",8,20,40,60,4,Indian,Snack,Vegetarian
Chilli Chicken Cheese Quesadilla Recipe,"Tortillas, Mozzarella Cheese, Butter, Chicken Breasts, Green Bell Pepper, Spring Onion, Garlic, Ginger, Green Chilli, Corn Flour, Soy Sauce, Tomato Ketchup, Sweet And Spicy Red Chilli Sauce, Sunflower Oil, Salt",15,20,20,40,4,Mexican,Appetizer,Non Vegeterian
Mocha Swiss Roll Recipe (Cream Roll),"Cup All Purpose Flour, Cup Sugar, Tablespoon Hot Water, Vanilla Extract, Whole Eggs, Butter, Cup Heavy Whipping Cream, Tablespoons Caster Sugar, Tablespoons Instant Coffee Powder",9,780,15,795,10,Continental,Dessert,Eggetarian
Aamras Recipe,"Mango, Into  à¤¨à¤¿à¤à¤² Water, Sugar",3,10,5,15,4,North Indian Recipes,Side Dish,Vegan
Basundi / Rabri Recipe,"Milk, Sugar, Cardamom Powder, Saffron Strands, Badam",5,10,45,55,4,Gujarati Recipesï»¿,Dessert,Vegetarian
Oriya Style Moong Dalma ,"Green Moong Dal, Carrots, Green Beans, Cabbage, Green Peas, Coconut, Ginger, Turmeric Powder, Dry Red Chilli, Bay Leaf, Cumin Seeds, Ghee, Salt, Water, Cumin Seeds, Mustard Seeds, Fennel Seeds, Kalonji Seeds, Fenugreek Seeds, Fenugreek Seeds",20,20,40,60,4,Oriya Recipes,Lunch,Vegetarian
Kala Chana Masala Curry Recipe,"Kala Chana, Sunflower Oil, Bay Leaf, Cumin Seeds, Mustard Seeds, Asafoetida, Green Chilli, Tomato, Whole Wheat Flour, Salt, Water, Red Chilli Powder, Turmeric Powder, Coriander Powder, Lemon Juice, Coriander",16,10,30,40,4,Rajasthani,Lunch,High Protein Vegetarian
Chicken Dum Biryani Recipe,"Chicken, Basmati Rice, Onion, Tomato, Green Chilli, Ginger, Garlic, Red Chilli Powder, Coriander Powder, Garam Masala Powder, Coriander, Mint Leaves, Sunflower Oil, Ghee, Salt, Hung Curd, Red Chilli Powder, Turmeric Powder, Salt",19,30,120,150,4,North Indian Recipes,One Pot Dish,High Protein Non Vegetarian
Mughlai Style Chicken Haleem Recipe,"Boneless Chicken, Chana Dal, Rice, Broken Wheat, Bay Leaf, Onion, Ginger Garlic Paste, Green Chilli, Red Chilli Powder, Salt, Mint Leaves, Coriander, Sunflower Oil, Ghee, Cumin Seeds, Ajwain, Whole Black Peppercorns, Cinnamon Stick, Cardamom, Black Cardamom",20,15,35,50,4,Mughlai,Main Course,High Protein Non Vegetarian
Kerala Style Pazham Pori Recipe (Banana Fry),"Raw Banana, Rice Flour, All Purpose Flour, Milk, Fresh Coconut, Salt",6,10,30,40,4,South Indian Recipes,Appetizer,Vegetarian
Chicken Yakisoba Recipe - Japanese Noodles,"Chicken Breasts, Salt, Corn Flour, Black Pepper Powder, Sunflower Oil, Yakisoba Noodles, Sunflower Oil, Onion, Carrot, Cabbage, Spring Onion Greens, Button Mushrooms, Soy Sauce, Red Wine Vinaigrette, Brown Sugar, Worcestershire Sauce, Green Chilli",17,15,30,45,4,Japanese,Main Course,Non Vegeterian
No Bake Nutella Cheesecake Recipe,"Oreo Biscuits, Tablespoon Butter, Nutella Spread, Britannia Cream Cheese, Nutella Spread, Caster Sugar, Vanilla Extract, Heavy Whipping Cream, Cocoa Powder, Gelatin, Oreo Biscuits, Fresh Cherries",12,35,420,455,6,Continental,Dessert,Vegetarian
Mutton Do Pyaza Recipe,"Mutton, Onion, Tablespoon Ginger Garlic Paste, Turmeric Powder, Cup Curd, Tablespoon Red Chilli Powder, Cumin Powder, Coriander Powder, Tablespoon Garam Masala Powder, Green Chilli, Tablespoons Extra Virgin Olive Oil, Coriander, Salt, Lemon Juice, Tablespoon Extra Virgin Olive Oil, Onion, Dry Red Chilli",17,10,75,85,4,North Indian Recipes,Dinner,Non Vegeterian
Tamil Nadu Style Broccoli Poriyal Recipe - Broccoli Stir Fry Recipe,"Broccoli, Onion, Mustard Seeds, Cumin Seeds, Turmeric Powder, Red Chilli Powder, Curry Leaves, Salt, Sunflower Oil",9,15,15,30,4,Tamil Nadu,Side Dish,Vegetarian
Kashmiri Style Modur Pulao Recipe - Kashmiri Sweet Pulao,"Basmati Rice, Sugar, Ghee, Bay Leaves, Cloves, Cinnamon Stick, Cardamom, Whole Black Peppercorns, Saffron Strands, Dates, Badam, Cashew Nuts, Raisins, Salt, Water",15,15,35,50,2,Kashmiri,Lunch,Vegetarian
Thotakura Majjiga Pulusu Recipe - Amaranth Leaves in Buttermilk Stew,"Green Amaranth Leaves, Onion, Turmeric Powder, Curd, Salt, Sunflower Oil, Fresh Coconut, Green Chilli, Coriander, Mustard Seeds, Methi Seeds, Cumin Seeds, Asafoetida, Curry Leaves, Dry Red Chilli, Sunflower Oil",16,10,25,35,4,Andhra,Lunch,Vegetarian
Nandan Kozhi Recipe  - Kerala Style Chicken Curry,"Chicken, Onion, Tomato, Ginger, Garlic, Red Chilli Powder, Turmeric Powder, Chicken Masala, Fresh Coconut, Cloves, Cinnamon Stick, Curry Leaves, Coconut Oil",13,10,40,50,4,Kerala Recipes,Dinner,High Protein Non Vegetarian
Tomato Basil Chicken Curry Recipe,"Chicken Breast, Carrots, Onion, Garlic, Tomato Puree, Basil, Rosemary, Thyme Leaves, Paprika Powder, Cumin Powder, Sugar, Salt, Olive Oil",13,5,30,35,4,Continental,One Pot Dish,Non Vegeterian
Penne With Roasted Eggplant And Mint Pesto Recipe,"Mint Leaves, Basil Leaves, Pine Nuts, Parmesan Cheese, Extra Virgin Olive Oil, Salt And Pepper, Extra Virgin Olive Oil, Brinjal, Penne Pasta, Mint Pesto, Salt",11,15,15,30,4,Italian Recipes,Dinner,Vegetarian
Mango Panna Cotta With Fruit Cream Recipe,"Mango Pulp, Double Cream, Milk, Agar Agar, Sugar, Heavy Whipping Cream, Mixed Fruits",7,20,120,140,4,Italian Recipes,Dessert,Vegetarian
Kerala Chicken Curry Recipe,"Chicken, Curd, Turmeric Powder, Sunflower Oil, Mustard Seeds, Curry Leaves, Onion, Ginger, Garlic, Salt, Instant Oats, Whole Black Peppercorns, Coriander, Cinnamon Stick, Fennel Seeds, Dry Red Chilli",16,10,60,70,4,Kerala Recipes,Lunch,Non Vegeterian
Baba Ganoush Recipe (Roasted Eggplant Middle Eastern Dip),"Brinjal, Garlic, Lemon Juice, Tahini, Parsley Leaves, Salt And Pepper, Extra Virgin Olive Oil, Red Chilli Powder, Pita Chips",9,10,30,40,4,Mediterranean,Side Dish,Vegetarian
Karnataka Style Jackfruit Moong Dal Payasa Recipe,"Jackfruit Ripe, Yellow Moong Dal, Jaggery, Rice, Fresh Coconut, Cardamom Powder, Ghee, Mixed Dry Fruits, Badam",9,5,10,15,4,Coastal Karnataka,Dessert,Vegetarian
Matar Butter Masala Recipe,"Green Peas, Tomato, Ginger, Garlic, Green Chilli, Cashew Nuts, Coriander Powder, Kashmiri Red Chilli Powder, Kasuri Methi, Bay Leaves, Butter, Sugar, Salt",13,5,20,25,4,North Indian Recipes,Lunch,Vegetarian
Spicy Mullangi Thogayal Recipe (Radish Chutney),"Mooli Mullangi, Black Urad Dal, Fresh Coconut, Tamarind, Turmeric Powder, Asafoetida, Salt, Sesame, Black Urad Dal, Mustard Seeds, Curry Leaves",11,20,34,54,4,South Indian Recipes,Side Dish,Diabetic Friendly
Mavinakayi Chitranna Recipe - Spiced Raw Mango Tempered Rice,"Cooked Rice, Mango, Black Urad Dal, Chana Dal, Mustard Seeds, Green Chilli, Curry Leaves, Turmeric Powder, Ssp Asafoetida, Salt, Coriander, Gingelly Oil",12,15,30,45,4,South Indian Recipes,Lunch,Gluten Free
Punjabi Methi Kadhi Recipe,"Curd, Flour, Turmeric Powder, Coriander Powder, Red Chilli Powder, Salt, Fenugreek, Onion, Cumin, Rye, Dry Red Chilli, , ",13,10,30,40,3,North Indian Recipes,Lunch,Vegetarian
Pav Bhaji Flavored Pasta Recipe-Fusion Fusilli Pasta,"Pasta  Fusilli, Carrot, Onion, Red Yellow And Green Bell Peppers, Tomato, Potato, Cauliflower, Green Peas, Chaat Masala Powder, Butter, Pav Bhaji Masala, Red Chilli Powder, Turmeric Powder, Lemon Juice, Red Chilli Sauce, Salt, Cheese, Coriander",18,15,20,35,3,Fusion,Main Course,Vegetarian
Flourless Chocolate Rum Cake Recipe,"Dark Chocolate, Butter, Caster Sugar, Whole Eggs, Vanilla Extract, Cocoa Powder, Dark Rum",7,20,30,50,4,Continental,Dessert,Vegetarian
Ragi Choco Coffee Mug Cake Recipe,"Coffee Decoction, Milk, Ragi Flour, Whole Wheat Flour, Cocoa Powder, Ghee, Palm Sugar, Salt, Baking Soda, Baking Powder, Apple Cider Vinegar, Chocolate Chips",12,5,6,11,4,Continental,Dessert,Vegetarian
Mix Vegetable Risotto Recipe,"Arborio Rice, Onion, Mixed Vegetables, Garlic, Extra Virgin Olive Oil, Whole Black Peppercorns, Vegetable Stock, Butter, Ricotta Cheese, Fresh Herbs, Parmesan Cheese",11,10,25,35,2,Italian Recipes,Dinner,Vegetarian
Badam And Besan Ladoo Recipe,"Gram Flour, Sooji, Badam, Sugar, Ghee, Cardamom, Raisins, Dried Rose Petals",8,10,60,70,2,North Indian Recipes,Dessert,Vegetarian
Apple Jalebi Recipe,"Apples, All Purpose Flour, Sunflower Oil Deep Fry, Cardamom, Curd, Pistachios Garnish, Canned Cherries Garnsh, All Purpose Flour, Cinnamon Powder, Sugar, Water, Saffron Strands, Rose Water",13,10,30,40,3,Indian,Dessert,Vegetarian
Jaisalmer Kala Chana Kadhi Recipe - Rajasthani Chickpea Curry,"Kala Chana, Curd, Gram Flour, Turmeric Powder, Coriander Powder, Red Chilli Powder, Garam Masala Powder, Salt, Cumin Seeds, Green Chilli, Ghee",11,20,35,55,4,Rajasthani,Lunch,High Protein Vegetarian
Boiled Peanut Raita Recipe,"Curd, Water, Salt, Black Pepper Powder, Cumin Powder, Raw Peanuts, Mint Leaves, Coriander",8,10,0,10,4,Indian,Side Dish,Vegetarian
Dal Shorba Recipe - Indian Style Lentil Soup,"Yellow Moong Dal, Onion, Garlic, Dry Ginger Powder, Turmeric Powder, Red Chilli Powder, Black Pepper Powder, Cumin Seeds, Coconut Oil, Salt, Water, Lemon Juice, Coriander",13,10,15,25,4,North Indian Recipes,Appetizer,Vegetarian
Sabudana Khatti Meethi Namkeen Recipe,"Sabudana, Raw Peanuts, Cashew Nuts, Raisins, Curry Leaves, Sunflower Oil Fry, Rock Salt, Sugar, Whole Black Peppercorns",9,10,20,30,2,Indian,Snack,Vegetarian
Chettinad Kozhi Rasam Recipe - Chettinad Chicken Rasam,"Chicken, Shallots, Tomato, Red Chilli Powder, Turmeric Powder, Salt, Whole Black Peppercorns, Cumin Seeds, Fennel Seeds, Coriander Powder, Dry Red Chilli, Shallots, Garlic",13,10,20,30,4,Chettinad,Lunch,High Protein Non Vegetarian
Bengali Doi Maach Recipe (Fish In Yogurt Curry),"Rohu Fish, Onion, Garlic, Ginger, Cinnamon Stick, Cardamom, Cloves, Cumin Seeds, Kashmiri Red Chilli Powder, Turmeric Powder, Raisins, Curd, Sugar, Mustard Oil, Green Chilli, Salt",16,10,30,40,4,Bengali Recipes,Lunch,Non Vegeterian
How to Make Homemade Flat Noodles With Egg Recipe,"All Purpose Flour, Wheat Berries Whole Wheat, Whole Egg, Milk, Butter, Salt",6,25,15,40,4,Chinese,Main Course,Eggetarian
Veg Shawarma Recipe,"Kabuli Chana, Instant Oats, All Purpose Flour, Garlic, Parsley Leaves, Cumin Powder, Salt, Black Pepper Powder, Sunflower Oil, Whole Wheat Flour, Active Dry Yeast, Milk, Sugar, Salt, Cucumber, Carrot, Tomato, Chilli Vinegar, Salt, Sugar, Homemade Hummus, Tzatziki, Onion",23,30,45,75,4,Middle Eastern,Main Course,Vegetarian
Parsi Style Chaas Payelo Sakarkand Recipe,"Sweet Potato, Salt, Red Chilli Powder, Cumin Powder, Sunflower Oil, Coriander",6,10,15,25,4,Parsi Recipes,Side Dish,Vegetarian
Quick & Easy Apple Cake Recipe,"Rice Flour All Purpose Flour, Cinnamon Powder, Baking Powder, Caster Sugar, Whole Eggs, Sunflower Oil, Fresh Cream, Buttermilk, Vanilla Extract, Rum Brandy, Apples",11,20,60,80,6,Continental,Dessert,Vegetarian
Kumbalakai Majjige Huli Recipe- Ash Gourd Buttermilk Curry,"Vellai Poosanikai, Chana Dal, Fresh Coconut, Green Chilli, Ginger, Salt, Curd, Coconut Oil, Mustard Seeds, Cumin Seeds, Asafoetida, Curry Leaves, Curry Leaves",13,25,40,65,4,Coastal Karnataka,Side Dish,Vegetarian
Curried Carrot Celery Soup Recipe,"Carrot, Stalks Celery, Onion, Garlic, Cumin Seeds, Bay Leaf, Cinnamon Stick, Cloves, Black Pepper Corns, Garam Masala Powder, Salt, Extra Virgin Olive Oil, Coriander, Sunflower Seeds",14,10,20,30,4,Continental,Dinner,Vegetarian
Date Obattu Recipe (Date Puran Poli),"Dates, Badam, Cardamom, Dessicated Coconut  Grated, Jaggery, Sooji, All Purpose Flour, Salt, Sunflower Oil, Ghee",10,0,90,90,4,Indian,Dessert,Vegetarian
Baked Vegetable Seekh Kebab Recipe,"Green Beans, Carrot, Cabbage, Green Peas, Potato, Sunflower Oil, Cumin Seeds, Ginger  Finely, Green Chilli, Turmeric Powder, Gram Flour, Cashew Nuts, Whole Wheat Bread Crumbs, Salt, Whole Black Peppercorns, Cardamom, Lemon Wedges, Onion",18,20,30,50,5,Indian,Appetizer,Vegetarian
Kiwi Sondesh Recipe,"Milk, Kiwi, Caster Sugar, Lemon Juice, Cardamom Powder, Mixed Nuts",6,30,30,60,4,Bengali Recipes,Dessert,Vegetarian
Eggless Cinnamon Flavoured Apple & Plum Cake Recipe,"All Purpose Flour, Baking Powder, Baking Soda, Salt, Caster Sugar, Butter, Cinnamon Powder, Milk, Lemon Zest, Vanilla Extract, Hung Curd, Plum, Apple",13,20,40,60,6,Continental,Dessert,Vegetarian
Twin In One Bread Loaf Recipe,"Active Dry Yeast, Lukewarm Water, Sugar, Salt, Butter, Vivatta Maida, Active Dry Yeast, Lukewarm Water, Sugar, Salt, Butter, Whole Wheat Flour",12,20,45,65,8,Continental,Snack,Vegetarian
Anhui Style 5 spice Corn Croquettes Recipe,"Tofu, Sweet Corn, Spring Onion Greens, Green Chilli Sauce, Ginger, Cloves, Chinese  Spice Powder, Corn Flour, Salt, Whole Wheat Bread Crumbs, Sunflower Oil Pan Fry The Croquettes",11,5,20,25,4,Chinese,Appetizer,Vegetarian
Sweet Potato Gnocchi Recipe With Garlic And Herb Butter,"Sweet Potato, Potato, Whole Eggs, Whole Wheat Flour, Salt, Butter, Sage  Finely, Nutmeg, Salt And Pepper, Salted Butter, Garlic, Brown Sugar, Cinnamon Powder, Dried Oregano, Chives  Finely, Salt, Lemon Juice",17,15,40,55,4,Italian Recipes,Dinner,Vegetarian
Thakkali Rasam Recipe,"Gm Arhar Dal, Turmeric Powder, Tamarind Water, Tomato, Garlic, Cumin Powder, Coriander Powder, Black Pepper Powder, Red Chilli Powder, Salt, Curry Leaves, Rye, Cumin Seeds, Ghee, Asafoetida, S Of Coriander",16,10,30,40,4,Tamil Nadu,Main Course,Vegetarian
Tangy Mint Potatoes ,"Potato, Mint, Coriander, Green Chilli, , Red Chilli Powder, Turmeric Powder, Salt, Ghee Oil, As Per",10,10,15,25,2,Indian,Lunch,Vegetarian
Manathakkali Kootu Recipe,"Yellow Moong Dal, Onion, Tomato, Manathakkali Keerai, Garlic, Turmeric Powder, Red Chilli Powder, Salt, Sesame, White Urad Dal, Mustard Seeds, Dry Red Chilli, Asafoetida",13,10,30,40,3,South Indian Recipes,Lunch,Diabetic Friendly
Pan Fried Avocado Kofta ,"Avocado, Carrot, Semolina Breadcrumbs, Rice Flour    Onion  Finely, Green Coriander, Green Chili, Ginger, Garlic, Tamarind Water Lemon Juice, Oil, Garam Masala Powder, Coriander Powder, Tablespoon Cumin Powder, Red Chili Powder, Black Pepper Powder, Turmeric Powder, Salt",17,10,8,18,15,Indian,Snack,Vegetarian
Bajra Matar Ki Khichdi ,"Millet Flour, Yellow Moong Dal, Oil, Mustard, Cumin Seeds, Asafoetida, Onion, Tomato, Potato, Carrot, Green Peas, Red Chili Powder, Ginger Garlic Paste, Coriander Powder, Hot Masala Powder, Turmeric Powder, Salt, Green Coriander, Lemon Juice",19,260,30,290,4,Indian,Lunch,Gluten Free
Paleo Balsamic Mushrooms Recipe,"Button Mushrooms, Butter, Onion, Garlic, Balsamic Vinegar, Salt, Whole Black Peppercorns, Spring Onion Greens",8,15,20,35,2,Continental,Side Dish,Vegetarian
Apple And Raisin Chutney Recipe,"Apples  Peeled, Onion, Lemon, Vinegar, Raisins, Salt, Sugar, Cinnamon Powder, Sunflower Oil",9,15,15,30,4,Continental,Side Dish,Vegetarian
Paneer Gassi Recipe,"Onion, Garlic, Byadagi Dried Chilli You Can Use  Kashmiri Chilli And  Small Red Chilli), Coriander, Cumin Seeds, Methi Seeds, Whole Black Peppercorns, Tamarind, Fresh Coconut, Ghee, Paneer, Onion, Salt, Turmeric Powder, Coconut Milk, Coconut Milk, Ghee, Cinnamon Stick, Cloves, Cardamom, Curry Leaves",21,10,35,45,4,Mangalorean,Lunch,High Protein Vegetarian
Chow Chow Thakkali Kootu Recipe - Chayote Squash In Dal Coconut Curry,"Chow Chow, Yellow Moong Dal, Tomato, Cumin Seeds, Turmeric Powder, Mustard Seeds, Dry Red Chilli, Asafoetida, Curry Leaves, Sunflower Oil, Salt, Fresh Coconut, Dry Red Chilli, Cumin Seeds, Whole Black Peppercorns",15,10,15,25,4,South Indian Recipes,Lunch,Vegetarian
Andhra Style Pachi Pulusu Recipe -Raw Tamarind Rasam,"Tamarind Water, Onion, Green Chilli, Coriander, Jaggery, Salt, Mustard Seeds, Cumin Seeds, Curry Leaves, Asafoetida, Dry Red Chilli, Garlic, Sunflower Oil",13,10,5,15,4,Andhra,Lunch,Vegetarian
Ajwain Puri ,"Wheat Flour, Celery, Turmeric Powder, Salt, Oil",5,25,30,55,4,Indian,Indian Breakfast,Vegetarian
Arbi Gosht Masala Recipe - Mutton Arbi Curry In Electric Pressure Cooker,"Mutton, Colocasia Root, Cinnamon Stick, Black Pepper Corns, Cloves, Black Cardamom, Onion, Ginger, Garlic, Green Chilli, Tomato, Red Chilli Powder, Coriander Powder, Turmeric Powder, Garam Masala Powder, Coriander, Mustard Oil, Salt",18,15,35,50,4,North Indian Recipes,Dinner,Non Vegeterian
Mexican Style Red Chicken Chilaquiles Recipe,"Tortillas, Cheese, Chicken Breasts, Dried Thyme Leaves, Onion, Garlic, Tomato, Onion, Garlic, Tomato Ketchup, Red Chilli Powder, Dried Oregano, Dried Thyme Leaves, Sugar, Salt",15,10,25,35,4,Mexican,Appetizer,Non Vegeterian
Kala Chana Amti Recipe - Maharashtrian Black Chickpea Curry,"Kala Chana, Onion, Tomato, Ginger Garlic Paste, Cumin Powder, Black Pepper Powder, Cardamom Powder, Tamarind Paste, Mustard Seeds, Curry Leaves, Asafoetida, Coriander, Sunflower Oil, Salt, Dry Red Chilli, Cloves, Cinnamon Stick, Star Anise, Coriander, Fennel Seeds, Poppy Seeds, Cumin Seeds, Dry Coconut",23,10,30,40,4,Maharashtrian Recipes,Lunch,High Protein Vegetarian
"Fig, Ricotta And Honey Salad Recipe With Pine Nuts","Fresh Figs   Into Quarters, Ricotta Cheese Any Other Soft Cheese, Honey, Extra Virgin Olive Oil, Walnuts Pine Nuts, Salt And Pepper",6,15,15,30,2,Continental,Appetizer,Vegetarian
Homemade Whole Wheat Crepes Recipe,"Whole Wheat Flour, Sugar, Milk, Salt, Whole Eggs",5,10,30,40,6,French,Appetizer,Vegetarian
Creamy Cinnamon Peach Milkshake Recipe With Chia Seeds,"Peaches, Sugar, Honey, Cinnamon Powder, Vanilla Ice Cream, Milk, Chia Seeds",7,10,0,10,4,Continental,Snack,Vegetarian
Vanilla Dutch Baby Pancake Recipe,"All Purpose Flour, Milk, Vanilla Extract, Whole Eggs, Caster Sugar, Salt, Butter",7,10,20,30,2,Continental,World Breakfast,Vegetarian
Sindhi Kadhi Recipe,"Arhar Dal, Tomato, Bhindi, Sunflower Oil, Methi Seeds, Mustard Seeds, Dry Red Chilli, Curry Leaves, Asafoetida, Gram Flour, Red Chilli Powder, Tamarind Paste, Turmeric Powder, Jaggery, Salt",15,10,60,70,2,Sindhi,Lunch,High Protein Vegetarian
Fruit Kebabs Recipe,"Strawberries, Red Grapes, Cheese Cubes, Lemon Juice, Ripe Bananas, Mango, Papaya, Watermelon, Kiwi, Fresh Raspberries Any Other Berries Of Choice",10,20,0,20,4,Continental,Appetizer,Vegetarian
Soft Taco With Mushroom and Roasted Bell pepper Sauce Recipe,"Makki Ka Atta, All Purpose Flour, Button Mushrooms, Cumin Powder, Red Chilli Flakes, Salt, Red Bell Pepper, Cheese, Green Bell Pepper, Garlic, Walnuts, Fresh Cream, Dried Oregano, Salt",14,10,35,45,4,Mexican,Appetizer,Vegetarian
Roasted Chicken Curry Recipe In Spinach Parmesan Sauce,"Chicken Breasts, Onion, Garlic, Spinach Leaves, Black Pepper Powder, Dried Oregano, Red Chilli Flakes, Cheese Spread, Parmesan Cheese, Nutralite Cheesy Garlic Mayo, Milk, Salt, Nutralite Classic Spread",13,10,25,35,2,Continental,Lunch,Non Vegeterian
Avocado Tomato Grilled Cheese Sandwich Recipe,"Whole Wheat Brown Bread, Butter, Homemade Basil Pesto, Avocado, Tomato, Red Romaine Lettuce, Black Pepper Powder, Cheese, Salt",9,10,15,25,2,Continental,World Breakfast,Vegetarian
Ragi Nippattu Recipe With Peanuts And Sesame - Ragi Thattai / Chekkalu,"Ragi Flour, Rice Flour, Chana Dal, Asafoetida, Sesame Seeds, Roasted Peanuts, Red Chilli Powder, Sunflower Oil, Salt, Sunflower Oil",10,10,20,30,20,South Indian Recipes,Snack,Vegetarian
Chinese Dragon Chicken With Vegetables Recipe,"Chicken, Baby Corn   Into One Cubes, Red Bell Pepper, Yellow Bell Pepper, Green Bell Pepper, Onion, Carrots, Button Mushrooms, Red Chilli Flakes, Fresh Red Chilli, Red Chilli Sauce, Tomato Ketchup, Corn Flour, Whole Eggs, Sunflower Oil, Cashew Nuts, Ginger Garlic Paste, Honey",18,10,30,40,4,Chinese,Appetizer,Non Vegeterian
Teekha Murgh Recipe,"Chicken, Curd, Kalonji, Fennel Seeds, Onion, Tomato, Ginger, Garlic, Green Chilli, Black Pepper Powder, Cumin Powder, Red Chilli Powder, Kashmiri Red Chilli Powder, Turmeric Powder, Curry Leaves",15,15,30,45,2,Indian,Dinner,High Protein Non Vegetarian
Paneer Shashlik Recipe,"Paneer, Green Bell Pepper, Yellow Bell Pepper, Onion, Tomato, Coriander, Anardana Powder, Fresh Cream, Lemon Juice, Curd, Sunflower Oil, Black Pepper Powder, Salt, Cumin Powder, Garam Masala Powder, Chaat Masala Powder, Garlic, Ginger, Corn Flour, Sunflower Oil, Lemon Juice, Onion, Cabbage",23,20,60,80,4,North Indian Recipes,Lunch,High Protein Vegetarian
Parshe Macher Jhal Recipe - Mullet In Mustard Sauce,"Parshe, Kasundi Mustard Sauce, Tomato, Green Chilli, Turmeric Powder, Red Chilli Powder, Kalonji, Mustard Oil, Coriander, Salt",10,5,30,35,6,Bengali Recipes,Lunch,High Protein Non Vegetarian
Awadhi Style Dal Masoor Musallam Recipe,"Masoor Dal, Onion, Tomato, Green Chilli, Asafoetida, Bay Leaf, Cumin Seeds, Clove Garlic, Ginger, Red Chilli Powder, Coriander Powder, Turmeric Powder, Garam Masala Powder, Coriander, Salt, Sunflower Oil",16,10,35,45,4,Awadhi,Lunch,High Protein Vegetarian
Green Chutney Aloo Chaat Recipe,"Potato, Green Coriander, Mint Leaves, Green Chilli, Ginger, Lemon, Peanuts, Sugar, Salt, Cumin, Garam Masala Powder, Cumin Powder, Pomegranate, Sev, Chaat Masala Powder, Oil",16,20,10,30,4,North Indian Recipes,Snack,Vegetarian
Healthy Carrot Methi & Mooli Thepla Recipe,"Whole Wheat Flour, Turmeric Powder, Red Chilli Powder, Cumin Powder, Asafoetida, Carrot, Mooli Mullangi, Methi Leaves, Green Chilli, Sunflower Oil, Salt",11,5,40,45,4,Gujarati Recipesï»¿,Lunch,Vegetarian
Eggless Saffron Yogurt Mousse Recipe With Cardamom & Nuts,"Badam, Pistachios, Sugar, Butter, Cardamom Powder, Curd, Milk, Saffron Strands, Honey, Rose Water, Gelatin, Water, Sugar, Water, Saffron Strands, Cardamom Powder, Corn Flour, Water",18,180,5,185,4,Fusion,Dessert,Vegetarian
Khamiri Roti Recipe,"Whole Wheat Flour, Active Dry Yeast, Sugar, Milk, Salt",5,30,30,60,4,Mughlai,Side Dish,Vegetarian
Pachai Sundakkai Puli Kuzhambu Recipe (Turkey Berry Tamarind Based Gravy),"Sundakkai, Onion, Tomato, Garlic, Dry Red Chilli, Tamarind Water, Turmeric Powder, Sambar Powder, Mustard Seeds, Cumin Seeds, Curry Leaves, Salt, Sunflower Oil, Sugar, Fresh Coconut, Coriander, Fennel Seeds",17,10,30,40,5,South Indian Recipes,Side Dish,Vegetarian
Kolhapuri Misal Pav Recipe,"Coriander, Cumin Seeds, Dry Coconut, Whole Black Peppercorns, Fennel Seeds, Sesame Seeds, Bean Sprouts, Mustard Seeds, Cumin Seeds, Asafoetida, Red Chilli Powder, Green Chilli, Curry Leaves, Salt, Kolhapuri Masala, Raw Peanuts, Potato, Tamarind Paste, Sunflower Oil, Onion, Tomato, Asafoetida, Tamarind Paste, Garlic, Ginger, Cinnamon Stick, Sunflower Oil, Kolhapuri Masala, Fresh Coconut, Cumin Seeds, Turmeric Powder, Red Chilli Powder, Onion, Tomato, Raw Peanuts, Sev",36,30,120,150,2,North Indian Recipes,Snack,Vegetarian
Narkel Diye Cholar Dal Recipe (Bengali Chana Dal With Fried Coconut Slices),"Chana Dal, Raisins, Dry Coconut, Cardamom, Cinnamon Stick, Bay Leaves, Ginger, Green Chilli, Cumin Seeds, Turmeric Powder, Dry Red Chilli, Mustard Oil, Ghee, Sugar, Salt",15,5,20,25,4,Bengali Recipes,Lunch,High Protein Vegetarian
Sparkling Strawberry Mocktail Recipe,"Strawberries, Mint Leaves, Lemon Juice, Water, Honey, Aerated Water",6,10,0,10,8,Continental,Snack,Vegetarian
French Crullers Recipe,"All Purpose Flour, Whole Eggs, Egg Whites, Butter, Salt, Lukewarm Water, Sunflower Oil Frying, Honey, Icing Sugar, Milk",10,10,60,70,4,European,World Breakfast,Vegetarian
Matar Millet Pulao Recipe - Peas Pulao Recipe,"Bajra Flour, Green Peas, Cardamom, Cinnamon Stick, Bay Leaf, Cumin Seeds, Salt, Ghee",8,5,25,30,4,North Indian Recipes,Lunch,Vegetarian
Chettinad Style Tomato Vermicelli Upma Recipe,"Semiya, Pearl Onion, Garlic, Ginger, Tomato, Mint Leaves, Fennel Seeds, Mustard Seeds, Whole Black Peppercorns, Cinnamon Stick, Cloves, Curry Leaves, Red Chilli Powder, Turmeric Powder, Lemon Juice, Sunflower Oil, Salt",17,5,20,25,4,Chettinad,South Indian Breakfast,Vegetarian
Kovakkai Podi Curry Recipe,"Tindora, Rye, White Urad Dal, Asafoetida, Curry Leaf, Dry Red Chilli, Oil, Salt, White Urad Dal, Chana Dal, Dry Red Chilli, Asafoetida",12,15,20,35,4,Tamil Nadu,Lunch,Diabetic Friendly
Easy Creamy Chicken Curry Recipe,"Chicken, Cups Curd, Lemon Juice, Salt, Ginger, Garlic, Black Pepper Powder, Kasuri Methi, Fresh Cream, Sunflower Oil",10,2,40,42,4,North Indian Recipes,Lunch,Non Vegeterian
Pudina Dahi Chutney Recipe,"Curd, Mint, Coriander, Green Chili, Ginger, Salt, According",7,15,0,15,4,North Indian Recipes,Side Dish,Vegetarian
Malvani Anda Curry Recipe - Egg Curry With Spicy Malvani Masala,"Whole Eggs, Onion, Homemade Tomato Puree, Green Chilli, Ginger Garlic Paste, Cashew Nuts, Fresh Coconut, Red Chilli Powder, Coriander Powder, Malwani Masala, Turmeric Powder, Cumin Seeds, Kokum, Curry Leaves, Sunflower Oil, Salt",16,10,20,30,4,Malvani,Side Dish,Eggetarian
Shanghai Yang Chun Noodle Recipe (Flat Noodles In Soya Broth Recipe),"Rice Noodles, Broccoli, Carrot, Bok Choy, Cloves, Lemongrass, Soy Sauce, Red Chilli Sauce, Honey, Salt, Black Pepper Powder, Spring Onion, Sunflower Oil",13,15,30,45,4,Chinese,World Breakfast,Vegetarian
Pachai Payaru Poriyal Recipe - Green Moong Sprout Poriyal,"Sunflower Oil, Mustard Seeds, Dry Red Chilli, Curry Leaves, Green Moong Sprouts, Salt, Black Pepper Powder, Lemon Juice, Coriander",9,5,15,20,4,South Indian Recipes,Side Dish,High Protein Vegetarian
Marwadi Gatte Ki Kadhi Recipe,"Flour, Red Chili Powder, Celery, Curd, Salt, Flour, Curd, Garlic, Green Chilli, Turmeric Powder, Salt, Of Green Coriander, Ghee, Cumin Seeds, Dry Red Chilli, Cinnamon",16,10,45,55,4,Rajasthani,Lunch,Vegetarian
Chicken Tikki Recipe - Chicken Cutlet,"Chicken, Onion, Coriander, Ginger Garlic Paste, Tablespoons Rice Flour, Salt, Whole Egg, Cup Whole Wheat Bread Crumbs, Tablespoons Sunflower Oil, Tablespoon Garam Masala Powder, Red Chilli Powder, Turmeric Powder, Coriander Powder, Cumin Powder",14,15,10,25,7,Indian,Appetizer,High Protein Non Vegetarian
Kala Chana Masala Recipe,"Cup Kala Chana, Onion, Ginger, Garlic, Cinnamon Stick, Homemade Tomato Puree, Turmeric Powder, Red Chilli Powder, Garam Masala Powder, Coriander Powder, Figaro Pure Olive Oil, Salt, Coriander",13,120,35,155,4,North Indian Recipes,Dinner,High Protein Vegetarian
Oats And Spinach Pongal Recipe,"Instant Oats, Yellow Moong Dal, Spinach, Water, Cumin Seeds, Whole Black Peppercorns, Curry Leaves, Asafoetida, Green Chilli, Cashew Nuts, Ghee, Salt",12,10,25,35,4,Tamil Nadu,South Indian Breakfast,High Protein Vegetarian
Blueberry Chia Banana Smoothie Recipe,"Blueberries, Ripe Bananas, Chia Seeds, Badam, Honey, Tender Coconut Water, Ice Cubes",7,10,5,15,2,Continental,World Breakfast,Vegetarian
Podi Potta Pachhai Kathirikai | Brinjal Stir Fry Recipe With Curry Powder,"Coriander, Chana Dal, White Urad Dal, Dry Red Chilli, Sunflower Oil, Mustard Seeds, Small Green Brinjal, Turmeric Powder, Coriander Powder, Mustard Seeds, Asafoetida, Sunflower Oil, Tamarind, Salt",14,10,20,30,2,South Indian Recipes,Side Dish,Vegetarian
Carrot Amla Pomegranate Juice Recipe,"Carrots, Amla, Fresh Pomegranate Fruit Kernels, Ginger, Honey",5,10,0,10,2,Continental,Snack,Vegetarian
Semolina Porridge Fruit & Nut Breakfast Bowl Recipe,"Sooji, Water, Milk, Vanilla Extract, Cinnamon Powder, Honey, Multigrain Digestive Biscuits, Strawberries, Badam, Pistachios",10,10,10,20,1,Continental,World Breakfast,Vegetarian
Curd Rice Style Overnight Oats Recipe,"Instant Oats, Hung Curd, Milk, Coriander, Cashew Nuts, Asafoetida, Mustard Seeds, White Urad Dal, Chana Dal, Cumin Seeds, Whole Black Peppercorns, Ginger, Onion, Curry Leaves, Green Chilli, Fresh Red Chilli, Sunflower Oil, Salt",18,0,15,15,10,Indian,World Breakfast,Vegetarian
Capsicum Bajji Recipe -Kuda Milagai Bajji/ Bell Pepper Bajji,"Green Bell Pepper, Gram Flour, Turmeric Powder, Red Chilli Powder, Asafoetida, Salt",6,10,10,20,3,Indian,Snack,Vegetarian
Bengali Aloo Jhinge Posto Curry ,"Trumpet, Potato, Fennel Seeds, Turmeric, Sugar, Salt, Mustard Oil, Poppy Seeds, Dry Red Chili, Green Chilli",10,15,30,45,4,Bengali Recipes,Lunch,Vegetarian
Paneer Stuffed Mushroom Masala Recipe,"Button Mushrooms, Salt, Sunflower Oil, Paneer, Salt, Black Pepper Powder, Garam Masala Powder, Cumin Powder, Onion, Mint Leaves, Whole Black Peppercorns, Dry Red Chilli, Cumin Seeds, Coriander Seeds, Cardamom, Cloves, Cinnamon Stick, Star Anise, Sunflower Oil, Milk, Homemade Tomato Puree, Garlic, Ginger, Water, Salt, Turmeric Powder, Coriander",27,20,25,45,5,North Indian Recipes,Main Course,Vegetarian
Manipuri Style Alu Kangmet Recipe - Mashed Potato In Dry Red Chillies,"Potato, Dry Red Chilli, Salt, Mustard Oil",4,5,15,20,4,North East India Recipes,Lunch,Vegetarian
Asian Shrimp And Veggie Bowl Recipe,"Shrimps, Red Bell Pepper, Baby Potato, Broccoli, Carrot, Onion, Garlic, Ginger, Basmati Rice, Extra Virgin Olive Oil, Black Pepper Powder, Salt, Red Chilli Flakes, Corn Flour, Cabbage, Soy Sauce, Honey, Red Chilli Sauce",18,10,35,45,4,Asian,Lunch,Non Vegeterian
Mughlai Aloo Lajawab Recipe - Mughlai Aloo Sabzi Recipe,"Potato, Onion, Tomato, Cashew Nuts, Garlic, Ginger, Milk, Ajwain, Kashmiri Red Chilli Powder, Coriander Powder, Turmeric Powder, Garam Masala Powder, Fresh Cream, Kasuri Methi, Sunflower Oil, Ghee, Salt",17,20,30,50,4,Mughlai,Dinner,Vegetarian
Mugachi Usal Recipe -Spicy Moong Sprouted Sabzi,"Green Moong Sprouts, Turmeric Powder, Cumin Seeds, Mustard Seeds, Asafoetida, Green Chilli, Ginger, Fresh Coconut, Lemon Juice, Salt, Water, Curry Leaves, Dry Red Chilli",13,10,20,30,4,Maharashtrian Recipes,Lunch,High Protein Vegetarian
Vermicelli Biryani ,"Macaroni, Carrot, Green Beans, Capsicum, Onion, Green Peas, Garam Masala Powder, Coriander Powder, Biryani Masala, Turmeric Powder, Cumin Seeds, Oil, Onion, Fennel, Green Chilli, Green Coriander, Garlic, Ginger",18,15,15,30,4,Indian,South Indian Breakfast,Vegetarian
Beetroot Chicken Cutlets Recipe,"Gm Chicken, Potato, Chakundar, Coriander Leaves, Curry Leaves, Green Chilli, , , Garam Masala Powder, Red Chili Powder, Salt, Whole Black Pepper, Oil, Bread Crumbs",14,30,20,50,4,Indian,Appetizer,High Protein Non Vegetarian
Paneer Carrot Stuffed Paratha Recipe,"Whole Wheat Flour, Salt, Sunflower Oil, Water, Paneer, Carrot, Onion, Green Chilli, Cumin Powder, Mint Leaves, Salt, Ghee Oil For Cooking",12,25,30,55,4,Indian,Lunch,Vegan
Rustic Cottage Pie With Mushroom Sauce Recipe,"Extra Virgin Olive Oil, Onion, Garlic, Button Mushrooms, Vegetable Stock, Fresh Thyme Leaves, Salt And Pepper, Extra Virgin Olive Oil, Onion, Garlic, Stalk Celery, Carrot, Green Peas, Sweet Corn, Button Mushrooms, Soy Chunks, Dried Oregano, Dried Thyme Leaves, Butter, Potato, Milk, Salt And Pepper",22,20,90,110,4,Continental,Dinner,Vegetarian
Shortbread Cookies With Citrus Zest Recipe,"All Purpose Flour, Sugar, Butter, Baking Powder, Lemon Zest, Orange Zest, Kosher Salt",7,25,35,60,4,Continental,Snack,Vegetarian
Sweet Potato & Lentil Tacos Recipe With Cranberries,"Sweet Potato, Green Bell Pepper, Masoor Dal, Tomato, Pickled Jalapenos, Garlic, Lemon Juice, Cabbage, Carrots, Cranberries, Avocado, Hung Curd, Coriander, Salt, Sunflower Oil, Corn Flour Tortilla",16,20,40,60,3,Mexican,Dinner,Vegetarian
Cheesy & Spicy Pull Apart Bread Recipe With Indian Spices,"All Purpose Flour, Wheat Bran, Flax Seed Powder, Active Dry Yeast, Sugar, Extra Virgin Olive Oil, Salt, Lukewarm Water, Potato, Baby Corn, Green Bell Pepper, Onion, Green Chilli, Soy Chunks, Cumin Seeds, Red Chilli Powder, Garam Masala Powder, Sunflower Oil, Salt, Cheese",20,10,100,110,2,Indian,Snack,Vegetarian
Mango Curry Recipe,"Mangoes, Cumin, Mustard, Fenugreek Seeds, Fennel, Oil, Dry Red Chilli, Asafetida, Turmeric Powder, Red Chilli Powder, Coriander Powder, Garam Masala Powder, Salt, Tamarind Paste",14,20,35,55,6,Indian,Lunch,Vegetarian
Avalakki Bella Usuli Recipe (Jaggery & Flattened Rice),"Poha, Jaggery, Fresh Coconut, Cardamom Powder, Water",5,5,10,15,2,Karnataka,Snack,Vegetarian
Andhra Style Pesarattu Upma Recipe,"Green Moong Dal, Raw Rice, Green Chilli, Ginger, Onion, Coriander, Salt, Sunflower Oil, Sooji, Tomato, Onion, Green Chilli, Ginger, Mustard Seeds, White Urad Dal, Curry Leaves, Asafoetida, Salt, Hot Water, Lemon Juice, Sunflower Oil, Sunflower Oil",22,240,45,285,4,Andhra,South Indian Breakfast,High Protein Vegetarian
Orange And Poppy Seeds Muffins Recipe,"All Purpose Flour, Baking Powder, Salt, Caster Sugar Powdered Sugar, Sunflower Oil, Vanilla Extract, Milk, Poppy Seeds, Whole Egg, Fresh Orange Juice, Orange Zest, Fresh Orange Juice, Caster Sugar",13,30,18,48,8,Continental,Dessert,Eggetarian
Gluten Free Samosa Recipe,"Potato, Cumin Seeds, Onion, Green Peas, Butter, Rice Paper Rolls, Garam Masala Powder, Salt",8,15,40,55,6,Indian,Snack,Vegetarian
Banana Walnut Chai Smoothie Recipe,"Apple, Ripe Bananas, Instant Oats, Walnuts, Milk, Chai Masala, Cardamom Powder, Ice Cubes",8,10,5,15,1,Continental,World Breakfast,Vegetarian
Honey Glazed Roasted Carrots Recipe With Herbs,"Carrots, Extra Virgin Olive Oil, Balsamic Vinegar Red Wine Vinaigrette, Salt, Whole Black Peppercorns, Honey, Rosemary Thymeparsley",7,10,25,35,4,Continental,Appetizer,Vegetarian
Loaded Baked Potato French Fries Recipe,"Potato, Extra Virgin Olive Oil, Salt, Red Chilli Flakes, Mixed Herbs, Eggless Mayonnaise, Veeba Sriracha Sauce, Black Olives, Pickled Jalapenos",9,10,30,40,4,Continental,Appetizer,Vegetarian
Thotakura Undalu Recipe (Crispy Amaranth Leaves Balls),"Green Amaranth Leaves, Gram Flour, Cumin Seeds, Red Chilli Powder, Ginger, Salt, Sunflower Oil, Sesame Seeds, Curry Leaves, Asafoetida, Dry Red Chilli",11,10,25,35,4,Andhra,Snack,Vegetarian
Anda Bhurji Recipe,"Whole Eggs, Milk Coconut Milk, Ghee Oil, Onion, Tomato, Green Chilli, Cumin Seeds, Coriander, Salt",9,15,15,30,4,North Indian Recipes,North Indian Breakfast,Eggetarian
Zucchini Boats With Chickpeas In Tomato Hummus Recipe,"Green Zucchini, Button Mushrooms   Finely, Onion, Tomato, Garlic, Dried Oregano, Parsley Leaves, Red Chilli Flakes, Black Pepper Powder, Extra Virgin Olive Oil, Kala Chana, Lemon Juice, Red Chilli Powder, Salt, Garlic, Tahini, Black Pepper Powder, Cumin Seeds, Byadagi Dried Chilli, Kala Chana, Lemon Juice, Extra Virgin Olive Oil, Sun Dried Tomato, Tomato, Salt, Extra Virgin Olive Oil",26,10,60,70,4,Mediterranean,Appetizer,Vegetarian
Foxtail Millet Vermicelli Upma Recipe,"Foxtail Millet, Onion, Mustard Seeds, Cumin Seeds, Raw Peanuts, Curry Leaves, Sambar Powder, Turmeric Powder, Salt, Sunflower Oil",10,5,25,30,4,South Indian Recipes,South Indian Breakfast,Diabetic Friendly
Grilled Cherry Tomato Pickle Recipe,"Cherry Tomato, Mint Leaves, Vinegar, Sugar, Sunflower Oil, Mustard Seeds, Fennel Seeds, Ajwain, Black Pepper Powder, Salt",10,10,30,40,6,Indian,Side Dish,Vegetarian
Pissaladiere Recipe - Provencal Onion Tart Recipe,"Active Dry Yeast, All Purpose Flour, Extra Virgin Olive Oil, Lukewarm Water, Flax Seeds, Onion, Tomato, Few  Fresh Thyme Leaves, Garlic, Salt And Pepper, Del Monte Green Olives, Extra Virgin Olive Oil, Extra Virgin Olive Oil",13,15,120,135,6,French,Appetizer,Vegetarian
Baby Potato Theeyal Recipe - Kerala Style Potatoes In Shallots And Roasted Coconut,"Baby Potato, Pearl Onion, Tomato, Green Chilli, Ginger, Garlic, Coriander Powder, Red Chilli Powder, Turmeric Powder, Garam Masala Powder, Curry Leaves, Pearl Onion, Fresh Coconut, Cumin Seeds, Whole Black Peppercorns, Coconut Oil, Salt",17,20,45,65,4,Kerala Recipes,Lunch,Vegetarian
Oats Uttapam topped with Paneer Recipe,"Rice Flour Sooji Rice Will Also Do, Sooji, Poha, White Urad Dal, Black Urad Dal, Arhar Dal, Chana Dal, Methi Seeds, Instant Oats, Curd, Water, Paneer, Carrot, Red Bell Pepper, Green Chilli, Coriander, Ginger",17,30,30,60,4,Tamil Nadu,South Indian Breakfast,Vegetarian
Peanut Butter Cookie Bars Recipe-Healthy snack for kids,"Oats Flour, Almond Meal, Dates, Peanut Butter, Coconut Oil, Salt, Dark Chocolate Chips",7,10,120,130,15,Continental,Snack,High Protein Vegetarian
Sel Roti Recipe (Nepalese ring-Shaped Sweet bread),"Rice, Sugar, Ghee, Rice Flour, Cardamom Powder, Water, Sunflower Oil",7,15,25,40,2,Nepalese,Snack,Vegetarian
Suran Kofta Curry Recipe - Yam Kofta Curry,"Elephant Yam, Â¼ Gram Flour, Green Chilli, Salt, Ginger, Tomato, Ginger, Green Chilli, Â¼ Mint Leaves, Salt, Garam Masala Powder, Cumin Powder, Sugar",13,20,20,40,2,North Indian Recipes,Main Course,No Onion No Garlic (Sattvic)
Turmeric Milk Recipe,"Turmeric, Milk, Honey Sugar, Black Pepper Powder",4,10,5,15,1,Indian,Snack,Vegetarian
Chow Chow and Carrot Kootu Recipe,"Chayote, Carrot, Turmeric Powder, Salt, Rice, Chana Dal, Fresh Coconut  Grated, Cumin Seeds, Green Chilli, Sunflower Oil, Mustard Seeds, White Urad Dal, Curry Leaves, Dry Red Chilli",14,30,20,50,4,South Indian Recipes,Lunch,Vegetarian
Pumpkin Erissery Recipe - Kerala Pumpkin Coconut Curry,"Kaddu, Fresh Coconut, Fresh Coconut Be Roasted, Green Chilli, Mustard Seeds, White Urad Dal, Curry Leaves, Dry Red Chilli, Turmeric Powder, Cumin Seeds, Coconut Oil, Salt",12,10,30,40,4,Kerala Recipes,Lunch,Vegetarian
Sesame Peanut Potato Mix Recipe,"Sunflower Oil, Curry Leaves, Sesame Seeds, Green Chilli, Raw Peanuts, Potato, Amchur, Cumin Powder, Black Pepper Powder, Coriander, Salt",11,10,30,40,4,Indian,Lunch,Vegetarian
Baked Banana Chips Recipe,"Raw Bananas, Paprika Powder, Pepper Powder, Salt, Olive Oil",5,10,35,45,4,Kerala Recipes,Snack,Vegetarian
Narkel Naru Ladoo Recipe With Grated Coconut,"Dessicated Coconut, Milk, Condensed Milk, Sugar, Ghee, Cardamom Powder, Raisins",7,30,60,90,5,Indian,Dessert,Vegetarian
Oriya Style Ghanta Tarkari ,"Pumpkin, Potato, Chawla Pods, Raw Banana, Radish, Sweet Potato, Arabic, Yam, Eggplant, Petha Pumpkin, Lima Beans   Into   Lengths, Tomato, Cucumber, Parwal, Cucumber, Trumpet, Coconut, Coconut, Cup Ginger, Bay Leaf, Black, Sprouted Moong, Turmeric Powder, Salt, Grind  Jaggery, Dry Red Chilli  For Tempering, Cumin Seeds, Cumin Powder, Red Chilli Powder, Ghee",30,15,50,65,4,Oriya Recipes,Lunch,Vegetarian
Sri Lankan Egg Curry ,"Eggs, Onion, Ginger Garlic Paste, Curry Leaves, Coriander Seeds, Fennel, Tomato, Coconut Milk, Red Chilli Powder, Turmeric Powder, Curry Powder  Sri Lankan Curry Powder, Salt, Oil, Dry Red Chilli, Coriander Seeds, Cumin Seeds, , Whole Pepper, Cardamom, Lentil, Capsicum, Curry Leaves",22,25,35,60,4,Sri Lankan,Lunch,Eggetarian
Red Rice Dosa ,"Red Chili, White Urad Dal, Fenugreek Seeds, Salt, Water, Oil",6,10,120,130,3,South Indian Recipes,South Indian Breakfast,Vegetarian
Beetroot & Spinach Nimki Recipe (Namak Para),"All Purpose Flour, Salt, Chaat Masala Powder, Ajwain, Spinach Leaves, Beetroot, Sunflower Oil",7,30,30,60,4,North Indian Recipes,Snack,Vegetarian
Lemon Pepper Fish Recipe,"Basa Fish, Curry Leaves, Mustard Seeds, Garlic, Fennel Seeds, Whole Black Peppercorns, Turmeric Powder, Lemon Juice, Salt, Sunflower Oil",10,5,25,30,4,Indian,Appetizer,High Protein Non Vegetarian
Iyengar Style Thavala Adai Recipe,"Rice, Rice, Chana Dal, Arhar Dal, White Urad Dal, Methi Powder, Whole Black Peppercorns, Cumin Seeds, Gingelly Oil, Mustard Seeds, Chana Dal, White Urad Dal, Asafoetida, Mor Milagai, Curry Leaves, Curd, Water, Salt",18,120,60,180,9,Tamil Nadu,South Indian Breakfast,High Protein Vegetarian
Stuffed Jackfruit Curry ,"Jackfruit, Mustard Oil, Onion, Tomato, Garlic, Ginger, Garam Masala Powder, Coriander Seeds, , Big Teaspoon Kashmiri Red Chilli, Turmeric Powder, Curd, Salt, Onion, Fennel, Mustard Oil, Garlic Butter, Cheese  Finely  Hua Pepper Powder, Salt, Mozzarella Cheese, Mozzarella Cheese",21,15,45,60,4,Indian,Lunch,Vegetarian
Israeli Couscous Salad Recipe,"Couscous  Israeli, Water, Turmeric Powder, Red Bell Pepper, Yellow Bell Pepper, Onion, Dried Figs, Apricots, Cranberries, Pistachios, Coriander, Orange Zest, Cumin Powder, Cardamom Powder, Cinnamon Powder, Lemon Juice, Fresh Orange Juice, Ginger, Honey, Extra Virgin Olive Oil, Lemon Zest",21,10,25,35,3,Continental,Side Dish,High Protein Vegetarian
Nei Appam Recipe Using Rice Flour,"Rice Flour, Jaggery, Water, Cardamom, Ripe Bananas, Baking Soda, Ghee",7,120,30,150,4,Kerala Recipes,Snack,Vegetarian
Chicken Spaghetti in Tomato Basil Sauce Recipe,"Spaghetti Pasta, Chicken Breasts, Tomato, Garlic, Onion, Extra Virgin Olive Oil, Salt, Sugar, Red Chilli Flakes, Rosemary, Tarragon, Coriander",12,10,60,70,4,Italian Recipes,Lunch,Non Vegeterian
Paal Kozhukattai Recipe With Bananas - With Vegan Option,"Rice Flour, Water, Sesame, Salt, Milk, Coconut Milk, Coconut Milk, Cardamom Powder, Sugar Jaggery, Ripe Bananas",10,15,40,55,6,South Indian Recipes,Lunch,Vegetarian
Maharashtrian Kalanyachi Bhakri Recipe With Groundnut Chutney,"Jowar Seeds, Black Urad Dal, Salt, Roasted Peanuts, Green Chilli, Coriander, Garlic, Salt, Sunflower Oil, Mustard Seeds, Cumin Seeds, Curry Leaves",12,15,30,45,6,Maharashtrian Recipes,Main Course,Vegetarian
Goan Raw Banana Sabzi Recipe,"Raw Banana, Onion, Fresh Coconut, Cumin Seeds, Mustard Seeds, Dry Red Chilli, Curry Leaves, Turmeric Powder, Sunflower Oil, Salt",10,5,15,20,4,Goan Recipes,Side Dish,Vegetarian
Garlic Shrimp Linguine Pasta Recipe,"Linguine Pasta, Shrimps, Butter, Salt, Garlic, Black Pepper Powder, Dried Oregano, Red Chilli Flakes, Parmesan Cheese",9,15,15,30,2,Italian Recipes,Dinner,Non Vegeterian
Healthy Fruit Pizza Recipe For Breakfast,"Instant Oats, Badam, Ripe Bananas, Rice Flour, Date Syrup Any Sweetener, Salt, Hung Curd, Strawberries, Kiwi, Orange, Blueberries, Mint Leaves, Honey Drizzle On Top",13,5,25,30,4,Fusion,World Breakfast,Vegetarian
Sweet Lime Soda ,"Sugar, Lime Juice, Water, Soda, Cumin Powder, Black Saltrock Salt, Pepper Powder, Peppermint, Ice",9,15,0,15,2,Indian,Snack,Vegetarian
Maash Ki Dal Khasgi Recipe (Dhaba Style Urad Dal),"White Urad Dal, Onion, Green Chilli, Cloves, Ginger, Coriander Powder, Turmeric Powder, Salt, Sunflower Oil, Water, Sunflower Oil, Onion, Cumin Seeds, Garlic, Ginger",15,10,45,55,4,North Indian Recipes,Lunch,High Protein Vegetarian
One Pot Tex-Mex Penne Pasta Recipe,"Penne Pasta, Extra Virgin Olive Oil, Green Bell Pepper, Onion, Garlic, Red Chilli Powder, Paprika Powder, Cumin Powder, Garlic Powder, Salt, Milk, Parmesan Cheese, Parsley Leaves",13,10,35,45,4,Fusion,Lunch,Vegetarian
Kesar Pista Phirni Recipe,"Milk, Basmati Rice, Sugar, Saffron Strands, Cardamom Powder, Badam, Pistachios",7,30,20,50,6,Mughlai,Dessert,Vegetarian
Punjabi Style Espresso Coffee Recipe,"Instant Coffee Powder, Sugar, Water, Milk  Cocoa Powder  As Per Use",4,30,10,40,2,Punjabi,Indian Breakfast,Vegetarian
Vempampoo Rice Recipe (Dried Neem Flowers Rice),"Black Rice, Sunflower Oil Ghee As Required, Asafoetida, White Urad Dal, Dried Neem Flowers, Dry Red Chilli, Few Curry Leaves",7,320,50,370,2,South Indian Recipes,Lunch,Vegetarian
Menthe / Fenugreek Seeds Tambli Recipe (Karnataka Recipes),"Methi Seeds, Dry Red Chilli, Fresh Coconut, Curd, Ghee, Salt, Ghee, Mustard Seeds, Curry Leaves",9,15,15,30,4,Karnataka,Dinner,Diabetic Friendly
Thai Style Noodles With Spinach And Leeks Recipe,"Coconut Milk, Peanut Butter, Soy Sauce, Brown Sugar, Red Chilli Sauce, Spaghetti Pasta Pad Thai Noodles, Baby Spinach, Leek, Sesame, Clove Garlic, Ginger, Red Chilli Flakes, Roasted Peanuts, Coriander, Salt And Pepper",15,20,20,40,4,Thai,Dinner,Vegetarian
Pasta Salad With Broccoli & Feta Cheese Recipe,"Macaroni Pasta, Cherry Tomato, Broccoli, Feta Cheese, Extra Virgin Olive Oil, Stalks Parsley Leaves, Dried Oregano, Lemon Juice, Whole Black Peppercorns, Salt, Lemon Juice, Whole Black Peppercorns, Salt",13,20,20,40,2,Italian Recipes,Side Dish,Vegetarian
Healthy Spinach Idli Recipe (Steamed Spinach Savory Cake),"Idli Dosa Batter, Spinach  Roughly, Salt, Red Chilli Powder, Garam Masala Powder, Sunflower Oil Grease, Cashew Nuts  Slit",7,5,15,20,4,South Indian Recipes,South Indian Breakfast,Vegetarian
Mushroom Strudel Recipe,"Butter, Onion, Button Mushrooms, Garlic, Parsley Leaves, Rosemary, Parmesan Cheese, Salt, Black Pepper Powder, All Purpose Pie Crust, Butter, Whole Wheat Bread Crumbs",12,10,40,50,2,Continental,Snack,Vegetarian
Roast Peaches with Coconut Walnut Sauce Recipe,"Butter, Walnuts, Coconut Milk, Butter, Sugar, Peaches, Walnuts, Mint Leaves",8,20,40,60,4,Continental,Dessert,Vegetarian
"South Indian Style Green Moong Sprouts, Raw Mango Salad Recipe","Green Moong Sprouts, Mango, Carrot, Cucumber, Coriander, Green Chilli, Fresh Coconut, Lemon Juice, Salt, Coconut Oil, Mustard Seeds, Asafoetida",12,10,0,10,3,South Indian Recipes,Appetizer,Vegetarian
"Beetroot, Carrot & Cucumber Salad with Peanuts Recipe ","Beetroot, Carrot, Cucumber, Roasted Peanuts, Green Chilli, Coriander, Lemon Juice, Black Pepper Powder, Chaat Masala Powder, Salt",10,30,0,30,4,North Indian Recipes,Side Dish,Vegetarian
Instant Mixed Vegetable Pickle Recipe,"Mango, Carrot, Green Beans, Ginger, Garlic, Ginger, Whole Black Peppercorns, Poppy Seeds, Cashew Nuts, Coriander, Mint Leaves, Lemons, Green Chilli, Turmeric Powder, Asafoetida, Salt",16,20,20,40,4,Indian,Appetizer,Vegetarian
Methi Kumro Recipe - Bengali Style Fenugreek Leaves and Pumpkin Stir Fry,"Kaddu, Methi Leaves, Green Chilli, Turmeric Powder, Cumin Powder, Dry Red Chilli, Mustard Seeds, Cumin Seeds, Kalonji, Fennel Seeds, Methi Seeds, Mustard Oil, Salt",13,10,15,25,4,Bengali Recipes,Side Dish,Vegetarian
Til Ke Aloo ,"Small Potato, Sesame Seeds, Coriander Leaves, Green Chilli, Lemon Juice, Cumin Seeds, Garlic, Oil, Turmeric Powder, Salt",10,15,20,35,2,Indian,Lunch,Vegetarian
Kaju Butter Masala Recipe,"Whole Cashews, Tomato, Ginger Garlic Paste, Green Chilli, Kashmiri Red Chilli Powder, Garam Masala Powder, Bay Leaf, Kasuri Methi, Fresh Cream, Butter, Salt",11,10,20,30,4,North Indian Recipes,Lunch,Vegetarian
Aloo Patta Gobi Sabzi Recipe - Potato Cabbage Sabzi,"Potato, Cabbage, Onion, Turmeric Powder, Red Chilli Powder, Coriander Powder, Cinnamon Stick, Cloves, Bay Leaf, Fennel Seeds, Cumin Seeds, Salt, Sunflower Oil, Coriander",14,5,15,20,4,North Indian Recipes,Lunch,Vegetarian
Hyderabad Style Kuska Recipe,"Rice, Stone Flower, Star Anise, Fennel, Mace, , Ginger, Onion, Tomato, Hung Curd, Mint, Green Coriander, Biryani Masala, Turmeric Powder, Salt",15,10,45,55,4,Hyderabadi,Lunch,Vegetarian
Maharashtrian Gavachi Kheer Recipe (Whole Cracked Wheat Pudding),"Broken Wheat, Ghee, Rice, Jaggery  Grated, Fresh Coconut, Nutmeg, Saffron Strands, Chironji Any Other Nuts Of Choice, Milk, Slivered Almonds",10,15,30,45,2,Indian,Dessert,Vegetarian
Stuffed Matar & Gobi Paratha Recipe (Green Pea & Cauliflower Flat Bread),"Green Peas, Cauliflower, Cumin Seeds, Garlic, Whole Wheat Flour, Salt, Red Chilli Powder, Sunflower Oil, Water",9,15,15,30,4,North Indian Recipes,North Indian Breakfast,Vegetarian
Creamy Spinach Basil Pasta Recipe,"Spinach Leaves, Basil Leaves, Onion, Garlic, Pasta  Fusilli, Extra Virgin Olive Oil, Red Chilli Flakes, Fresh Cream, Cheddar Cheese, Salt",10,10,25,35,4,Italian Recipes,Lunch,Vegetarian
Kathiyawadi Adad Dal Recipe- Spicy Urad Dal,"White Urad Dal, Tomato, Ginger Garlic Paste, Green Chilli, Turmeric Powder, Lemon Juice, Curry Leaves, Coriander, Salt, Ghee, Mustard Seeds, Cumin Seeds, Asafoetida, Red Chilli Powder",14,5,30,35,4,Gujarati Recipesï»¿,Side Dish,High Protein Vegetarian
Chinese Style Green Beans Recipe,"Green Beans, Sesame, Garlic, Ginger, Soy Sauce, Rice Wine Vinegar, Red Chilli Sauce, Dry Red Chilli, Corn Flour, Vegetable Stock, Sesame Seeds",11,10,10,20,4,Sichuan,Appetizer,Vegetarian
Cheesy Baked Ziti Pasta Recipe with Roasted Mushroom & Corn,"Ziti Pasta, Extra Virgin Olive Oil, Button Mushrooms, Del Monte Whole Corn Kernels, Salt, Extra Virgin Olive Oil, Basil Leaves, Garlic, Onion, Red Chilli Flakes, Salt, Sugar, Black Pepper Powder, Rosemary, Homemade Tomato Puree, Mozzarella Cheese",16,10,40,50,4,Italian Recipes,Main Course,Vegetarian
Passion Fruit- Shrikhand Shots Recipe,"Curd, Passion Fruit, Caster Sugar, Cardamom Powder, Saffron Strands, Chocolate Chips, Passion Fruit",7,240,15,255,4,Indian,Dessert,Vegetarian
Fish Tikka Masala Gravy Recipe,"Basa Fish, Lemon Juice, Turmeric Powder, Salt And Pepper, Cardamom, Bay Leaf, Cumin Powder, Coriander Powder, Turmeric Powder, Ginger Garlic Paste, Red Chilli Powder, Kasuri Methi, Lukewarm Water, Fresh Cream, Salt, Onion, Tomato, Cashew Nuts, Cloves, Cinnamon Powder",20,10,30,40,4,North Indian Recipes,Lunch,High Protein Non Vegetarian
Green Beans Salad Recipe,"Green Beans, Dessicated Coconut, Sunflower Oil, Mustard Seeds, Cumin Seeds, Asafoetida, Curry Leaves, Dry Red Chilli, Salt, Lemon Juice, Slivered Almonds",11,10,15,25,4,Continental,Appetizer,Vegetarian
Raw Banana and Banana Stem Stuffed Paratha Recipe,"Banana Stem, Raw Banana, Onion, Garlic, Ginger, Green Chilli, Cumin Seeds, Red Chilli Powder, Turmeric Powder, Garam Masala Powder, Black Pepper Powder, Amchur, Salt, Whole Wheat Flour",14,10,40,50,4,Indian,Lunch,Diabetic Friendly
Roasted Red Pepper Hummus Recipe,"Kabuli Chana, Red Bell Pepper, Garlic, Cumin Powder, Red Chilli Powder, Salt, Lemon, Extra Virgin Olive Oil, Parsley Leaves, Sesame Seeds, Water",11,10,40,50,4,Mediterranean,Appetizer,High Protein Vegetarian
Chaat Masala Mashed Potato Toasted Sandwich Recipe,"Potato, Green Chilli, Onion, Coriander, Salt, Butter, Green Chutney, Whole Wheat Brown Bread, Sweet Chutney, Chaat Masala Powder",10,15,20,35,4,Fusion,Snack,Vegetarian
Indo-Chinese Style Ginger Fish Recipe,"Basa Fish, Green Bell Peppers, Red Bell Pepper, Onion, Ginger, Garlic, Corn Flour, Salt And Pepper, Spring Onion, Soy Sauce, Red Chilli Sauce, Brown Sugar, Dry Ginger Powder, Chilli Vinegar, Corn Flour",15,10,25,35,4,Indo Chinese,Appetizer,Non Vegeterian
Moroccan Eggplant And Garbanzo Stew Recipe,"Brinjal, White Garbanzo, Onion, Cloves, Tomato, Vegetable Stock, Paprika Powder, Cinnamon Powder, Cumin Powder, White Pepper Powder, Extra Virgin Olive Oil, Salt",12,10,30,40,4,African,Main Course,High Protein Vegetarian
Cheesy Pav Bhaji Recipe,"Potato, Cauliflower, Carrots, Green Beans, Green Peas, Cabbage, Green Bell Pepper, Ginger, Garlic, Onion, Tomato, Red Chilli Powder, Coriander Powder, Pav Bhaji Masala, Cheese, Butter, Salt",17,10,20,30,4,Maharashtrian Recipes,One Pot Dish,Vegetarian
Enchorer Torkari Recipe - Bengali Style Raw Jackfruit in Semi-gravy,"Jackfruit Raw, Potato, Onion, Garlic, Ginger, Tomato, Cumin Powder, Red Chilli Powder, Turmeric Powder, Garam Masala Powder, Cinnamon Stick, Cardamom, Cloves, Bay Leaf, Green Chilli, Mustard Oil, Salt, Sugar, Ghee, Garam Masala Powder",20,45,30,75,4,Bengali Recipes,Dinner,Vegetarian
Creme Caramel Flan Recipe (Caramel Custard),"Sugar, Water, Milk, Fresh Cream, Caster Sugar, Whole Eggs, Vanilla Extract",7,0,45,45,4,French,Dessert,Eggetarian
Elo Jhelo Nimki Recipe,"All Purpose Flour, Sunflower Oil Cook, Salt, Sugar, Kalonji",5,5,50,55,4,Bengali Recipes,Snack,Vegetarian
Spinach And Tomato Quiche Recipe,"All Purpose Pie Crust, Whole Eggs, Milk, Spinach Leaves, Onion, Garlic, Rosemary, Salt",8,10,35,45,4,French,World Breakfast,Eggetarian
Kerala Style Avial Recipe - Onam Sadya Recipe,"Vellai Poosanikai, Drumstick, Carrots, Green Beans, Raw Banana, Potato, Elephant Yam, Turmeric Powder, Salt, Fresh Coconut  Grated, Green Chilli, Curry Leaves, Cumin Seeds, Coconut Oil, Salt",15,30,45,75,4,Kerala Recipes,Lunch,Vegetarian
Muga Ambat Recipe,"Green Moong Sprouts, Fresh Coconut, Dry Red Chilli, Turmeric Powder, Tamarind Water, Salt, Water, Sunflower Oil, Sunflower Oil, Dry Red Chilli, Mustard Seeds, Onion, Curry Leaves",13,10,40,50,3,Coastal Karnataka,Lunch,High Protein Vegetarian
Chakka Erissery Recipe - Kerala Style Coconut Laced Jackfruit Sabzi,"Jackfruit Ripe, Water, Red Chilli Powder, Turmeric Powder, Black Pepper Powder, Salt, Fresh Coconut, Cumin Seeds, Fresh Coconut, Curry Leaves, Dry Red Chilli, Garlic, Mustard Seeds, Coconut Oil",14,15,15,30,2,Kerala Recipes,Side Dish,Vegetarian
Cold Phyllo Tartlets With Cream Cheese And Dill Toppings Recipe,"Phyllo Tartlet Cups, Few Dill Leaves, Strawberries, Britannia Cream Cheese, Sour Cream, Hung Curd, Salt, Mint Leaves",8,10,15,25,4,Continental,Dinner,Vegetarian
Vepampoo Kara Kuzhambu Recipe (Dried Neem Flower Gravy),"Pearl Onion, Garlic, Turmeric Powder, Sambar Powder, Coriander Powder, Tamarind, Water, Salt, Sesame, Asafoetida, Mustard Seeds, Methi Seeds, Chana Dal, Dry Red Chilli, Sesame, Neem Leaves",16,20,35,55,4,South Indian Recipes,Lunch,Vegetarian
The Best Spicy Spaghetti Bolognese Recipe,"Del Monte Spaghetti Pasta, Beef, Bacon, Onion, Garlic, Carrots, Fresh Red Chilli, Homemade Tomato Puree, Red Wine, Dried Oregano, Basil Leaves, Salt, Black Pepper Powder, Parmesan Cheese, Extra Virgin Olive Oil",15,10,45,55,4,Italian Recipes,Dinner,Non Vegeterian
Banana And Cranberry Bran Muffins Recipe,"Instant Oats, Milk, Ripe Bananas, Vanilla Extract, Whole Wheat Flour All Purpose Flour, Baking Powder, Baking Soda, Cinnamon Powder, Cranberries, Salt, Butter, Honey, Maple Syrup",13,20,35,55,3,Continental,World Breakfast,Diabetic Friendly
Tandoori Chickpea & Cauliflower Curry Recipe (Vegan Curry),"Cauliflower, Kabuli Chana, Homemade Tomato Puree, Garlic, Fennel Seeds, Turmeric Powder, Kashmiri Red Chilli Powder, Garam Masala Powder, Chaat Masala Powder, Salt, Mint Leaves, Coal, Sunflower Oil",13,15,45,60,4,Indian,Dinner,Vegan
Oats Yogurt Parfait With Fruits Recipe,"Hung Curd, Instant Oats, Vanilla Extract, Honey, Water, Wheat Flakes, Fresh Fruits",7,10,10,20,2,Continental,World Breakfast,Vegetarian
Indo Japanese Rice Cakes Recipe,"Cooked Rice, Yellow Bell Pepper, Onion, Salt, Black Pepper Powder, Soy Sauce, All Purpose Flour, Corn Flour, Sunflower Oil, Corn Flour, Brown Sugar, Soy Sauce, Water, Green Chilli",14,15,20,35,6,Japanese,Appetizer,Vegetarian
Cauliflower Rice and Lentil Curry Recipe,"Cauliflower, Tofu, Sunflower Oil, Mustard Seeds, Cumin Seeds, Cinnamon Stick, Turmeric Powder, Curry Leaves, Coriander, Masoor Dal, Coconut Milk, Curry Powder, Onion, Tomato, Ginger Garlic Paste, Garam Masala Powder, Red Chilli Powder, Turmeric Powder, Salt, Sunflower Oil, Coriander",21,10,40,50,4,Indian,Lunch,Vegetarian
Healthy Vegetable Paratha Rolls Recipe,"Tawa Paratha, Onion, Cabbage, Carrot, Green Peas, Potato, Green Bell Pepper, Tomato, Ginger, Green Chilli, Coriander, Sunflower Oil, Cumin Seeds, Salt, Garam Masala Powder",15,10,30,40,4,North Indian Recipes,Snack,Vegetarian
Vegetarian Malai Kebab Recipe,"Paneer, Potato, Milk Powder, Ginger, Green Chilli, Onion, Garam Masala Powder, Chaat Masala Powder, Coriander, Rice Flour, Salt, Sunflower Oil",12,25,10,35,6,North Indian Recipes,Snack,Vegetarian
Persian Eggplant Stew Recipe (Khoresht Bademjan),"Brinjal, Onion, Tomato, Garlic, Turmeric Powder, Red Chilli Powder, Cumin Powder, Cinnamon Powder, Black Pepper Powder, Water, Sunflower Oil, Salt",12,15,40,55,4,Parsi Recipes,Dinner,Vegetarian
Moong Dal Ladoo Recipe,"Yellow Moong Dal, Caster Sugar, Ghee, Cardamom Powder, Whole Cashews, Badam, Pistachios",7,10,10,20,10,South Indian Recipes,Dessert,Vegetarian
Adzuki Bean Paste Recipe (Red Bean Paste Recipe),"Black Beans, Sesame, Soy Sauce, Vinegar, Sugar, Salt",6,500,45,545,10,Chinese,Dessert,Vegetarian
Paneer Pav Bhaji Recipe - Wholesome Weeknight Dinner,"Butter, Onion, Garlic, Green Bell Pepper, Homemade Tomato Puree, Potato, Cauliflower, Carrots, Pav Bhaji Masala, Chaat Masala Powder, Paneer, Lemon, Salt, Pav Buns, Butter, Coriander, Onion, Lemon",18,20,30,50,4,North Indian Recipes,Dinner,High Protein Vegetarian
Andhra Style Beetroot Vepudu Recipe (Stir Fried Beetroot),"Beetroot, Sunflower Oil, Chana Dal, White Urad Dal, Cumin Seeds, Salt, Curry Leaves, Dry Red Chilli",8,10,20,30,4,Andhra,Lunch,Vegetarian
Iyengar Style Whole Wheat & Oats Khara Biscuit Recipe (Savory Cookie Recipe),"Whole Wheat Flour, Instant Oats, Butter, Salt, Sugar, Coriander, Curry Leaves, Whole Black Pepper Corns, Green Chilli, Milk",10,10,35,45,4,Tamil Nadu,Snack,Vegetarian
Eggless Date & Walnut Oatmeal Cake Recipe,"All Purpose Flour, Baking Powder, Salt, Brown Sugar, Nutralite Classic Spread, Rolled Oats, Hot Water, Dates, Walnuts, Flax Seed Powder, Chilled Water",11,19,70,89,6,Continental,Snack,Vegetarian
Muesli Pumpkin Bread Recipe,"All Purpose Flour, Whole Wheat Flour, Muesli, Instant Oats, Baking Powder, Cinnamon Powder, Dry Ginger Powder, Cinnamon Powder, Salt, Kaddu, Jaggery, Extra Virgin Olive Oil, Whole Eggs, Milk, Vanilla Extract",15,20,45,65,4,Continental,Snack,Eggetarian
Baby Corn & Tomato Masala Bath-Rice Spiced With Pav Bhaji Masala,"Baby Corn  Sliced, Sunflower Oil, Cumin Seeds, Ginger, Garlic, Onion, Tomato, Pav Bhaji Masala, Garam Masala Powder, Cumin Powder, Salt, Cooked Rice  Cooled Completely, Lemon Juice, Coriander",14,10,20,30,2,North Indian Recipes,Lunch,Vegetarian
Prawn Ghee Pepper Masala Recipe With Garlic,"Prawns  Cleaned & Deveined, Ghee, Curry Leaves, Garlic, Whole Black Peppercorns, Onion, Dabur Homemade Tamarind Paste, Jaggery, Dry Red Chilli, Whole Black Peppercorns, Cumin Seeds, Fennel Seeds, Star Anise, Curry Leaves",14,5,20,25,3,South Indian Recipes,Appetizer,Non Vegeterian
Ada Pradhaman Recipe - Kerala Style Rice Ada Pudding With Jaggery & Coconut Milk,"Rice Ada, Jaggery, Water, Coconut Milk, Coconut Milk, Cashew Nuts, Raisins, Fresh Coconut, Cardamom Powder, Ghee",10,10,60,70,4,Kerala Recipes,Dessert,Vegetarian
"Creamy Cabbage, Sweet Corn Cole Slaw with Hung Curd Recipe","Cabbage, Sweet Corn, Spring Onion Greens, Hung Curd, Black Pepper Powder, Dried Oregano, Red Chilli Flakes, Salt",8,15,0,15,4,Continental,Appetizer,Vegetarian
Mamsaam Chops Recipe (Lamb Chops in Black Pepper Gravy),"Lamb, Turmeric Powder, Red Chilli Powder, Salt, Sunflower Oil, Ghee, Cloves, Cardamom, Cinnamon Stick, Onion, Coriander Powder, Whole Black Peppercorns, Ginger, Garlic, Green Chilli, Dry Red Chilli",16,10,45,55,4,Indian,Dinner,Non Vegeterian
Karnataka Style Kadle Kaalu Saru Recipe (Black Chickpea Curry Recipe),"Kala Chana, Jaggery, Sambar Powder, Red Chilli Powder, Salt, Coriander, Onion, Garlic, Curry Leaves, Fresh Coconut, Tomato, Onion, Mustard Seeds, Cumin Seeds, Curry Leaves",15,500,30,530,4,South Karnataka,Main Course,High Protein Vegetarian
Satsaagi Recipe - Sindhi Seven Vegetable Sabzi No Onion No Garlic,"Carrot, Green Beans, Colocasia Root, Green Peas, Potato, Bottle Gourd, Green Bell Pepper, Sunflower Oil Fry, Ghee, Cumin Seeds, Asafoetida, Green Chilli, Ginger, Turmeric Powder, Red Chilli Powder, Cumin Powder, Amchur, Garam Masala Powder, Coriander, Homemade Tomato Puree, Coriander, Mint Leaves",22,20,30,50,4,Sindhi,Side Dish,Vegetarian
Baked Eggplant Stuffed with Red Lentil Hummus Recipe,"Brinjal, Salt And Pepper, Extra Virgin Olive Oil, Parmesan Cheese, Mint Leaves, Carrot, Masoor Dal, Garlic, Cumin Seeds, Lemon, Salt, Extra Virgin Olive Oil, Onion, Garlic, Butter, Walnuts, Badam, Red Chilli Flakes, Dried Oregano, Paprika Powder, Sugar, Salt, Hung Curd, Garlic, Lemon Juice",25,20,45,65,4,Middle Eastern,Appetizer,Vegetarian
Lebanese Style Riz B Haleeb Recipe - Rice Pudding With Pistachios,"Rice  Soaked For  Hours, Milk, Sugar, Corn Flour, Orange Blossom Water, Pistachios",6,5,45,50,4,Middle Eastern,Dessert,Vegetarian
Homemade Macaroni And Cheese Recipe,"Milk  Whole Milk, Butter, Whole Wheat Flour, Salt, Elbow Pasta, Cheddar Cheese, Salt Cook Pasta, Salt Cook Pasta",8,15,15,30,4,Italian Recipes,Dinner,Vegetarian
Ragi Or Finger Millet Powder/ Malt Recipe for Babies 6 Months & Above,Sprouted Ragi,1,840,10,850,10,Indian,High Protein Vegetarian,Vegetarian
Sri Lankan Style Fried Egg Curry Recipe,"Whole Egg, Curry Leaves, Onion, Tomato, Ginger, Garlic, Cinnamon Stick, Cloves, Cardamom, Red Chilli Flakes, Fennel Seeds, Coriander Powder, Garam Masala Powder, Coconut Milk, Salt",15,10,30,40,4,Sri Lankan,Lunch,Eggetarian
Pull Apart Mini Pizza Boats Recipe,"Active Dry Yeast, Sugar, Lukewarm Water, Whole Wheat Flour, Salt, Italian Seasoning, Extra Virgin Olive Oil, Tomato, Onion, Pickled Jalapenos Green Chilli, Garlic, Homemade Tomato Puree, Salt, Sugar, Dried Oregano, Italian Seasoning, Green Bell Pepper, Button Mushrooms, Green Chilli, Clove Garlic, Dried Oregano, Red Bell Pepper, Salt, Extra Virgin Olive Oil, Mozzarella Cheese",25,60,40,100,6,Italian Recipes,Appetizer,Vegetarian
Roasted Beet & Walnut Dip Recipe,"Beetroot, Clove Garlic, Spring Onion, Extra Virgin Olive Oil, Whole Black Peppercorns, Walnuts, Cumin Powder, Salt, Lemon Juice, Coriander",10,10,40,50,4,Continental,Side Dish,Vegetarian
Peanut Kesar Burfi Recipe,"Raw Peanuts, Sugar, Milk Powder, Saffron Strands, Yellow Food Colour, Butter, Milk, Cardamom, Pistachios",9,10,30,40,3,North Indian Recipes,Dessert,Vegetarian
South Indian Vazhakkai Puli Kootu Recipe (Plantain In Tamarind Based Curry),"Raw Banana, Shallots, Tomato, Tamarind Paste, Sambar Powder, Jaggery, Methi Seeds, Mustard Seeds, Asafoetida, Curry Leaves, Dry Red Chilli, Sesame, Chana Dal, Cumin Seeds, Fennel Seeds, Fresh Coconut",16,10,15,25,4,South Indian Recipes,Side Dish,Diabetic Friendly
Banana Stem Thoran Recipe - Ayurvedic No Onion No Garlic Recipe,"Banana Stem, Fresh Coconut, Green Chilli, Curry Leaves, Salt, Coconut Oil, Mustard Seeds, White Urad Dal, Curry Leaves",9,20,20,40,4,Kerala Recipes,Lunch,No Onion No Garlic (Sattvic)
Three Bean Salad Recipe,"Rajma, Kabuli Chana, Black Eyed Beans, Red Onion, Tomato, Cucumber, Green Bell Pepper, Coriander, Red Chilli Powder, Extra Virgin Olive Oil, Lemon Juice, Cumin Powder, Chaat Masala Powder, Salt",14,10,20,30,4,Mexican,Dinner,High Protein Vegetarian
Spinach And Sweet Potato Kofta In Green Curry Recipe,"Sweet Potato, Spinach, Gram Flour, Onion, Garlic, Dried Thyme Leaves, Dried Oregano, Red Chilli Flakes, Black Pepper Powder, Lemon Juice, Salt, Sunflower Oil, Coriander, Mint Leaves, Garlic, Black Pepper Powder, Cumin Powder, Red Chilli Flakes, Dried Oregano, Salt, Coconut Milk",21,20,30,50,4,Continental,Lunch,Vegetarian
Chettinad Vegetable Pulav Recipe -,"Rice, Pearl Onion, Garlic, Ginger, Green Chilli, Bay Leaves, Cloves, Cardamom, Red Chilli Powder, Turmeric Powder, Coriander Powder, Carrot, Green Beans, Potato, Figaro Pure Olive Oil, Coriander, Salt, Green Peas, Green Peas, Mint Leaves",20,15,45,60,4,Chettinad,Dinner,Vegetarian
Eggless Ragi & Whole Wheat Crisp Biscuits Recipe,"Ragi Flour, Whole Wheat Flour, Butter, Sugar, Baking Powder, Milk Knead The Dough",6,50,30,80,5,Continental,Snack,Vegetarian
Cheesy Grilled Sandwich With Smoked Chicken Recipe,"Green Chutney, Whole Wheat Brown Bread, Cheese Slices, Butter, Curd, Ginger, Garlic, Lemon Juice, Garam Masala Powder, Kashmiri Red Chilli Powder, Salt, Coriander Powder, Mustard Oil, Chicken Breasts, Mustard Oil, Ghee, Charcoal",17,250,8,258,2,Fusion,Snack,Non Vegeterian
Papad Parathas Recipe,"Whole Wheat Flour  Kneadeddough, Papad, Onion, Coriander, Red Chilli Powder, Garam Masala Powder, Chaat Masala Powder, Salt, Sunflower Oil",9,20,20,40,4,Indian,Lunch,Vegetarian
Methi Bajra Poori Recipe,"Bajra Flour, Whole Wheat Flour, Methi Leaves, Garlic, Red Chilli Powder Green Chilli Paste, Sesame Seeds, Fennel Seeds, Coriander Powder, Cumin Powder, Amchur, Sunflower Oil, Turmeric Powder, Salt, Sunflower Oil",14,10,60,70,2,Indian,Lunch,Vegetarian
Healthy Spicy Banana Cake Recipe,"Whole Wheat Flour, Baking Powder, Baking Soda, Salt, Cinnamon Powder, Nutmeg Powder, Brown Sugar, Canola Oil, Curd, Ripe Bananas, Chia Seeds, Vanilla Extract, Sunflower Seeds, Walnuts",14,10,35,45,6,Continental,Snack,Vegetarian
Fenugreek Spiced Sardine Fish Curry Recipe,"Sardine Fish, Gingelly Oil Sunflower Oilcook, Methi Seeds, Onion  Finely, Onion  Coarsely, Tomato, Garlic, Curry Leaves, Whole Black Peppercorns, Dry Red Chilli, Red Chilli Powder, Coriander, Turmeric Powder, Tamarind Paste, Cumin Seeds, Fresh Coconut, Salt",17,10,25,35,3,Indian,Side Dish,High Protein Non Vegetarian
Whole Wheat Fruit and Nut Cup Cake Recipe,"Whole Wheat Flour, Baking Powder, Baking Soda, Cinnamon Powder, Cardamom, Jaggery, Milk, Sunflower Oil, Vanilla Extract, Badam, Cashew Nuts, Apricots",12,10,35,45,4,Continental,Snack,Sugar Free Diet
Karela Bajji Recipe - Pavakkai Bajji Recipe | Bittergourd,"Karela, Gram Flour, Garlic, Ajwain, Turmeric Powder, Red Chilli Powder, Asafoetida, Salt",8,10,10,20,4,Indian,Appetizer,Vegetarian
Jowar Dhani Chivda Recipe,"Jowar Seeds, Papads, Raw Peanuts, Curry Leaves, Dry Red Chilli, Turmeric Powder, Sunflower Oil, Salt",8,20,20,40,5,South Indian Recipes,Snack,Vegetarian
Moroccan Harira Recipe (Thick Soup With Chickpeas & Masoor Dal),"Kabuli Chana, Masoor Dal, Carrot, Onion, Coriander, Garlic, Salt, Black Pepper Powder, Cumin Powder, Coriander Powder, Turmeric Powder, Cinnamon Powder, Paprika Powder, Mint Leaves, Vegetable Stock Water, Extra Virgin Olive Oil, Coriander, Parsley Leaves, Curd",19,25,60,85,5,African,Appetizer,Vegetarian
Spicy Mixed Vegetables Rice Cutlet Recipe,"Cooked Rice, Potato, Onion, Green Chilli, Carrot, Coriander, Turmeric Powder, Red Chilli Powder, Cumin Powder, Coriander Powder, Garam Masala Powder, Whole Wheat Bread Crumbs, Salt, All Purpose Flour, Water, Sunflower Oil",16,20,15,35,5,Indian,Snack,Vegetarian
Upside Down Pear Ginger Cake Recipe,"Whole Wheat Flour, Almond Meal, Extra Virgin Olive Oil, Curd, Caster Sugar, Honey, Ginger, Baking Powder, Pears, Lemon Juice, Butter, Honey, Caster Sugar, Ginger",14,10,30,40,8,Continental,Dessert,Eggetarian
Ande Ka Salan Recipe - Tangy Egg Masala in Peanut Gravy,"Whole Eggs, Cup Fresh Coconut, Peanuts, Sesame Seeds, Water, Mustard Seeds, Cumin Seeds, Methi Seeds, Curry Leaves, Onion, Ginger, Garlic, Green Chilli, Homemade Tomato Puree, Turmeric Powder, Red Chilli Powder, Coriander, Tamarind Water, Sunflower Oil, Coriander",20,15,30,45,4,North Indian Recipes,Lunch,Eggetarian
Oats Omelette Recipe,"Instant Oats, Whole Eggs, Onion, Tomato, Green Bell Pepper, Green Chilli, Red Chilli Powder, Milk, Sunflower Oil, Salt And Pepper",10,5,10,15,1,Continental,World Breakfast,Eggetarian
Southern Style Fried Chicken Recipe,"Chicken Wings, Buttermilk Milk, Black Pepper Powder, Paprika Powder, Salt, All Purpose Flour, Baking Powder, Garlic Powder, Red Chilli Powder, Black Pepper Powder, Rosemary, Salt, Whole Eggs, Salt, All Purpose Flour, Sunflower Oil",16,100,20,120,4,American,Side Dish,High Protein Non Vegetarian
Tawa Idli Recipe,"Idli, Onion, Tablespoon Butter, Salt, Garam Masala Powder, Garam Masala Powder, Pav Bhaji Masala, Lemon, Coriander",9,10,15,25,4,Indian,Snack,Vegetarian
Egg And Harissa Sandwich Recipe,"Whole Wheat Brown Bread, Tomato, Lettuce Leaves, Onion, Veeba Harissa Sauce, Butter, Whole Eggs, Salt And Pepper",8,10,15,25,2,Fusion,Snack,Eggetarian
Chaas Dahi Vada Recipe - Dahi Vada in Refreshing Buttermilk,"White Urad Dal, Salt, Green Chilli, Figaro Pure Olive Oil, Curd, Water, Mint Leaves, Chaat Masala Powder, Green Chilli, Cumin Seeds, Sugar, Salt",12,30,30,60,6,North Indian Recipes,Snack,Vegetarian
Chingiri Paturi Recipe,"Prawns, Poppy Seeds, Mustard Seeds, Fresh Coconut, Green Chilli, Salt, Mustard Oil, Lemon Juice, Banana Leaf",9,10,35,45,4,Bengali Recipes,Lunch,Non Vegeterian
Cajun Style Potatoes Recipe,"Potato, Extra Virgin Olive Oil, Salt, Garlic Powder, Onion Powder, Paprika Powder, Black Pepper Powder, Dried Thyme Leaves, Dried Oregano, Salt, Onion, Coriander",12,20,60,80,4,Caribbean,Appetizer,Vegetarian
Ragi Pachchai Maa Puli Upma Recipe - Ragi Flour Upma Recipe,"Ragi Flour, Curd, Salt, Mustard Seeds, White Urad Dal, Asafoetida, Green Chilli, Ginger, Curry Leaves, Ghee, Curry Leaves, Sunflower Oil",12,10,15,25,2,South Indian Recipes,Indian Breakfast,Diabetic Friendly
Raw Banana Chivda Recipe,"Raw Banana, Raw Peanuts, Curry Leaves, Green Chilli, Raisins, Cashew Nuts, Badam, Red Chilli Powder, Caster Sugar, Chaat Masala Powder, Salt, Sunflower Oil",12,10,35,45,3,Indian,Snack,Vegetarian
Shahi Tukda Gajar Halwa Shots With Rabri Recipe,"Milk, Sugar, Cardamom Powder, Saffron Strands, Pistachios, Whole Wheat Brown Bread, Ghee, Sugar, Water, Rose Water, Pistachios Garnish, Carrots, Ghee, Milk, Khoya, Sugar, Cardamom Powder, Ghee, Slivered Almonds, Pistachios",20,120,10,130,6,Indian,Dessert,Vegetarian
Bhatt Ki Dal Recipe - Traditional Kumaoni Black Bean Dal,"Black Beans, Onion, Garlic, Cumin Seeds, Whole Wheat Flour, Turmeric Powder, Red Chilli Powder, Coriander Powder, Garam Masala Powder, Salt, Sunflower Oil, Ghee",12,10,25,35,4,North Indian Recipes,Lunch,Vegetarian
Matar Pudina Oat & Broken Wheat Tikki Recipe,"Green Peas, Sweet Potato, Paneer, Rolled Oats Or Instant Oats, Ginger, Green Chilli, Onion, Chaat Masala Powder, Mint Leaves, Sunflower Oil, Salt",11,10,25,35,4,Indian,Snack,Vegetarian
Black Forest Cake Recipe,"All Purpose Flour, Baking Powder, Cocoa Powder, Sugar, Butter, Whole Eggs, Vanilla Extract, Hung Curd, Heavy Whipping Cream, Icing Sugar, Cherry Compote, Canned Cherries, Dark Chocolate, Chocolate Shavings, Dark Chocolate Chips, Chocolate Chips, Dark Chocolate Milk Chocolate",17,60,200,260,8,Continental,Dessert,Eggetarian
Sukhi Dahi Wali Lauki Recipe - Yogurt Based Bottle Gourd Sabzi,"Bottle Gourd, Cumin Seeds, Mustard Seeds, Curry Leaves, Green Chilli, Garlic, Onion, Tomato, Curd, Red Chilli Powder, Turmeric Powder, Coriander Powder, Salt, Water, Sunflower Oil",15,15,30,45,4,North Indian Recipes,Lunch,Diabetic Friendly
Chicken Pakora Recipe - Chicken Fritters,"Chicken, Gram Flour, Onion, Cumin Seeds, Turmeric Powder, Red Chilli Powder, Coriander, Salt, Sunflower Oil, Water, Chaat Masala Powder, Pickled Onion",12,10,25,35,4,Indian,Snack,High Protein Non Vegetarian
Roasted Vegetables With Tahini Sauce Recipe,"Large Carrot, Green Zucchini, Brinjal, Broccoli, Onion, Red Bell Pepper, Extra Virgin Olive Oil, Tahini, Lemon Juice, Clove Garlic, Walnuts, Za'Atar, Parsley Leaves, Salt",14,15,35,50,4,Greek,Side Dish,Vegetarian
Karnataka Style Ellu Bella Recipe (Sankrati Mix Recipe),"Roasted Gram Dal, Raw Peanuts, Dry Coconut, Jaggery, Sesame Seeds",5,45,0,45,4,Karnataka,Snack,Vegetarian
Peanut Curry Recipe,"Raw Peanuts, Fresh Coconut, Green Chilli, Red Chilli Powder, Jaggery, Cloves, Kokum, Curry Leaves, Ghee, Cumin Seeds, Water, Salt",12,15,20,35,4,Indian,Lunch,High Protein Vegetarian
Savory Tart Recipe with Grape and Gouda Cheese,"Recipe All Purpose Pie Crust, Gouda Cheese, Mozzarella Cheese, Tomato, Green Seedless Grapes, Black Olives, Tomato Basil Pasta Sauce, Mixed Herbs, Red Chilli Flakes, Salt, Black Pepper Powder",11,10,60,70,3,Italian Recipes,Appetizer,Vegetarian
Healthy Tomato Carrot Onion Soup Recipe,"Sunflower Oil, Tomato, Onion, Carrot, Garlic, Salt, Whole Black Peppercorns, Sugar",8,10,20,30,3,Indian,Dinner,Vegetarian
Biryani Masala Powder Recipe,"Bay Leaves, Coriander, Whole Black Peppercorns, Ajwain, Cumin Seeds, Cardamom, Black Cardamom, Mace, Stone Flower, Star Anise, Nutmeg Powder, Cinnamon Stick, Cloves",13,5,5,10,4,Hyderabadi,Side Dish,Vegetarian
Italian Pasta Sizzler Recipe,"Pasta, Extra Virgin Olive Oil, Garlic, Tomato, Water, Corn Flour, Basil Leaves, Italian Seasoning, Red Chilli Flakes, Mozzarella Cheese, Salt, Whole Wheat Brown Bread, Butter, Garlic, Mozzarella Cheese, Red Chilli Flakes, Italian Seasoning, Potato, Onion, Carrot, Tomato, Cauliflower, Sweet Corn, Green Beans, Red Yellow And Green Bell Peppers, Sunflower Oil, Black Pepper Powder, Salt, Cabbage, Butter",30,15,45,60,3,Italian Recipes,Dinner,Vegetarian
Whole Wheat Sonth Ke Ladoo Recipe,"Whole Wheat Flour, Dry Ginger Powder, Jaggery, Gond, Dry Coconut, Mixed Nuts, Ghee",7,10,30,40,10,North Indian Recipes,Snack,Vegetarian
Crispy Lavash Recipe | Lebanese Bread (Eggless),"All Purpose Flour, Red Chilli Flakes, Dried Oregano, Extra Virgin Olive Oil, Salt, Lukewarm Water, Sesame Seeds, Black Sesame Seeds",8,30,12,42,10,Mediterranean,Dinner,Vegetarian
Quick & Easy Creamy Fruit Trifle Recipe,"Hung Curd, Fresh Cream, Sugar, Strawberry Compote, Marie Biscuit",5,20,300,320,4,British,Dinner,Vegetarian
Chilli Chicken Recipe - Delicious Indian Style Chinese Chicken,"Chicken Breasts, Egg White, Red Chilli Sauce, Corn Flour, Soy Sauce, Tomato Ketchup, White Vinegar, Sunflower Oil, Ginger Garlic Paste, Onion, Green Bell Pepper, Green Chilli, Salt, Water, Sunflower Oil, Coriander, Spring Onion",17,10,100,110,2,Chinese,Appetizer,Non Vegeterian
Bacon Quiche Tart Recipe,"Butter, All Purpose Flour, Salt, Lemon Juice, Whole Egg, Butter, Onion, Bacon Strips, Garlic, Whole Eggs, Egg Yolks, Fresh Cream, Cheese, Parsley Leaves, Black Pepper Powder, Salt",16,10,90,100,4,French,World Breakfast,Non Vegeterian
Aloo Bonda Recipe (Deep Fried Snack With Potato Filling),"Potato, Mustard Seeds, Cumin Seeds, Curry Leaves, Turmeric Powder, Green Chilli, Sunflower Oil, Ginger, Asafoetida, Coriander, Lemon Juice, Gram Flour, Rice Flour, Ajwain, Turmeric Powder, Red Chilli Powder, Sunflower Oil, Asafoetida, Salt, Water, Sunflower Oil",21,10,45,55,2,Bengali Recipes,Snack,Vegetarian
Rajasthani Gunde Ka Achaar Recipe (Bird Lime Pickle),"Gunde, Asafoetida, Split Methi Seeds, Split Mustard Seeds, Fennel Seeds, Turmeric Powder, Red Chilli Powder, Mustard Oil, Salt",9,20,25,45,500,Rajasthani,Appetizer,Vegetarian
Spicy Goan Style Mushrooms Recipe,"Button Mushrooms, Sunflower Oil, Sooji, Rice Flour, Garlic, Turmeric Powder, Red Chilli Powder, Salt",8,10,30,40,4,Goan Recipes,Lunch,Vegetarian
Baked Whole Wheat Salsa Tart Recipe,"Whole Wheat Flour, Butter   Into  Cubes, Salt, Chilled Water, Spring Onion, Red Bell Pepper, Tomato, Onion, Green Chilli, Cumin Powder, Tabasco Original  Hot Sauce  Adjustable, Extra Virgin Olive Oil, Mozzarella Cheese, Salt",14,10,45,55,4,French,Snack,Vegetarian
Dal Kabila Recipe - Diabetic Urad Dal Tadka,"Ghee, White Urad Dal, Cinnamon Stick, Cloves, Dry Red Chilli, Onion, Garlic, Ginger, Tomato, Green Chilli, Red Chilli Powder, Coriander Powder, Turmeric Powder, Garam Masala Powder, Coriander, Water, Ghee, Cumin Seeds, Black Pepper Corns",19,10,20,30,4,North Indian Recipes,Lunch,Diabetic Friendly
Thumbprint Salted Caramel Chocolate Cookies Recipe,"Vivatta Maida, Cocoa Powder, Baking Soda, Salt, Butter, Brown Sugar, Whole Egg, Vanilla Extract, Chocolate Chips, Salt, Condensed Milk",11,15,12,27,4,Continental,Snack,Vegetarian
Olive Oil & Cranberry Cookies Recipe,"Vivatta Maida, Whole Wheat Flour, Baking Powder, Sugar, Salt, Milk, Extra Virgin Olive Oil, Cranberries",8,10,30,40,4,Continental,Dessert,Vegetarian
Green Beans And Scrambled Egg Recipe,"Whole Eggs, Green Beans, Cumin Seeds, Turmeric Powder, Black Pepper Powder, Green Chilli, Salt, Sunflower Oil",8,10,25,35,4,North Indian Recipes,North Indian Breakfast,No Onion No Garlic (Sattvic)
Mirchi And Aloo Curry Recipe - Long Green Chilli And Potato Curry,"Badi Hari Mirch, Potato, Bay Leaf, Cardamom, Cinnamon Stick, Cumin Seeds, Red Chilli Powder, Coriander Powder, Garam Masala Powder, Turmeric Powder, Salt, Onion, Tomato, Cloves, Green Chilli, Dill Leaves",16,10,30,40,4,North Indian Recipes,Lunch,Vegetarian
Bardoli Ki Khichdi Recipe,"Rice, Arhar Dal, Potato, Green Peas, Mango, Onion, Ginger, Green Chilli, Turmeric Powder, Red Chilli Powder, Cumin Seeds, Asafoetida, Ghee, Coriander, Salt",15,30,20,50,4,Gujarati Recipesï»¿,Main Course,High Protein Vegetarian
Chocolate Pancakes With Banana Recipe,"All Purpose Flour, Cocoa Powder, Salt, Milk, Buttermilk, Vanilla Extract, Butter, Caster Sugar, Cooking Soda, Baking Powder, Chocolate Sauce, Ripe Bananas, Butter",13,5,20,25,4,Continental,World Breakfast,Vegetarian
Stuffed Makai Paratha Recipe (Corn & Coriander Stuffed Flat Bread),"Whole Wheat Flour, Salt, Sunflower Oil, Sweet Corn, Green Chilli, Coriander, Cumin Powder, Salt",8,20,40,60,4,North Indian Recipes,Dinner,Diabetic Friendly
Kanji Recipe - Probiotic Drink Made From Carrots & Beetroot,"Purple Carrots, Beetroot, Mustard Powder, Red Chilli Powder, Water, Salt",6,0,5,5,1,North Indian Recipes,Snack,Vegetarian
Shahi Egg Curry Recipe In Tomato & Cashew Gravy,"Whole Eggs, Homemade Tomato Puree, Onion, Garlic, Ginger, Bay Leaf, Turmeric Powder, Red Chilli Powder, Garam Masala Powder, Kasuri Methi, Cashew Nuts, Figaro Pure Olive Oil, Salt",13,30,60,90,4,North Indian Recipes,Dinner,Eggetarian
Mooli Makki Roti Recipe,"Mooli Mullangi, Corn Flour, Green Moong Sprouts, Spring Onion, Coriander, Green Chilli, Ginger, Salt, Sunflower Oil, Green Chutney, Avocado, Spinach Leaves, Red Bell Pepper, Purple Cabbage, Mooli Mullangi",15,25,30,55,6,Indian,Indian Breakfast,Vegetarian
Pineapple Chicken Curry Recipe,"Chicken Breasts, Pineapple, Thai Yellow Curry Paste, Onion, Garlic, Ginger, Coconut Milk, Basil Leaves, Salt, Sugar, Nutralite Garlic & Oregano Spread",11,5,20,25,4,Thai,Lunch,Non Vegeterian
Kashmir Style Bom Chount/Wangan Recipe-Spicy Apple Brinjal Curry,"Brinjal, Apple, Red Chilli Powder, Fennel Powder, Salt, Garam Masala Powder, Cumin Seeds, Sunflower Oil",8,10,30,40,4,Kashmiri,Lunch,Vegetarian
Watermelon Pizza Recipe,"Watermelon, Onion, Feta Cheese, Basil Leaves, Black Olives, Balsamic Vinegar, Honey, Salt, Parsley Leaves",9,10,5,15,2,Continental,Snack,Vegetarian
Menthya Dose (Dosa Recipe With Methi Leaves),"Rice, Chana Dal, White Urad Dal, Fresh Coconut, Methi Leaves, Jaggery, Coriander, Dry Red Chilli, Cumin Seeds, Tamarind, Salt, Water As Needed, Sunflower Oil Butter As Neededmake Dosa",13,280,5,285,4,South Indian Recipes,South Indian Breakfast,Vegetarian
Vermicelli & Oats Kheer Recipe,"Instant Oats, Semiya, Milk, Raisins, Cashew Nuts, Sugar, Cardamom Powder, Ghee",8,10,30,40,3,Indian,Dessert,Vegetarian
Pyaz Kachori Chaat Recipe,"All Purpose Flour, Ghee, Salt, Water, Onion, Potato, Asafoetida, Fennel Seeds, Coriander, Turmeric Powder, Red Chilli Powder, Amchur, Garam Masala Powder, Coriander, Salt, Mustard Oil, Curd, Cumin Powder, Salt, Sugar, Green Chutney, Sweet Chutney, Sev, Onion, Coriander",25,30,20,50,6,North Indian Recipes,Snack,Vegetarian
Dahi Wale Tinda Ki Sabzi Recipe - Apple Gourd in Yogurt Curry,"Tinda, Mustard Oil, Mustard Seeds, Methi Seeds, Green Chilli, Asafoetida, Turmeric Powder, Salt, Curd, Gram Flour, Coriander, Garam Masala Powder, Red Chilli Powder, Kasuri Methi, Coriander",15,10,20,30,4,North Indian Recipes,Lunch,Vegetarian
Bharli Vangi Recipe - Maharashtrian Style Stuffed Brinjals,"Brinjal, Sunflower Oil, Cumin Seeds, Mustard Seeds, Curry Leaves, Onion, Green Chilli, Garam Masala Powder, Salt, Coriander, Raw Peanuts, Tomato, Garlic, Ginger, Jaggery, Red Chilli Powder, Turmeric Powder",17,10,30,40,4,Maharashtrian Recipes,Lunch,Vegetarian
Vazhakkai Podimas Recipe (Ayurvedic Recipe With No Onion No Garlic),"Raw Banana, Sesame, Mustard Seeds, White Urad Dal, Asafoetida, Turmeric Powder, Curry Leaves, Salt, Lemon Juice",9,10,25,35,4,South Indian Recipes,Lunch,Vegetarian
Fresh Figs Ice Cream Recipe,"Fresh Figs, Fresh Cream, Caster Sugar, Vanilla Extract, Milk, Lemon Juice, Water, Dates, Tutti Frutti",9,15,30,45,6,Continental,Dessert,Vegetarian
Assamese Bilahi Boror Tenga Recipe (Sour Curry With Red Lentil Fritters),"Pink Masoor Dal, Turmeric Powder, Salt, Kokum, Canola Oil Pan Fry Masoor Dal Fritters, Sugar, Bay Leaf, Panch Phoran Masala, Dry Red Chilli, Mustard Oil, Whole Wheat Flour, Onion, Tomato, Red Chilli Powder",14,30,40,70,3,Assamese,Side Dish,High Protein Vegetarian
Moong Dal Karara Recipe,"Yellow Moong Dal, Green Chilli, Ginger, Coriander, Salt, Enos Fruit Salt, Sunflower Oil Fry Pakodas, Asafoetida, Cumin, Cinnamon Stick, Black Cardamom, Ginger, Green Chilli, Curd, Coriander, Red Chilli Powder, Garam Masala Powder, Coriander",18,15,30,45,4,Rajasthani,Lunch,Vegetarian
Potato Puff Pastry Recipe,"Potato, Paneer, Onion, Coriander, Ginger, Red Chilli Powder, Garam Masala Powder, Chaat Masala Powder, Cumin Seeds, Coriander, Green Chilli, Sunflower Oil, Salt, All Purpose Flour, All Purpose Flour, Butter, Chilled Water, White Vinegar Lemon Juice, Salt",19,10,120,130,4,North Indian Recipes,Snack,Vegetarian
Baby Potatoes Pulao Recipe - Aloo Pulao Recipe,"Basmati Rice, Baby Potato, Onion, Tomato, Ginger Garlic Paste, Curd, Red Chilli Powder, Coriander Powder, Garam Masala Powder, Mint Leaves, Coriander, Green Chilli, Star Anise, Bay Leaf, Cloves, Cardamom, Cinnamon Stick, Lemon Juice, Ghee, Salt",20,15,30,45,4,Indian,Lunch,Vegetarian
Rajasthani Kanji Vada Recipe,"Yellow Moong Dal, Green Moong Sprouts, Ginger, Green Chilli, Fennel Seeds, Sunflower Oil, Curry Leaves, Salt, Mustard Seeds, Black Salt, Red Chilli Powder, Asafoetida, Salt",13,25,45,70,4,Rajasthani,Snack,High Protein Vegetarian
Sour Cream Onion Dip Recipe,"Hung Curd, Fresh Cream, Lemon Juice, Stalks Spring Onion, Garlic, Extra Virgin Olive Oil, Salt",7,10,5,15,4,Continental,Side Dish,Vegetarian
Khajur Satori Recipe (Dates Flatbread),"Dates, Dry Coconut, Poppy Seeds, Milk Powder, Cardamom Powder, Whole Wheat Flour, Ghee Butter, Milk, Salt",9,60,20,80,2,Maharashtrian Recipes,Snack,High Protein Vegetarian
Achari Chicken Masala Pasta Recipe,"Nutralite Garlic & Oregano Spread, Garlic, Onion, Dry Red Chilli, Chicken Breasts, Salt, Achari Mayo, Homemade Tomato Puree, Milk, Penne Pasta",10,10,30,40,4,Fusion,Dinner,Non Vegeterian
Mango Pulusu Recipe - Mamidi Pandu Pulusu Recipe,"Mango, Green Chilli, Red Chilli Powder, Mustard Seeds, Methi Seeds, Asafoetida, Curry Leaves, Sunflower Oil, Salt, Tamarind Paste, Coriander",11,15,30,45,4,Andhra,Lunch,Vegetarian
Karwar Style Dali Thoy Recipe - Toor dal Curry,"Arhar Dal, Turmeric Powder, Salt, Ghee, Dry Red Chilli, Mustard Seeds, Asafoetida, Curry Leaves, Coriander",9,5,20,25,3,Coastal Karnataka,Side Dish,High Protein Vegetarian
Spiced Rajma Pulao Recipe,"Rice, Kidney Beans, Garlic, , Bay Leaf, Lentil Sugar, Cardamom, Black Pepper Powder, Ghee, Salt",10,20,45,65,4,Indian,Dinner,Vegetarian
Malaysian Nasi Lemak Rice Recipe,"Rice, Coconut Milk, Water, Salt, Ginger",5,5,20,25,4,Malaysian,Main Course,Vegetarian
Paniyaram Muttai Masala Recipe - Spicy Egg Curry Made In Paniyaram Pan,"Whole Eggs, Green Chilli, Coriander, Black Pepper Powder, Salt, Cumin Seeds, Coriander, Fennel Seeds, Roasted Gram Dal, Dry Red Chilli, Whole Black Peppercorns, Sunflower Oil, Fresh Coconut, Onion, Garlic, Ginger, Tomato, Tamarind Paste, Water, Sunflower Oil, Mustard Seeds, Curry Leaves",22,20,25,45,4,South Indian Recipes,Dinner,Non Vegeterian
Savory Oatmeal Bowl with Cabbage and Green Peas Stir Fry Recipe,"Rolled Oats Or Instant Oats, Water, Cumin Seeds, Mace, Cabbage, Green Peas, Green Chilli, Onion, Turmeric Powder, Black Pepper Powder, Red Chilli Powder, Salt",12,10,20,30,4,World Breakfast,Vegetarian,Non Vegeterian
Tofu & Capsicum Paratha Recipe (Stuffed Tofu Flatbread),"Whole Wheat Flour, Salt, Sunflower Oil, Tofu, Green Bell Pepper, Cumin Powder, Green Chilli, Coriander, Salt",9,20,40,60,3,North Indian Recipes,Lunch,High Protein Vegetarian
Kerala Style Chakka Adai Recipe-Rice Flour and Jackfruit Flatbread,"Rice Flour, Fresh Coconut, Jackfruit Ripe, Sugar, Salt, Cardamom",6,10,25,35,4,Kerala Recipes,Indian Breakfast,Vegetarian
Baby Corn Stew Recipe,"Baby Corn, Carrot, Potato, Onion, Garlic, Ginger, Coconut Milk, Coconut Milk, Cardamom, Cinnamon Stick, Cloves, Salt, Coconut Oil, Turmeric Powder, Black Pepper Powder, Red Chilli Powder, Dry Red Chilli, Curry Leaves, Mustard Seeds",19,10,25,35,4,South Indian Recipes,Dinner,Vegetarian
Spaghetti Stir Fry Recipe,"Spaghetti Pasta, Onion, Carrot, Green Bell Pepper, Cabbage, Black Pepper Powder, Italian Seasoning, Salt, Sunflower Oil, Water",10,5,15,20,2,Fusion,Dinner,Vegetarian
Badami Paneer Masala Recipe -Paneer In Almond Gravy,"Paneer, Badam, Onion, Tomato, Ginger, Garlic, Dry Red Chilli, Coriander Powder, Kashmiri Red Chilli Powder, Garam Masala Powder, Turmeric Powder, Sugar, Bay Leaf, Ghee Oil, Salt",15,10,20,30,4,North Indian Recipes,Side Dish,High Protein Vegetarian
Dahi Wali Singhare Ki Sabzi Recipe,"Singhade, Cumin Seeds, Mustard Seeds, Tomato, Green Chilli, Curd, Gram Flour, Turmeric Powder, Coriander Powder, Black Pepper Powder, Amchur, Salt, Sunflower Oil, Coriander",14,10,30,40,4,North Indian Recipes,Side Dish,No Onion No Garlic (Sattvic)
Paneer Tikka Pulao Recipe,"Basmati Rice, Onion, Green Chilli, Cumin Seeds, Cardamom, Cinnamon Stick, Cloves, Bay Leaf, Turmeric Powder, Garam Masala Powder, Sunflower Oil, Salt, Paneer, Curd, Gram Flour, Red Chilli Powder, Garam Masala Powder, Kasuri Methi, Ginger Garlic Paste, Coconut Oil",20,30,20,50,4,North Indian Recipes,Lunch,Vegetarian
Bharma Baingan Ki Sabzi Recipe - Spicy Stuffed Brinjals,"Small Brinjal, Sunflower Oil, Garlic, Onion, Green Chilli, Ginger, Salt, Cumin Powder, Garam Masala Powder, Amchur, Mint Leaves, Salt",12,10,45,55,3,Rajasthani,Lunch,Vegetarian
No Bake Dragon Fruit Jam Tarts Recipe,"Dates, Digestive Biscuit, Butter, Dragon Fruit, Sugar, Lemon Juice, Strawberries",7,15,30,45,2,French,Dessert,Vegetarian
Spinach Banana Muffin Recipe,"Baby Spinach, Ripe Bananas, Honey, Milk, Extra Virgin Olive Oil, Whole Egg, Vanilla Extract, Whole Wheat Flour, Salt, Baking Powder, Baking Soda, Cinnamon Powder, Mace Powder",13,30,20,50,2,Continental,Snack,Eggetarian
Muhammara Recipe - Roasted Red Bell Pepper & Walnut Dip,"Red Bell Pepper, Walnuts, Cumin Powder, Red Chilli Flakes, Jaggery Pomegranate Mollases, Lemon Juice, Extra Virgin Olive Oil, Whole Wheat Bread Crumbs, Salt",9,5,20,25,6,Middle Eastern,Side Dish,Vegetarian
UP Style Paneer In Mustard Gravy Recipe,"Paneer, Onion, Tomato, Coriander Powder, Cumin Powder, Black Pepper Powder, Turmeric Powder, Cumin Seeds, Mustard Oil, Lemon Juice, Coriander, Salt, Yellow Mustard Seeds, Garlic, Green Chilli",15,10,20,30,4,Uttar Pradesh,Lunch,Vegetarian
Kara Boondi Kurma Recipe - Boondi In Coconut Milk,"Boondi, Onion, Tomato, Green Chilli, Ginger Garlic Paste, Coconut Milk, Coconut Milk, Red Chilli Powder, Coriander Powder, Turmeric Powder, Salt, Bay Leaves, Mustard Seeds, Cloves, Cinnamon Stick, Sunflower Oil, Curry Leaves, Coriander",18,20,20,40,4,Tamil Nadu,Lunch,Vegetarian
Cheesy Pull Apart Bread Recipe,"All Purpose Flour, Active Dry Yeast, Sugar, Salt, Butter, Water, Milk, Butter, Cheddar Cheese, Mozzarella Cheese, Italian Seasoning, Garlic",12,120,30,150,12,Continental,Dinner,Vegetarian
Kashmiri Kulith Ki Dal Recipe - Horse Gram Dal Recipe,"Horse Gram Dal, Green Chilli, Ginger, Garlic, Turmeric Powder, Kashmiri Red Chilli Powder, Salt, Rice Flour, Water, Ghee, Cumin Seeds, Asafoetida, Coriander",13,20,25,45,6,Kashmiri,Main Course,Diabetic Friendly
Kaju Karela Recipe - Bitter Gourd And Cashew Nuts Stir Fry,"Karela, Potato, Cashew Nuts, Dry Red Chilli, Mustard Seeds, Green Chilli, Asafoetida, Red Chilli Powder, Coriander Powder, Cumin Powder, Amchur, Caster Sugar, Sesame Seeds, Dessicated Coconut, Salt, Sunflower Oil Cook",16,15,30,45,2,Gujarati Recipesï»¿,Side Dish,Diabetic Friendly
Carrot Poriyal Recipe - Steamed Carrot Stir Fry,"Carrots, Mustard Seeds, White Urad Dal, Dry Red Chilli, Curry Leaves, Asafoetida, Turmeric Powder, Fresh Coconut, Sunflower Oil, Salt",10,10,30,40,4,South Indian Recipes,Lunch,Vegetarian
Black And Green Grapes Panna Cotta Recipe,"Fresh Cream, Milk, Caster Sugar, Gelatin  Unflavoured, Vanilla Extract, Water, Green Grapes, Caster Sugar, Gelatin  Unflavoured, Green Grapes, Water, Black Grapes, Caster Sugar, Gelatin  Unflavoured, Black Grapes, Water, Green Grapes",17,90,30,120,4,Italian Recipes,Dessert,Non Vegeterian
Palak Gobi Sabzi ,"Spinach, Cabbage, Tomato, Ginger, Cumin Seeds, Turmeric Powder, , Salt, Oil, Coriander",10,10,30,40,4,North Indian Recipes,Lunch,Vegetarian
Punjabi Black Chickpea Curry Recipe - Kale Chane Ki Sabzi,"Kala Chana, Sunflower Oil, Cumin Seeds, Onion, Ginger Garlic Paste, Tomato, Red Chilli Powder, Salt, Garam Masala Powder, Coriander, Water",11,10,30,40,4,Punjabi,Dinner,Vegetarian
Ammini Kozhukattai (Rice Flour Dumplings) Recipe,"Rice Flour, Water, Salt, Sunflower Oil, Mustard Seeds, White Urad Dal, Curry Leaves, Dry Red Chilli, Asafoetida, Fresh Coconut",10,23,30,53,4,South Indian Recipes,Snack,Vegetarian
Tandoori Chicken Curry Recipe,"Kg Chicken, Sunflower Oil, Tomato, Onion, Green Chilli, Tablespoon Ginger Garlic Paste, Coriander, Tablespoon Curd, Tablespoon Fresh Cream, Cup Water, Salt, Cloves, Whole Black Peppercorns, Bay Leaves, Cinnamon Stick, Fennel Seeds, Kasuri Methi, Tablespoons Kashmiri Red Chilli Powder, Turmeric Powder, Tablespoon Tandoori Masala, Tablespoon Onion Powder",21,15,40,55,5,North Indian Recipes,Main Course,High Protein Non Vegetarian
Baked Mathri Recipe (Non Fried Tea Time Snack),"Whole Wheat Flour, Salt, Chilled Butter, Whole Black Peppercorns, Ajwain, Chilled Water",6,20,40,60,6,North Indian Recipes,Snack,Vegetarian
Walnut Burfi Recipe - Akhrot Barfi,"Walnuts, Sugar, Ghee, Cardamom",4,5,20,25,6,Indian,Dessert,Vegetarian
Chatpata Kabuli Chana Salad - Chickpea Salad Recipe,"Kabuli Chana, Onion, Tomato, Green Chilli, Chaat Masala Powder, Salt, Lemon, Coriander",8,15,40,55,4,Indian,Appetizer,High Protein Vegetarian
Gawarphali Ki Sabzi Recipe -Cluster Beans Sabzi,"Gawar Phali, Green Chilli, Garlic, Gram Flour, Mustard Seeds, Cumin Seeds, Asafoetida, Turmeric Powder, Coriander Powder, Amchur, Salt, Sunflower Oil",12,10,15,25,3,North Indian Recipes,Lunch,Vegetarian
Thai Veg Papaya Salad Recipe (No Onion No Garlic),"Raw Papaya, Tomato, Red Yellow And Green Bell Peppers, Roasted Peanuts, Green Beans, Green Chilli, Soy Sauce, Sunflower Oil, Lemon Juice, Brown Sugar, Basil Leaves",11,20,15,35,4,Thai,Appetizer,Vegetarian
Mangalorean Kadle Manoli Recipe  - Tindora Kala Chana Sabzi,"Kala Chana, Tindora, Garlic, Mustard Seeds, Curry Leaves, Onion, Fresh Coconut, Jaggery, Sunflower Oil, Salt, Dry Red Chilli, Coriander, Methi Seeds, Whole Black Peppercorns, Cumin Seeds, Garlic",16,120,45,165,4,Mangalorean,Lunch,Diabetic Friendly
Pesto Paneer Sandwich,"Whole Wheat Brown Bread, Onion, Tomato, Homemade Basil Pesto, Paneer, Green Chilli, Salt, Butter Cook Sandwich",8,15,30,45,4,Continental,World Breakfast,Vegetarian
Kerala Pumpkin Pachadi Recipe (Parangikai Pachadi),"Kaddu, Turmeric Powder, Jaggery, Salt, Fresh Coconut, Green Chilli, Ginger, Curry Leaves, Sunflower Oil, Mustard Seeds, White Urad Dal, Curry Leaves",12,10,30,40,4,Kerala Recipes,Lunch,Vegetarian
Baby Potatoes In Tomato Gravy ,"Small Potato, Tomato, Cumin Powder, , Coriander Powder, Turmeric Powder, Oil, Salt, , Cardamom, Lentil, Water",12,30,20,50,4,North Indian Recipes,Lunch,Vegetarian
Eggless Chocolate Chip Cupcakes With Spinach Recipe,"Instant Oats, Badam, Cocoa Powder, Coconut Sugar, Baking Powder, Baking Soda, Spinach Leaves, Coconut Yogurt Hung Yogurt, Chia Seeds, Ripe Bananas, Coconut Milk Milk, Chocolate Chips",12,20,30,50,6,Continental,Dessert,Vegetarian
Sprouted Green Gram Kosambari Recipe- With Pomegranates,"Green Moong Sprouts, Carrots, Fresh Pomegranate Fruit Kernels, Green Chilli, Fresh Coconut, Coriander, Lemon Juice, Salt, Sunflower Oil, Mustard Seeds, Asafoetida, Curry Leaves",12,10,15,25,4,Karnataka,Side Dish,Diabetic Friendly
Jackfruit Seed Modak Recipe,"Jackfruit Seeds, Palm Sugar, Cardamom Powder, Rice Flour, Water, Sesame, Salt, Ghee, Thonnai",9,10,60,70,10,Indian,Dessert,Vegetarian
Whole Wheat Masala Papdi Recipe / Kadak Puri Recipe,"Whole Wheat Flour, Ghee, Ajwain, Whole Black Pepper Corns, Salt",5,10,40,50,6,Indian,Snack,Vegetarian
Vazaithandu Neer Mor Recipe - Plantain Stem Buttermilk,"Plantain Stem, Water, Lemon Juice, Curry Leaves, Asafoetida, Curd",6,15,0,15,2,South Indian Recipes,Snack,Vegetarian
Maharashtrian Aloo Bhujne ,"Potato, Onion, Mustard, Green Chili, Turmeric Powder, Ginger Garlic Paste, Salt, Oil, Oil, Wheat Germ, Chickpea Lentils, Fenugreek Seeds, Whole Pepper, Coriander Seeds, Dry Red Chilli, Small Spoon Cumin Seeds, Mustard, Turmeric Powder, Asafetida",19,10,30,40,4,Maharashtrian Recipes,Lunch,Vegetarian
"Pesto Pizza Recipe With Sun Dried Tomatoes, Mushrooms, Pineapples And Olives","All Purpose Flour, Baking Soda, Baking Powder, Garlic Powder, Onion Powder, Salt, Sugar, Extra Virgin Olive Oil, Curd, Water, Basil Leaves, Extra Virgin Olive Oil, Salt And Pepper, Garlic, Walnuts, Chia Seeds, Pineapple, Button Mushrooms, Kalamata Olives, Sun Dried Tomato, Mozzarella Cheese, Cheddar Cheese",22,120,30,150,4,Italian Recipes,Dinner,Vegetarian
Mini Victoria Sponge Cake Recipe,"Butter, Sugar, Whole Eggs, All Purpose Flour, Icing Sugar, Strawberry Jam, Hung Curd",7,20,30,50,6,British,Dessert,Eggetarian
Gujarati Kachariyu Recipe - Spiced Sesame And Coconut Ladoos,"Sesame Seeds, Dessicated Coconut, Badam, Melon Seeds, Jaggery, Dry Ginger Powder, Cardamom Powder, Nutmeg Powder, Dates, Dried Figs, Ghee",11,10,30,40,2,Gujarati Recipesï»¿,Snack,Vegetarian
Vazhakkai Milagu Kootu Recipe - Plantains Pepper Curry,"Plantain Stem, Mustard Seeds, White Urad Dal, Dry Red Chilli, Salt, Sunflower Oil, Fresh Coconut, Chana Dal, Whole Black Peppercorns, Cumin Seeds, Asafoetida, Dry Red Chilli, Sunflower Oil",13,5,15,20,4,South Indian Recipes,Lunch,Vegetarian
No-Bake Chocolate Hazelnut Cheesecake Recipe,"Oreo Biscuits, Butter, Britannia Cream Cheese, Heavy Whipping Cream, Nutella Spread, Caster Sugar, Vanilla Extract, Gelatin Agar Agar, Water, Hazelnut",10,25,400,425,4,Continental,Dessert,Vegetarian
Gil-E-Firdaus Recipe (Creamy & Sweet Bottlegourd Pudding),"Milk, Bottle Gourd, Sabudana, Basmati Rice, Almond Meal, Cardamom Powder, Saffron Strands, Vanilla Extract, Condensed Milk, Slivered Almonds, Ghee, Edible Silver Foilleaf",12,20,45,65,6,Hyderabadi,Dessert,Vegetarian
Classic Pineapple Upside-Down Cake Recipe,"Pineapple, Glazed Cherries, Butter, Brown Sugar, Cake Mix, Pineapple Juice, Sunflower Oil, Pineapple Essence, Food Color",9,15,100,115,8,Italian Recipes,Dessert,Vegetarian
Palak And Kala Chana Sukhi Sabzi Recipe,"Kala Chana, Spinach Leaves, Onion, Tomato, Green Chilli, Ginger, Garlic, Salt, Garam Masala Powder, Turmeric Powder, Red Chilli Powder, Coriander Powder, Bay Leaves, Cardamom, Sunflower Oil",15,30,30,60,4,Indian,Side Dish,Vegetarian
Navratan Korma ,"Cashews, Almonds, Melon Seeds, Onion, Tomato, Mixed Vegetables, Ginger Garlic Paste, Coconut Milk, Turmeric Powder, Red Chilli Powder, Coriander Powder, Garam Masala Powder, Salt, Ghee Oil, Tablespoon Pomegranate, Cashew, Raisins, Ghee",18,15,50,65,4,North Indian Recipes,Lunch,Vegetarian
Egg and Bread Fried Rice ,"Rice, Eggs, Onion, Bread, Ginger Garlic Paste, Lentil Sugar, , Cumin Seeds, Whole Black Pepper, Sambar Powder, Salt, As Per",12,10,20,30,4,Fusion,Dinner,Eggetarian
Spiced Indian Potato Flatbread ,"Wheat Flour, Salt, Water Make Dough, Oil Ghee, Potato, Onion, Ginger, Green Chilli, Turmeric Powder, Coriander Powder, Cumin Powder, Red Chilli Powder, Garam Masala Powder, Green Coriander",14,15,45,60,4,Punjabi,North Indian Breakfast,Vegetarian
Quick And Spicy Bell Pepper Pasta Recipe,"Conchiglie Pasta, Green Bell Peppers, Red Bell Pepper, Yellow Bell Pepper, Onion, Green Chilli, Red Chilli Sauce, Soy Sauce, Salt, Ginger Garlic Paste, Vinegar, Sugar, Extra Virgin Olive Oil",13,10,25,35,2,Italian Recipes,Dinner,Vegetarian
Angoori Rasmalai Recipe,"Milk, Condensed Milk, Lemon Juice, Sugar, Cardamom, Mixed Nuts",6,30,60,90,4,Bengali Recipes,Dessert,Vegetarian
Pineapple Mawa Delight Recipe,"Pineapple, Sugar, Cardamom Powder, Saffron Strands, Badam, Raisins, Fresh Cream, Khoya, Ghee, Sponge Cake Slice Mawa Cake",10,30,45,75,6,Indian,Dessert,Vegetarian
Mango & Mixed Fruit Popsicle Recipe,"Mango Juice, Kiwi, Green Grapes, Strawberries, Mint Leaves",5,15,0,15,2,Continental,Dessert,Vegetarian
Sajjappa Recipe (Stuffed Sweetened Coconut Pastry),"All Purpose Flour, Chiroti Rava, Ghee, Salt, Fresh Coconut, Dessicated Coconut, Jaggery, Poppy Seeds Khus Khus, Chiroti Rava, Cardamom Powder, Sunflower Oil Deep Fry",11,60,20,80,15,Karnataka,Dessert,Vegetarian
Shimla Mirch Ki Launji Recipe,"Green Bell Pepper, Sunflower Oil, Kalonji, Fennel Seeds, Green Chilli, Turmeric Powder, Coriander Powder, Red Chilli Powder, Amchur, Jaggery, Salt",11,5,15,20,2,North Indian Recipes,Side Dish,Vegetarian
Spicy Yogurt Chapati/Roti Recipe,"Whole Wheat Flour, Curd, Water, Green Chilli, Coriander, Sunflower Oil, Cumin Seeds, Ghee, Salt",9,20,25,45,4,Indian,Lunch,Vegetarian
Bread Waffle Pizza Recipe,"Whole Wheat Brown Bread, Mozzarella Cheese, Onion, Green Bell Pepper, Tomato, Sweet Corn, Baby Spinach, Black Pepper Powder, Homemade Pizza And Pasta Sauce, Dried Oregano, Butter Grease Waffle Iron",11,10,20,30,4,Continental,World Breakfast,Vegetarian
Nuchinunde / Nucchina Unde Recipe -Karnataka Style Dal Steamed Pakora,"Arhar Dal, Chana Dal, Dill Leaves, Green Chilli  Finely, Ginger, Fresh Coconut, Coriander, Curry Leaves, Asafoetida, Turmeric Powder, Salt",11,150,35,185,10,Karnataka,Snack,Vegetarian
Kerala Style Kappa Ulathiyathu Recipe - Tapioca Stir Fry Recipe,"Tapioca Root, Mustard Seeds, Shallots, Ginger, Curry Leaves, Dry Red Chilli, Fresh Coconut, Turmeric Powder, Salt, Coconut Oil",10,10,35,45,4,Kerala Recipes,Appetizer,Vegetarian
Minced Mutton Spring Rolls Recipe,"Mutton, Onion, Garlic, Ginger, Green Chilli, Turmeric Powder, Red Chilli Powder, Coriander, Cumin Powder, Garam Masala Powder, Salt, Mint Leaves, All Purpose Flour, Corn Flour, Water, Salt, All Purpose Flour, Water",18,40,30,70,6,Indian,Snack,High Protein Non Vegetarian
Homemade Soft Idli ,"Idli Dosa Mixture  Sesame Oil Ghee, As Per The Experiment",2,480,20,500,4,South Indian Recipes,South Indian Breakfast,High Protein Vegetarian
Paneer Peshawari Recipe - Cottage Cheese In Rich Gravy,"Paneer, Onion, Homemade Tomato Puree, Whole Cashews, Fresh Cream, Cumin Seeds, Bay Leaf, Ginger Garlic Paste, Turmeric Powder, Cumin Powder, Garam Masala Powder, Kashmiri Red Chilli Powder, Coriander Powder, Kasuri Methi, Honey, Butter, Salt",17,10,30,40,4,Punjabi,Lunch,Vegetarian
Dry Fruits Meetha Paneer Paratha Recipe,"Whole Wheat Flour, Water Knead Dough, Ghee, Badam, Cashew Nuts, Paneer, Raisins, Jaggery, Ajwain, Cardamom Powder, Cinnamon Powder",11,30,30,60,6,Indian,Snack,Vegetarian
Aal Ke Kofte (Bottle Gourd Fritters In Spicy Gravy) Recipe,"Ginger Garlic Paste, Curd, Onion, Bay Leaf, Black Cardamom, Cinnamon Stick, Red Chilli Powder, Turmeric Powder, Coriander Powder, Salt, Sunflower Oil, Water, Coriander, Bottle Gourd, Gram Flour, Red Chilli Powder, Green Chilli, Salt, Water, Sunflower Oil",20,15,60,75,4,Rajasthani,Dinner,Vegetarian
Kathirikai Rasavangi Recipe - Eggplant is a Tangy Coconut Gravy,"Brinjal, Arhar Dal, Turmeric Powder, Tamarind Water, Jaggery, Salt, Chana Dal, Coriander, Dry Red Chilli, Whole Black Peppercorns, Fresh Coconut, Sesame, Mustard Seeds, Curry Leaves",14,15,20,35,2,Tamil Nadu,Lunch,Vegetarian
Fennel Infused Mango Sorbet Recipe,"Mango, Fresh Orange Juice, Water, Fennel Seeds, Sugar",5,10,240,250,2,Continental,Dessert,Vegetarian
Chilli Garlic Toast Recipe,"Herb Butter, Green Chilli, Garlic, Whole Wheat Brown Bread",4,10,15,25,2,Fusion,Appetizer,Vegetarian
Aam Chunda Pickle Recipe - Gujarati Mango Chunda Recipe,"Mango, Salt, Turmeric Powder, Sugar, Red Chilli Powder, Cumin Seeds",6,20,20,40,1,Gujarati Recipesï»¿,Side Dish,Vegetarian
Vegan Jackfruit Ice Cream Recipe With Coconut Milk,"Coconut Milk, Jackfruit Ripe, Sugar, Jackfruit Ripe",4,15,0,15,4,Indian,Dessert,Vegan
5 Grain Greek Yogurt Fruit Parfait Recipe,"Multigrain Digestive Biscuits, Honey, Hung Curd, Chia Seeds, Fresh Fruits",5,15,0,15,4,Continental,Snack,High Protein Vegetarian
Karuveppilai Chicken Fry Recipe- Curry Leaf Flavoured Chicken,"Chicken, Onion, Ginger, Garlic, Green Chilli, Coriander Powder, Turmeric Powder, Salt, Coriander, Sunflower Oil, Curry Leaves, Cinnamon Stick, Star Anise, Cardamom, Stone Flower, Fennel Seeds, Dry Red Chilli, Black Pepper Powder",18,10,45,55,4,Tamil Nadu,Appetizer,High Protein Non Vegetarian
Ripe Mango Pachadi Recipe - Ripe Mambazha Curry Recipe,"Mango, Coconut Milk, Jaggery, Mustard Seeds, Cumin Seeds, Asafoetida, Dry Red Chilli, Turmeric Powder, Red Chilli Powder, Salt, Sunflower Oil",11,10,10,20,2,South Indian Recipes,Side Dish,Vegetarian
Ellu Sadam Recipe - Sesame Rice,"Basmati Rice, Salt, Sunflower Oil, Sesame Seeds, Dry Coconut, Dry Red Chilli, White Urad Dal, Cashew Nuts, Mustard Seeds, Curry Leaves, Asafoetida, à¤¬à¥à¥ à¤à¤®à¤à¥à¤ à¤¹à¥à¤à¤",12,20,30,50,4,South Indian Recipes,Lunch,Vegetarian
Financiers Recipe - French Almond Tea Cake,"All Purpose Flour, Almond Meal, Icing Sugar, Salt, Vanilla Extract, Egg Whites, Butter, Butter",8,20,30,50,4,French,Snack,Vegetarian
Spicy Broken Wheat Khichdi With Vegetables Recipe,"Broken Wheat, Water, Ginger, Garlic, Cloves, Bay Leaf, Dry Red Chilli, Ghee, Mustard Seeds, Cumin Seeds, Curry Leaves, Green Chilli, Onion, Tomato, Green Peas, Carrot, Potato, Red Chilli Powder, Turmeric Powder, Salt, Coriander",21,15,35,50,3,Indian,Lunch,Vegetarian
Chenna Poda Recipe,"Paneer, Sugar, Ghee, Milk, Sooji, Cardamom Powder, Cashew Nuts, Raisins, Ghee, Sugar",10,10,45,55,8,Oriya Recipes,Dessert,Vegetarian
Spinach Rice Recipe - Palak Pulao,"Cooked Rice, Spinach Leaves, Cumin Seeds, Ginger, Tomato, Turmeric Powder, Sambar Powder, Garam Masala Powder, Ghee, Salt",10,10,40,50,4,Indian,Lunch,Vegetarian
Apple And Raisin Chutney Recipe,"Apples, Onion, Lemon, Vinegar, Kisamis, Salt, Sugar, Cinnamon Powder, Oil",9,15,15,30,4,Continental,Side Dish,Vegetarian
Aval Puttu Recipe,"Poha, Jaggery, Cardamom Powder, Fresh Coconut  Grated, Ghee, Cashew Nuts",6,10,25,35,2,Indian,Dessert,Vegetarian
Goan Gawar Bhaji Recipe,"Sunflower Oil, Gawar Phali, Mustard Seeds, Cumin Seeds, Asafoetida, Turmeric Powder, Onion, Tomato, Green Chilli, Salt, Fresh Coconut, Coriander",12,15,15,30,4,Goan Recipes,Lunch,Vegetarian
Besan Aur Dahi Wali Kacche Kele Ki Sabzi Recipe,"Raw Banana, Gram Flour, Asafoetida, Cumin Seeds, Turmeric Powder, Red Chilli Powder, Coriander Powder, Garam Masala Powder, Hung Curd, Lukewarm Water, Salt, Sunflower Oil, Coriander, Sunflower Oil, Green Chilli",15,10,35,45,4,North Indian Recipes,Lunch,Vegetarian
Fusilli Alla Caprese Recipe-Pasta With Cherry Tomatoes And Basil Leaves,"Pasta  Fusilli, Extra Virgin Olive Oil, Garlic, Cherry Tomato, Salt, Whole Black Peppercorns, Basil Leaves, Mozzarella Cheese",8,10,30,40,2,Italian Recipes,Dinner,Vegetarian
Methi Lachha Paratha Recipe,"Whole Wheat Flour, Methi Leaves, Green Chilli, Garlic, Salt, Figaro Pure Olive Oil",6,10,15,25,4,Indian,Side Dish,Vegetarian
Chettinad Style Pepper Mushroom Recipe,"Button Mushrooms, Tomato, Green Chilli, Bay Leaf, Fennel Seeds, Curry Leaves, Coriander, Sunflower Oil, Salt, Fresh Coconut, Coriander, Whole Black Peppercorns, Cumin Seeds, Poppy Seeds, Fennel Seeds, Cinnamon Stick, Cardamom, Cloves, Star Anise, Mace, Nutmeg Powder, Dry Red Chilli, White Urad Dal, Shallots, Garlic, Ginger, Curry Leaves, Turmeric Powder",28,15,20,35,4,Chettinad,Lunch,Vegetarian
Cabbage Palya Recipe,"Cabbage, Tomato, Onion, Garlic, Green Chilli, Coriander, Fresh Coconut, Mustard Seeds, Asafoetida, Curry Leaves, Mustard Oil, Salt",12,10,30,40,4,South Indian Recipes,Lunch,Vegetarian
Chettinad Sura Meen Kuzhambu Recipe (Shark Fish Curry),"Shark Fish, Shallots, Garlic, Red Chilli Powder, Coriander Powder, Turmeric Powder, Fennel Powder, Cumin Powder, Salt, Sunflower Oil, Fennel Seeds, Mustard Seeds, Cumin Seeds, Water, Tamarind Water, Curry Leaves, Dry Red Chilli",17,15,45,60,4,Chettinad,Lunch,High Protein Non Vegetarian
Cauliflower Au Gratin Recipe - French Style Cauliflower & Cheese Bake,"Cauliflower, Butter, All Purpose Flour, Milk, Nutmeg Powder, Cheddar Cheese, Parmesan Cheese, Whole Wheat Bread Crumbs, Salt And Pepper",9,20,55,75,4,Continental,Dinner,Vegetarian
Sweet Corn And Capsicum Gravy Recipe,"Sweet Corn, Red Yellow And Green Bell Peppers, Onion, Tomato, Green Chilli, Ginger, Curd, Cashew Nuts, Water, Sunflower Oil, Salt",11,15,15,30,4,North Indian Recipes,Side Dish,Vegetarian
Traditional Christmas Cake Recipe,"Black Raisins, Prunes, Apricots, Dates, Dried Figs, Fresh Orange Juice, Orange Zest, Nutralite Classic Spread  Softened, Baking Powder, Brown Sugar, Whole Eggs, Vanilla Extract, Cinnamon Powder, Clove Powder, Dry Ginger Powder, Almond Meal, All Purpose Flour, Slivered Almonds",18,2880,45,2925,1,Continental,Dessert,Eggetarian
Salted Caramel Ice Cream Recipe With Salted Roasted Almonds,"Fresh Cream, Milk, Sugar, Vanilla Extract, Badam, Butter, Sugar, Fresh Cream, Vanilla Extract, Sea Salt",10,15,30,45,4,Continental,Dessert,Vegetarian
Broccoli & Bell Pepper Zunka ,"Cumin Seeds, Turmeric Powder, Asafoetida, Red Chilli Powder, Flour, Water, Broccoli, Cup Cabbage, Capsicum, Capsicum, Oil",11,15,20,35,4,Maharashtrian Recipes,North Indian Breakfast,No Onion No Garlic (Sattvic)
Matar Mushroom Curry Recipe,"Button Mushrooms  Diced, Green Peas, Onion, Tomato, Ginger Garlic Paste, Cumin Seeds, Turmeric Powder, Coriander Powder, Red Chilli Powder, Garam Masala Powder, Kasuri Methi, Tomato Ketchup Sugar Can Be Used, Fresh Cream, Sunflower Oil Cook, Coriander, Salt",16,20,30,50,4,Indian,Dinner,Vegetarian
Ilish Macher Korma Recipe - Hilsa Fish Curry In Rich Gravy,"Hilsa Fish, Onion, Ginger, Garlic, Green Chilli, Cashew Nuts, Raisins, Hung Curd, Cinnamon Stick, Bay Leaf, Cardamom, Turmeric Powder, Garam Masala Powder, Sugar, Salt, Red Chilli Powder, Ghee, Mustard Oil Cook",18,15,15,30,4,Bengali Recipes,Side Dish,Non Vegeterian
Vegetarian Corn Chowder Soup Recipe,"Extra Virgin Olive Oil, Stalks Celery, Milk, Water More If Required, Potato, Sweet Corn, Black Pepper Powder, Whole Black Peppercorns",8,10,30,40,4,Continental,Appetizer,Vegetarian
Whole Wheat Orange Honey Cake Recipe,"Whole Wheat Flour, Baking Powder, Baking Soda, Condensed Milk, Sunflower Oil, Vanilla Custard, Fresh Orange Juice, Lemon Juice, Brown Sugar, Orange Zest, Water, Sugar, Honey, Jam, Sugar",15,15,40,55,4,Continental,Dessert,Eggetarian
Instant Granola In A Microwave Recipe,"Instant Oats, Honey, Sunflower Oil, Chilled Water, Salt, Badam, Pumpkin Seeds, Dessicated Coconut",8,0,5,5,1,Continental,Snack,Vegetarian
Carrot Cauliflower Peas Sabzi Recipe,"Carrots, Cabbage, Green Peas, Green Peppers, Celery, Bay Leaves, Cinnamon, Cardamom, Whole Pepper, Mustard Oil",10,10,15,25,4,North Indian Recipes,Lunch,Diabetic Friendly
Bengali Style Basanti Pulao Recipe,"Govind Bhog Rice, Cashew Nuts, Raisins, Cinnamon Stick, Cardamom, Cloves, Bay Leaves, Turmeric Powder, Ginger, Sugar, Ghee, Sunflower Oil",12,10,40,50,4,Bengali Recipes,Main Course,Vegetarian
Mexican Green Sauce Recipe,"Coriander, Tahini, Lemon Juice, Extra Virgin Olive Oil, Honey, Ginger, Salt",7,10,0,10,4,Mexican,Side Dish,Vegetarian
Dahi Methi Puri Recipe - Fenugreek Leaves Puri With Yogurt,"Whole Wheat Flour, Methi Leaves, Cumin Seeds, Ajwain, Salt, Curd",6,15,20,35,4,Indian,Main Course,Vegetarian
Broccoli Mushroom Bean Sprouts Stir Fry Recipe,"Broccoli, Bean Sprouts, Button Mushrooms, Green Bell Pepper, Garlic, Extra Virgin Olive Oil, Soy Sauce, Red Chilli Flakes, Salt",9,5,20,25,4,Fusion,Side Dish,Diabetic Friendly
Sookha Aloo Matar Methi Sabzi Recipe,"Potato, Green Peas, Methi Leaves, Onion, Red Chilli Powder, Coriander Powder, Turmeric Powder, Garam Masala Powder, Sunflower Oil, Salt",10,10,15,25,4,North Indian Recipes,Lunch,Vegetarian
Beetroot Hummus Recipe,"Beetroots, Kabuli Chana, Black Pepper Powder, Garlic, Basil Leaves, Salt, Lemon Juice, Tahini, Extra Virgin Olive Oil",9,360,30,390,8,Middle Eastern,Appetizer,Vegetarian
Kashmiri Style Tamatar Chaman Recipe -Paneer Cooked With Tomatoes,"Paneer, Tomato, Cumin Seeds, Ajwain, Kashmiri Red Chilli Powder, Turmeric Powder, Fennel Powder, Dry Ginger Powder, Garam Masala Powder, Mustard Oil, Salt",11,10,20,30,4,Kashmiri,Lunch,High Protein Vegetarian
"Summer Salad Recipe-Red Cabbage, Lettuce Onions & Tomatoes ","Red Cabbage, Iceberg Lettuce, Onion, Salt, Tomato, Lemon Juice, Honey",7,15,0,15,4,Continental,Appetizer,Vegetarian
Karnataka Style Bonda Soup Recipe-Urad dal Fritters in Spicy Dal Soup,"White Urad Dal, Green Chilli, Curry Leaves, Black Pepper Powder, Fresh Coconut, Baking Soda, Salt, Yellow Moong Dal, Tomato, Ginger, Green Chilli, Cumin Seeds, Asafoetida, Turmeric Powder, Salt, Sunflower Oil, Water",17,150,60,210,4,Karnataka,South Indian Breakfast,Vegetarian
Creamy Spinach & Cheese Bread Toast Recipe,"Butter, Cups Spinach Leaves, Onion, Garlic, Corn Flour, Milk, Salt, Whole Black Peppercorns, Red Chilli Flakes, Fresh Cream, Cheese, Whole Wheat Brown Bread",12,20,10,30,4,Italian Recipes,World Breakfast,Vegetarian
Homemade Rose Flavoured Ice Cream Cake recipe,"Chocolate Cake, Vanilla Ice Cream, Heavy Whipping Cream, Rose Essence, Mixed Nuts, Decorative Sugar, Water, Sugar",8,480,60,540,5,Continental,Dessert,Vegetarian
Rava Fried Prawns Recipe,"Prawns, Turmeric Powder, Red Chilli Powder, Salt, Sooji, Rice Flour, Turmeric Powder, Red Chilli Powder, Salt, Sunflower Oil",10,10,20,30,4,Goan Recipes,Lunch,Non Vegeterian
Konkani Style Vaingana Kaap Recipe - Shallow Fried Eggplant With Semolina,"Brinjal, Red Chilli Powder, Turmeric Powder, Tamarind Paste, Sooji, Salt, Sunflower Oil",7,10,20,30,4,Konkan,Side Dish,Vegetarian
Nawabi Paneer Curry Recipe,"Paneer, Lemon Juice, Salt, Cumin Powder, Chaat Masala Powder, Black Pepper Powder, Sunflower Oil, Fresh Coconut, Whole Cashews, Green Chilli, Cinnamon Stick, Cloves, Cardamom, Cumin Seeds, Water, Ghee, Onion, Garlic, Ginger, Green Peas, Red Bell Pepper, Coriander, Salt, Turmeric Powder, Black Pepper Powder, Coconut Milk, Water",27,15,20,35,4,Hyderabadi,Main Course,Vegetarian
Rich Decadent Chocolate Souffle Recipe,"Dark Chocolate, Butter, Sugar, Egg Yolks, Egg Whites, Sugar, Vanilla Extract, Salt, Cream Of Tartar, Icing Sugar, Heavy Whipping Cream",11,20,15,35,4,Continental,Dessert,Eggetarian
Vegetarian Thai Green Curry Recipe,"Stalks Lemongrass, Green Chilli, Coriander, Basil Leaves, Coriander, Cumin Seeds, Whole Black Peppercorns, Onion, Spring Onion, Garlic, Ginger, Salt, Coconut Milk, Thai Green Curry Paste, Broccoli, Carrot, Red Yellowgreen Bell Pepper, Green Zucchini, Water Vegetable Stock, Brown Sugar, Basil Leaves Kaffir Lime Leaves, Salt, Sunflower Oil",23,15,40,55,4,Thai,Main Course,Vegetarian
Bhindi Raita ,"Okra, Oil, Hungfat, Mustard, Cumin Seeds, Red Chilli Powder, Peanut Powder, Chaat Masala Powder, Asafoetida, Sugar, Salt",11,15,15,30,4,Indian,Side Dish,Vegetarian
Bihari Makhana Aur Matar Sabzi Recipe,"Phool Makhana, Green Peas, Onion, Cloves, Tomato, Green Chilli, Red Chilli Powder, Coriander Powder, Garam Masala Powder, Mustard Seeds, Cumin Seeds, Fennel Seeds, Methi Seeds, Kalonji, Coriander, Sunflower Oil As Required, Salt",17,2,15,17,4,Bihari,Lunch,Vegetarian
Masala Puri Chaat Recipe,"Dried Green Peas, Onion, Tomato, Coriander, Pani Puris, Sev, Lemon Juice, Green Chutney, Coriander, Cumin Seeds, Fennel Seeds, Dry Red Chilli, Salt",13,10,20,30,4,Indian,Snack,Vegetarian
Malabar Style Erachi Pathiri Recipe - Flat Bread Stuffed With Shredded Chicken,"Chicken, Onion, Cloves, Ginger, Curry Leaves, Red Chilli Powder, Coriander Powder, Garam Masala Powder, Turmeric Powder, Salt, All Purpose Flour, Whole Wheat Flour, Sunflower Oil Cook The Erachi Pathiri",13,10,45,55,4,Malabar,Appetizer,Non Vegeterian
Buckwheat Corn Dhokla Recipe,"Buckwheat Flour, Sweet Corn, Curd, Sama Flour, Green Chilli Paste, Salt, Enos Fruit Salt, Sunflower Oil, Sunflower Oil, Sesame Seeds, Cumin Seeds, Mustard Seeds, Lemon Juice, Coriander",14,10,30,40,4,Gujarati Recipesï»¿,North Indian Breakfast,Gluten Free
Chammanthi Chutney Recipe (Coconut And Onion Chutney),"Fresh Coconut, Ginger, Onion, Curry Leaves, Asafoetida, Mustard Seeds, Dry Red Chilli, Sunflower Oil, Salt",9,20,20,40,4,Indian,Side Dish,Vegetarian
Dhania Wale Aloo ,"Gm Small Potato, Cumin Powder, Black Pepper Powder, Garam Masala Powder, Lemon Juice, Sesame, Salt Rock Salt, Green Coriander, Ginger, Green Chili",10,10,30,40,4,Indian,Lunch,Vegetarian
Classic Cheesecake Recipe With Lemon Curd Made Using Preethi Electric Pressure Cooker,"Whole Eggs, Egg Yolks, Caster Sugar, Butter, Lemon Zest, Lemon, Ginger Cookies, Butter, Britannia Cream Cheese, Sugar, All Purpose Flour, Salt, Hung Curd, Vanilla Extract, Whole Eggs",15,20,400,420,4,Continental,Dessert,Eggetarian
Kerala Style Cauliflower Kurma Recipe,"Cauliflower, Carrots, Green Peas, Onion, Ginger Garlic Paste, Green Chilli, Tomato, Turmeric Powder, Red Chilli Powder, Coriander Powder, Cumin Powder, Cinnamon Stick, Curry Leaves, Coconut Milk, Coconut Milk, Salt, Cashew Nuts, Sunflower Oil, Coriander",19,10,40,50,3,Kerala Recipes,Dinner,Vegetarian
Nolen Gur Panna Cotta Recipe (Fresh Dates Jaggery Panna Cotta),"Milk, Double Cream, Gelatin, Vanilla Extract, Nolen Gur, Nolen Gur  Syrup, Silver Balls, Fresh Fruits",8,20,260,280,4,Fusion,Dessert,Vegetarian
Kodava Kummu Curry Recipe- Coorg Style Mushroom Curry,"Button Mushrooms, Green Chilli, Dry Red Chilli, Whole Black Peppercorns, Onion, Tomato, Curry Leaves, Coriander, Turmeric Powder, Salt, Sunflower Oil, Fresh Coconut, Cumin Seeds, Garlic",14,10,25,35,2,Coorg,Lunch,Vegetarian
Gajar Amla Raita Recipe - Carrot Gooseberry Raita Recipe,"Curd, Carrot, Amla, Split Mustard Seeds, Red Chilli Powder, Fresh Coconut, Green Chilli, Salt, Sunflower Oil, Mustard Seeds, Cumin Seeds, Curry Leaves",12,10,8,18,4,Indian,Side Dish,Vegetarian
Homemade Dhansak Masala Powder Recipe,"Coriander Seeds, Dry Red Chilli, , Cardamom, Cinnamon, Large Cardamom, Whole Pepper, Bay Leaves, Star Anis, Mustard, Gram Nutmeg Powder, Gram Poppy Poppy",12,0,10,10,200,Parsi Recipes,Vegetarian,No Onion No Garlic (Sattvic)
Spicy Pepper Chicken Recipe,"Chicken Breasts, Sunflower Oil, Onion, Water, Tomato, Turmeric Powder, Red Chilli Powder, Ginger Garlic Paste, Whole Black Peppercorns, Cumin Seeds, Fennel Seeds, Salt, Curry Leaves, Coriander",14,10,35,45,4,Indian,Dinner,High Protein Non Vegetarian
Orange Rasmalai Recipe (Indian Cottage Cheese Pudding),"Milk, Vinegar, Fresh Orange Juice, Orange Zest, Orange Pulp, Arrowroot Flour, Baking Soda, Sugar, Sugar, Water, Drops Orange Essence, Food Color, Dry Fruits",13,25,90,115,4,Bengali Recipes,Dessert,Vegetarian
Laal Maas Biryani Recipe,"Gm Mutton, Yogurt, Cumin Powder, Coriander Powder, Ginger Garlic Paste, Salt, Dry Kashmiri Chilli, Cumin, Big Cardamom, Cardamom, Cinnamon, , Bay Leaf, Ghee, Onion, Garam Masala Powder, Salt    Coriander, Charcoal Smoke, Ghee, Bay Leaf, Dry Kashmiri Chilli, Big Cardamom, Cardamom, Cinnamon, , Onion, Make  Ginger, Garlic, Salt, Green Chilli, Coriander Powder, Kashmiri Red Chili Powder, Turmeric Powder, Rice, Green Coriander, Mint",36,30,60,90,8,Rajasthani,Main Course,Non Vegeterian
Rajasthani Dal Bati Churma Recipe | Dhaba Style recipe,"Whole Wheat Flour, Sooji, Ghee, Ajwain, Baking Powder, Salt, Jaggery, Green Moong Dal, Black Urad Dal, Chana Dal, Onion, Ginger, Green Chilli, Clove Garlic, Tomato, Bay Leaf, Cinnamon Stick, Turmeric Powder, Garam Masala Powder, Coriander, Ghee, Cumin Seeds, Dry Red Chilli",23,10,90,100,4,Rajasthani,Lunch,Vegetarian
Green Moong Dal And Vegetable Idli Recipe,"Yellow Moong Dal, White Urad Dal, Methi Seeds, Carrot, Green Bell Pepper, Dill Leaves, Coriander, Ginger, Green Chilli, Salt",10,15,20,35,4,South Indian Recipes,South Indian Breakfast,Diabetic Friendly
Lemon Rasam Recipe - Nimbe Saaru Recipe,"Arhar Dal, Tomato, Green Chilli, Ginger, Turmeric Powder, Turmeric Powder, Coriander Powder, Cumin Powder, Black Pepper Powder, Coriander, Salt, Lemon, Ghee Sesame Oil, Mustard Seeds, Cumin Seeds, Curry Leaves, Asafoetida",17,10,20,30,2,South Indian Recipes,Lunch,Vegetarian
Tawa Paratha Recipe - Plain Paratha,"Whole Wheat Flour, Salt, Sunflower Oil, Ghee Oil For Cooking",4,20,20,40,4,North Indian Recipes,Main Course,Vegetarian
Crunchy Ragi And Oats Breakfast Bowl Recipe,"Ragi Flour, Instant Oats, Water, Milk, Honey, Multigrain Digestive Ragi Biscuits, Badam, Pistachios",8,5,15,20,1,Continental,World Breakfast,Vegetarian
Cabbage Palya ,"Cabbage, Tomato, Onion, Garlic, Green Chilli, Green Coriander, Coconut, Mustard, Asafetida, Curry Leaves, Mustard Oil, Salt",12,10,30,40,4,South Indian Recipes,Lunch,Vegetarian
Sambal Spiced Veggie Mee Goreng Recipe,"Wheat Noodles, Onion, Green Bell Pepper, Carrot, Baby Corn, Sunflower Oil, Sambal Paste, Onion, Green Chilli, Garlic, Stalk Lemongrass, Tamarind Water, Dry Red Chilli, Turmeric Powder, Sugar, Salt, Sunflower Oil",17,40,15,55,2,Asian,Snack,Vegetarian
Pitor Ki Sabzi Recipe,"Gram Flour, Curd, Water, Green Chilli, Ginger, Turmeric Powder, Salt, Sunflower Oil, Cumin Seeds, Asafoetida, Sunflower Oil, Cumin Seeds, Dry Red Chilli, Curd, Green Chilli, Red Chilli Powder, Turmeric Powder, Salt",18,0,90,90,4,Rajasthani,Lunch,Vegetarian
Guava Empanadas Recipe,"All Purpose Flour, Salt, Sugar, Baking Powder, Butter, Chilled Water, Britannia Cream Cheese, Guava, Mixed Nuts, Caster Sugar More",10,30,20,50,15,Continental,Snack,Vegetarian
Phalguni Dal Recipe,"Lentils, Green Peas, Onion, Tomato, Ginger, Garlic, Green Chilli, Turmeric Powder, Salt, Rye, Fenugreek Seeds, Cumin Seeds, Fennel Seeds, Fennel, Kalonji Seeds, Garam Masala Powder, Mustard Oil, Asafoetida",18,10,20,30,2,Bengali Recipes,Lunch,High Protein Vegetarian
Quick & Easy Idli Upma Recipe With Figaro Olive Oil,"Idli, Pearl Onion, Green Chilli, Ginger, Turmeric Powder, Mustard Seeds, White Urad Dal, Curry Leaves, Figaro Pure Olive Oil, Coriander, Salt",11,15,20,35,4,South Indian Recipes,South Indian Breakfast,Gluten Free
Cantonese Style Dimsums Recipe-Sweet Corn & Tofu Steamed Dumpling,"All Purpose Flour, Sunflower Oil, Salt, Onion, Tofu, Sweet Corn, Garlic, Ginger, Spring Onion, Soy Sauce, Chilli Vinegar, Salt",12,20,30,50,4,Cantonese,Appetizer,Vegetarian
Vegetarian Moussaka with Mushrooms Sauce Recipe,"Brinjal, Cheddar Cheese, Whole Wheat Bread Crumbs, Button Mushrooms, Garlic, Homemade Tomato Puree, Cumin Powder, Salt, Black Pepper Powder, Parsley Leaves, Whole Wheat Flour Corn Flour, Milk, Britannia Cream Cheese, Salt, Black Pepper Powder",15,15,45,60,4,Greek,One Pot Dish,Vegetarian
Malabar Prawn Curry Recipe,"Prawns, Coconut Milk, Tamarind Paste, Curry Leaves, Mustard Seeds, Methi Seeds, Dry Red Chilli, Pearl Onion, Turmeric Powder, Kashmiri Red Chilli Powder, Salt, Lemon Juice, Mustard Oil, Fresh Coconut, Ginger, Garlic, Green Chilli, Turmeric Powder, Cumin Powder, Coriander Powder",20,10,50,60,3,Kerala Recipes,Lunch,Non Vegeterian
Soba Noodle Salad Recipe,"Soba Noodles, Red Cabbage, Red Yellowgreen Bell Pepper, Spring Onion, Carrots, Coriander, Basil Leaves, Mint Leaves, Sesame Seeds, Peanut Butter, Ginger, Honey, Soy Sauce, Rice Vinegar, Sesame, Sriracha Sauce, Salt, Black Pepper Powder, Red Chilli Flakes, Lemon Juice",20,10,5,15,4,Chinese,Dinner,Vegetarian
Masoor Dal Makhni Recipe,"Masoor Dal, Onion, Tomato, Garlic, Ginger, Bay Leaf, Cloves, Cumin Seeds, Cinnamon Stick, Garam Masala Powder, Red Chilli Powder, Coriander Powder, Ghee, Fresh Cream, Salt",15,10,20,30,4,North Indian Recipes,Lunch,High Protein Vegetarian
à¤ªà¤à¤à¤¾à¤¬à¥ à¤²à¥à¤¬à¤¿à¤¯à¤¾ à¤®à¤¸à¤¾à¤²à¤¾à¤°à¥à¤¸à¤¿à¤ªà¥ -Punjabi Style Black Eyed Beans Curry ,"Cowpea, Onion, Tomato, Green Chili, Ginger Garlic Paste, Cumin Seeds, Cinnamon, Bay Leaf, , Red Chilli Powder, Turmeric Powder, Cumin Powder, Coriander Powder, Garam Masala Powder, Kasoori Methi, Ginger, Ghee, Salt  Salt",18,320,30,350,4,Indian,Dinner,Vegetarian
Aloo Raswala Sabzi Recipe,"Sunflower Oil, Methi Seeds, Cumin Seeds, Asafoetida, Onion, Garlic, Ginger, Green Chilli, Tomato, Potato, Turmeric Powder, Garam Masala Powder, Red Chilli Powder, Salt, Coriander",15,20,20,40,2,North Indian Recipes,North Indian Breakfast,Vegetarian
Rajma and Horse Gram Stuffed Paratha Recipe,"Rajma, Horse Gram Dal, Onion, Green Chilli, Cumin Seeds, Coriander Powder, Red Chilli Powder, Amchur, Garam Masala Powder, Black Pepper Powder, Salt, Whole Wheat Flour, Sunflower Oil, Water Knead",14,15,35,50,4,Punjabi,North Indian Breakfast,Diabetic Friendly
Chicken Malai Kebab Recipe,"Chicken Breasts, Onion, Ginger Garlic Paste, Hung Curd, Fresh Cream, Red Chilli Powder, Cumin Powder, Salt, Sunflower Oil",9,20,30,50,2,Indian,Appetizer,High Protein Non Vegetarian
Gobi Musallam Recipe (Spicy Cauliflower Creamy Gravy),"Cauliflower, Onion, Ginger, Garlic, Tomato, Turmeric Powder, Coriander Powder, Garam Masala Powder, Red Chilli Powder, Salt, Coriander, Fresh Cream, Sunflower Oil",13,15,45,60,4,Awadhi,Side Dish,Vegetarian
Prawns Kuzhambu Recipe - Tangy Prawns In Tamarind And Coconut Gravy,"Prawns, Onion, Turmeric Powder, Tomato, Garlic, Ginger, Tamarind Paste, Mustard Seeds, Fresh Coconut, Curry Leaves, Red Chilli Powder, Cardamom, Sunflower Oil, Water, Salt",15,15,20,35,2,South Indian Recipes,Lunch,Non Vegeterian
Urad Dal Vada Recipe (Non Deep Fried),"Cup White Urad Dal, Asafoetida, Green Chilli, Ginger, Salt, Tablespoons Extra Virgin Olive Oil",6,240,20,260,4,South Indian Recipes,Snack,Vegetarian
Aval Mixture Recipe - Poha Chivda,"Poha, Red Khara Sev, Boondi, Roasted Peanuts, Chana Dal, Curry Leaves, Turmeric Powder, Asafoetida, Red Chilli Powder, Salt, Sunflower Oil",11,10,30,40,4,North Indian Recipes,Snack,Vegetarian
Punjabi Bhindi Kadhi Recipe - Roasted Okra In Yogurt Curry,"Bhindi, Sunflower Oil, Curd, Gram Flour, Turmeric Powder, Coriander Powder, Red Chilli Powder, Salt, Cumin Seeds, Dry Red Chilli, Cinnamon Stick, Ghee",12,15,30,45,4,Punjabi,Dinner,Vegetarian
Adrak Chai Recipe - Indian Style Ginger Tea,"Water, Milk, Loose Leaf Tea, Ginger, Sugar",5,0,15,15,2,Indian,Side Dish,Vegetarian
Menthe Hittu Recipe (Roasted Fenugreek Chutney Powder),"White Urad Dal, Chana Dal, Arhar Dal, Yellow Moong Dal, Horse Gram Dal, Rice, Broken Wheat, Methi Seeds, Coriander, Cumin Seeds, Whole Black Peppercorns, Dry Red Chilli, Curry Leaves, Turmeric Powder, Asafoetida",15,0,35,35,300,Indian,Side Dish,Vegetarian
Raw Banana Chivda Recipe,"Uncooked Bananas, Peanuts, Curry Leaves, Green Chilli, Of Casmis, Cashews, Almonds, Red Chilli Powder, Castor Sugar, Spoon Chaat Masala Powder, Salt, Oil",12,10,35,45,3,Indian,Snack,Vegetarian
Banana Butterscotch Cake Recipe,"Whole Wheat Flour, Baking Powder, Baking Soda, Cinnamon Powder, Salt, Sugar, Whole Eggs, Ripe Bananas, Sunflower Oil, Milk, Butterscotch Chips, Vanilla Extract",12,20,35,55,3,Continental,Dessert,Eggetarian
Stir Fry Green beans and Tofu with Panch Phoron Recipe,"Green Beans, Tofu, Onion, Turmeric Powder, Mustard Seeds, Curry Leaves, Panch Phoran Masala, Salt, Sunflower Oil",9,10,30,40,4,Bengali Recipes,Side Dish,Vegetarian
Poha Breakfast Bowl Recipe With Sprouts & Crunchy Peanuts,"Poha, Salt, Sugar, Lemon Juice, Sunflower Oil, Mustard Seeds, Green Chilli, Curry Leaves, Potato, Onion, Turmeric Powder, Coriander, Raw Peanuts, Sunflower Oil, Salt, Chaat Masala Powder, Black Pepper Powder, Cumin Powder, Red Chilli Powder, Green Moong Sprouts, Onion, Tomato, Lemon Juice, Coriander, Salt, Black Pepper Powder, Carrot, Fresh Coconut, Salt, Sugar, Lemon Juice, Green Chilli",32,10,20,30,2,Indian,Indian Breakfast,High Protein Vegetarian
Almond and Cashew Nut Mushroom Curry Recipe,"Button Mushrooms, Onion, Garlic, Ginger, Green Chilli, Sesame Seeds, Poppy Seeds, Badam, Cashew Nuts, Black Pepper Powder, Sunflower Oil Buttercook, Garam Masala Powder, Coriander, Salt",14,20,25,45,4,North Indian Recipes,Side Dish,High Protein Vegetarian
Cabbage Capsicum Sabzi Recipe,"Cabbage, Oil, Capsicum, Mustard, Cumin Seeds, Dry Red Chilli, Asafetida, Turmeric Powder, Coriander Powder, Red Chilli Powder, Salt, Lemon Juice",12,5,15,20,3,North Indian Recipes,Main Course,No Onion No Garlic (Sattvic)
Peri Peri Fish Fingers Recipe,"Basa Fish, All Purpose Flour, Salt, Black Pepper Powder, Whole Egg, Milk, Whole Wheat Bread Crumbs, Red Chilli Powder, Red Chilli Flakes, Garlic Powder, Dry Ginger Powder, Cinnamon Powder, Dried Oregano",13,5,30,35,4,Continental,Appetizer,Non Vegeterian
Makhmali Rajma Kebab Recipe,"Rajma, Onion, Garlic, Ginger, Green Chilli, Coriander, Cumin Powder, Coriander Powder, Amchur, Red Chilli Powder, Garam Masala Powder, Roasted Gram Flour, Sugar, Salt, Sunflower Oil, Khoya",16,10,45,55,4,North Indian Recipes,Appetizer,Vegetarian
Goondh Paani Recipe - Sweet Gum Tree Almond Drink Recipe,"Ghee, Gond, Jaggery, Badam",4,15,15,30,4,North Indian Recipes,Snack,Vegetarian
Drunken Noodles Recipe - Pad Kee Mao,"Rice Noodles, Baby Corn, Red Bell Pepper, Yellow Bell Pepper, Green Bell Pepper, Thai Basil Leaves, Spring Onion, Garlic, Ginger, Brown Sugar, Honey, Soy Sauce, Fish Sauce, Sriracha Sauce",14,10,25,35,4,Thai,Main Course,Vegetarian
Sundried Tomato Pesto Recipe,"Sun Dried Tomato, Basil Leaves, Garlic, Badam, Parmigiano Reggiano Cheese, Extra Virgin Olive Oil, Whole Black Peppercorns, Salt",8,0,10,10,10,Thai,Main Course,Vegetarian
Dahi Turai Ki Sabzi Recipe (Ridge Gourd Simmered In Yogurt Curry Recipe),"Ridge Gourd, Gram Flour, Sugar, Turmeric Powder, Green Chilli, Curd, Tomato, Bay Leaf, Kalonji, Sunflower Oil, Salt, Ghee, Cumin Seeds, Dry Red Chilli, Cinnamon Stick",15,10,25,35,4,North Indian Recipes,Lunch,Vegetarian
Eggless Carrot Muffins Recipe,"Whole Wheat Flour, Curd, Carrot, Caster Sugar, Sunflower Oil, Badam, Vanilla Extract, Baking Powder, Baking Soda, Salt",10,10,20,30,8,Continental,Snack,Vegan
Bitter Gourd Juice Recipe - Karela Juice,"Karela, Ginger, Lemon Juice, Turmeric Powder, Black Salt, Salt, Honey, Black Pepper Powder, Mint Leaves",9,5,20,25,8,Indian,Snack,Diabetic Friendly
Oats Carrot Bell Peppers Mayo Sandwich Recipe,"Whole Wheat Brown Bread, Butter, Carrot, Red Bell Pepper, Instant Oats, Classic Mayonnaise, Red Chilli Flakes, Dried Oregano, Salt And Pepper",9,10,25,35,4,Continental,Lunch,Vegetarian
Murg Badami Recipe - Chicken In Almond Gravy,"Chicken, Badam, Onion, Ginger Garlic Paste, Red Chilli Powder, Dry Red Chilli, Turmeric Powder, Salt, Poppy Seeds, Cinnamon Stick, Cloves, Bay Leaf, Cardamom Powder, White Pepper Powder, Cumin Seeds, Curd, Ghee, Fresh Cream, Coriander",19,70,25,95,4,North Indian Recipes,Side Dish,Non Vegeterian
Tamil Nadu Style Vazha Thandu Thogayal Recipe (Banana Stem Chutney Recipe),"Mustard Seeds, White Urad Dal, Curry Leaves, Banana Stem, Dry Red Chilli, Tamarind, Turmeric Powder, Kasuri Methi, Salt, Asafoetida, Mustard Seeds, White Urad Dal, Curry Leaves, Dry Red Chilli, Sunflower Oil",15,10,30,40,4,Tamil Nadu,Side Dish,Vegetarian
Peanut Garlic Chutney Powder Recipe,"Cup Roasted Peanuts, Cup Dry Red Chilli, Tablespoon Cumin Seeds, Tablespoon Tamarind, Salt, Garlic, Sunflower Oil",7,20,15,35,5,South Indian Recipes,Side Dish,Vegetarian
Khajur And Pakora Raita Recipe - Dates Pakora Raita,"Curd, Cumin Powder, Black Pepper Powder, Chaat Masala Powder, Red Chilli Powder Sprinkle, Salt, Dates, Gram Flour, All Purpose Flour, Salt, Cooking Soda",11,10,15,25,4,Sindhi,Side Dish,Vegetarian
Tomato Methi Rice Recipe,"Rice, Onion, Ginger, Garlic, Tomato, Methi Leaves, Red Chilli Powder, Coriander Powder, Garam Masala Powder, Cinnamon Stick, Cloves, Cardamom, Ghee, Salt",14,10,20,30,4,Indian,Dinner,Vegetarian
Carrot And Beans Poriyal Recipe For Babies And Toddlers,"Carrot, Green Beans, Salt, Butter, Mustard Seeds, Asafoetida",6,5,10,15,2,South Indian Recipes,Side Dish,Vegetarian
Persian Eggplant Stew Recipe,"Eggplant, Onion, Tomato, Garlic, Turmeric Powder, Red Chili Powder, Cumin Powder, Small Tablespoon Cinnamon Powder, Black Pepper Powder, Water, Oil, Salt",12,15,40,55,4,Parsi Recipes,Dinner,Vegetarian
Vegan Guilt Free Chocolate Espresso Mousse Recipe,"Ripe Bananas, Avocados, Dark Chocolate, Cocoa Powder, Instant Coffee Powder, Sugar, Coconut Milk, Vanilla Extract, Icing Sugar, Chocolate Shavings, Decorative Sugar",11,20,40,60,4,Continental,Dessert,Vegetarian
Spicy Dalia Pulao Recipe - Broken Wheat Pulao,"Broken Wheat, Water, Onion, Carrot, Green Beans, Green Chilli, Turmeric Powder, Cumin Seeds, Salt, Garam Masala Powder, Red Chilli Powder, Tomato, Ginger Garlic Paste, Bay Leaf, Red Chilli Powder, Tomato, Ginger Garlic Paste, Coriander",18,20,30,50,4,North Indian Recipes,Lunch,Vegetarian
Eggless Cake Pops Recipe,"All Purpose Flour, Sugar, Salted Butter, Milk, Baking Powder, Baking Soda, Vanilla Extract, Sunflower Oil, Dark Chocolate, White Chocolate, Decorative Sugar",11,45,15,60,4,Continental,Dessert,Vegetarian
Tomatoes Stuffed With Mint Mayo And Paneer Recipe,"Paneer, Del Monte Mint Mayo, Tomato, Onion, Green Bell Pepper, Extra Virgin Olive Oil, Whole Black Peppercorns, Salt",8,20,30,50,4,Continental,Side Dish,Vegetarian
Gongura Chicken Curry Recipe,"Of Chicken, Onion, Tomato, Green Chilli, Ginger, Garlic, Turmeric Powder, Garam Masala Powder, Sesame Oil, Salt, Fenugreek Seeds, Coriander Seeds, Dry Red Chilli, Fennel Seeds, Sesame Seeds Oil, Garlic, Gongura, Salt",18,15,30,45,4,Andhra,Lunch,Non Vegeterian
Tomato Gojju (South Indian Style Tomato Curry Recipe),"Tomato, Green Chilli, Curry Leaves, Jaggery, Turmeric Powder, Sunflower Oil, Mustard Seeds, Cumin Seeds, Asafoetida, Salt",10,10,15,25,4,South Karnataka,Lunch,Vegetarian
One Pot Chicken Nasi Goreng Recipe,"Cooked Rice, Fresh Red Chilli, Green Chilli, Garlic, Ginger, Chicken Breasts, Shallots, Button Mushrooms, Red Bell Pepper, Carrot, Cabbage, Bean Sprouts, Whole Black Peppercorns, Red Chilli Sauce, Soy Sauce, Spring Onion Greens, Salt",17,20,30,50,4,Indonesian,One Pot Dish,Non Vegeterian
Parsi Toovar Dal Recipe,"Salt, Of Arhar Dal, Turmeric Powder, Onion, Tomato, Ghee, Of Green Coriander, Green Chilli, Ginger, Buds Garlic, Cumin Seeds, Coriander Seeds, Dry Red Chilies, Lentil Sugar, , Whole Black Peppers, Khus Khus, Ghee, Cumin",19,10,20,30,4,Parsi Recipes,Main Course,High Protein Vegetarian
Savory Carrot Olive Spinach Sandwich Spread Recipe,"Carrots, Pimientostuffed Green Olives  Finely, Spinach Leaves, Walnuts, Clove Garlic, Chia Seeds, Dried Basil Leaves, Black Pepper Powder, Britannia Cream Cheese, Salt, Extra Virgin Olive Oil",11,20,20,40,6,Continental,Snack,Vegetarian
Paneer Naan Pizza Recipe,"All Purpose Flour, Baking Powder, Salt, Sugar, Milk, Hung Curd, Ghee Cooking Oil, Lukewarm Water, Blanched Tomato, Garlic, Red Chilli Flakes, Dry Mix Herbs, Basil Leaves, Butter, Salt, Mozzarella Cheese, Red Yellow And Green Bell Peppers, Paneer, Onion, Red Chilli Flakes, Italian Seasoning, Butter Oilgrease",22,60,30,90,2,Fusion,Dinner,Vegetarian
Spinach Open Toast With Fried Egg Recipe,"Whole Wheat Brown Bread, Whole Eggs, Spinach Leaves, Tomato, Whole Black Peppercorns, Salt, Sunflower Oil, Butter",8,10,10,20,2,Continental,World Breakfast,Eggetarian
Kandathipli And Arisi Thipli Rasam Recipe,"Kandathipli, Arisithipli, Chana Dal, Cumin Seeds, Whole Black Peppercorns, Ajwain, Curry Leaves, Asafoetida, Salt, Tamarind, Water, Turmeric Powder, Coriander, Ghee, Mustard Seeds, Cumin Seeds, Dry Red Chilli",17,10,15,25,4,South Indian Recipes,Dinner,Vegetarian
Red Wine Sangria Cocktail Recipe,"Red Wine, Strawberry Vodka, Pomegranate Juice, Apple Juice, Ginger Juice, Lemon Juice, Ginger Ale, Sugar Syrup, Ice Cubes, Strawberries, Mint Leaves, Lemon, Orange",13,10,10,20,2,Brunch,Dinner,Vegetarian
Vegetarian Hakka Noodles Recipe,"Hakka Noodles, Onion, Ginger, Carrot, Capsicum, Cabbage, Green Beans, Green Onion, Soy Sauce, Red Chilli Sauce, Chilli Vinegar, Black Pepper Powder, Salt",13,20,30,50,4,Cantonese,Main Course,Vegetarian
Paneer Kalimirch ,"Cheese, Cream, Milk, Turmeric Powder, Garam Masala Powder, Whole Pepper, Salt, Oil  As Per Use  Onion, Cashews, Garlic, Ginger, Garlic, Oil, Black Pepper Powder",14,20,35,55,4,North Indian Recipes,Side Dish,High Protein Vegetarian
Carrot Fenugreek Leaves Stir Fry ,"Carrots, Fenugreek, Onion, Cumin, Asafetida, Red Chili Powder, , Turmeric Powder, Mango Powder, Salt, As Per",11,10,30,40,4,Indian,Lunch,Vegetarian
Traditional Shahi Tukda Recipe - Hyderabadi Double Ka Meetha,"Milk, Sugar, Cardamom Powder, Saffron Strands, Rose Water, Sugar, Water, Cardamom Powder, Rose Water, Whole Wheat Brown Bread, Ghee, Badam, Pistachios",13,10,30,40,4,Mughlai,Dessert,Vegetarian
Pineapple Mushroom Tikka Recipe With Tandoori Masala,"Button Mushrooms, Green Bell Pepper, Pineapple, Onion, Gram Flour, Curd, Ginger Garlic Paste, Turmeric Powder, Red Chilli Powder, Tandoori Masala, Kasuri Methi, Lemon Juice, Salt, Sunflower Oil",14,60,30,90,6,North Indian Recipes,Appetizer,Vegetarian
Mushroom Ghee Roast Recipe,"Button Mushroom, Curd, Turmeric Powder, Lemon Juice, Dry Red Chilli, Whole Black Pepper, Bud, Fenugreek Seeds, Coriander Seeds, Cumin, Garlic, Tamarind Paste, Ghee, Curry Leaves, Jaggery, Salt",16,10,25,35,5,Fusion,Appetizer,Vegetarian
"Stuffed Bread Rolls With Pumpkin, Onion & Cheese Recipe","Whole Wheat Flour, All Purpose Flour, Butter, Active Dry Yeast, Sugar, Salt, Kaddu, Onion, Garlic, Fresh Cream, Nutmeg Powder, Red Chilli Flakes, Fresh Thyme Leaves, Milk, Cheese, Salt",16,30,45,75,4,Continental,World Breakfast,Vegetarian
Baby Corn Paneer Kathi Roll Recipe,"Oil, Garlic, Onion, Capsicum, Carrot, Baby Corn, Salt  G Paneer As Per, Chaat Masala Powder, Achari Mayo, Tava Paratha, Cucumber, Tomato, Achari Mayo",13,10,30,40,4,Indian,Snack,High Protein Vegetarian
Green Spinach & Oats Cutlet Recipe,"Instant Oats, Green Peas, Spinach, Green Chilli, Coriander, Ginger, Salt, Whole Black Peppercorns, Dried Oregano, Lemon, Sunflower Oil",11,20,30,50,4,Indian,Snack,Vegetarian
Spinach Fig & Cherry Tomatoes Salad with Red Wine Vinaigrette Recipe,"Spinach Leaves, Fresh Figs, Cherry Tomato, Cucumber, Feta Cheese, Red Wine Vinaigrette, Dijon Mustard, Extra Virgin Olive Oil, Salt And Pepper",9,15,0,15,4,Continental,Appetizer,Vegetarian
Pineapple Lassi Recipe,"Pineapple, Sugar, Yogurt, Saffron, Cream, Salt, Ice",7,20,0,20,4,Indian,Lunch,Vegetarian
Cheese Masala Omelette Recipe,"Whole Eggs, Onion, Tomato, Cheese, Green Chilli, Coriander, Salt, Sunflower Oil",8,10,15,25,1,Indian,Indian Breakfast,Eggetarian
Sweet Potato And Bitter Gourd Kulambu ,"Sweet Potato, Onion, Dry Coconut, Bitter Gourd, Tamarind Water, Red Chilli, Sesame Oil, Turmeric Powder, , Coriander Powder, Salt, Mustard Seeds, Fenugreek Seeds, Chickpea Lentils, Asafoetida, Curry Leaves, Water",17,15,35,50,4,South Indian Recipes,Lunch,Vegetarian
Goan Style Black Chickpeas And Cucumber Masala Recipe (Taushem Tondak),"Cucumber, Kala Chana, Fresh Coconut, Dry Red Chilli, Tamarind, Coriander, Turmeric Powder, Whole Black Peppercorns, Sugar, Salt",10,15,30,45,4,Goan Recipes,Lunch,High Protein Vegetarian
Quatre Quart Pound Cake Recipe With Fresh Figs,"All Purpose Flour, Butter, Caster Sugar, Whole Eggs, Baking Powder, Salt, Vanilla Extract, Milk, Fresh Figs",9,20,40,60,8,French,Dessert,Eggetarian
Cheese Crackers Recipe,"Gm Chhedar Cheese, Butter, All Purpose Flour, Salt, Paprika Powder, Water",6,70,20,90,6,Continental,Snack,Vegetarian
Zunka Recipes (Spicy Gram Flour),"Gram Flour, Onion, Garlic, Green Chilli, Coriander, Mustard Seeds, Cumin Seeds, Red Chilli Powder, Sunflower Oil, Salt, Water",11,10,25,35,2,Maharashtrian Recipes,Dinner,Vegetarian
Keerai Vadai Recipe,"Chana Dal, Spinach, Onion, Green Chilli, Garlic, Ginger, Cumin Seeds, Salt, As Per  Deep Fry",9,140,30,170,4,South Indian Recipes,Snack,Vegetarian
Chana Dal & Methi Ki Sabzi ,"Chana Dal, Fenugreek Seeds, Water, Mustard Seeds, Asafoetida, Asafoetida, Curry Leaves, Red Chilli Powder, Turmeric Powder, Mango Powder, Coriander Powder, Salt, Oil",13,20,30,50,4,North Indian Recipes,Side Dish,Vegetarian
Karnataka Style Chicken Saaru Recipe,"Chicken, Red Chilli Powder, Turmeric Powder, Salt, Sunflower Oil, Onion, Fresh Coconut, Garlic, Ginger, Cinnamon Stick, Cloves, Dry Red Chilli, Poppy Seeds",13,10,45,55,4,Karnataka,Lunch,High Protein Non Vegetarian
Chow Chow Poricha Kootu Recipe,"Chow Chow, Yellow Moong Dal, Turmeric Powder, Coconut, Dry Red Chilli, Cumin, Curry Leaves, Salt, Curry Leaves, Rye, Oil, White Urad Dal, Chana Dal",13,15,30,45,4,Tamil Nadu,Lunch,Vegetarian
Lauki Tamatar Ki Sabzi Recipe,"Bottle Gourd, Onion, Garlic, Tomato, Cumin Seeds, Turmeric Powder, Red Chilli Powder, Curry Leaves, Coriander, Sunflower Oil Cook, Salt",11,20,30,50,4,Gujarati Recipesï»¿,Dinner,Diabetic Friendly
Carrots And Coriander Fritters Recipe,"Carrots, Green Coriander, Flour, Green Chili, Salt, Oil Brush",6,10,20,30,2,Indian,Snack,Vegetarian
Vegan Gluten Free Banana Bread Recipe,"Ripe Bananas, Almond Milk, Tender Coconut Water, Flax Seed Powder, Salt, Ripe Bananas, Cinnamon Powder, Vanilla Extract, Baking Powder, Baking Soda, Coconut Oil Refined Oil, Date Syrup Honey, Apple Cider Vinegar White Vinegar, Buckwheat Flour, Rolled Oats, Badam, Dark Chocolate",17,10,90,100,4,Continental,Snack,Vegan
Onion And Parmesan Toast Recipe,"Whole Wheat Brown Bread, Onion, Classic Mayonnaise, Parmesan Cheese, Butter, Italian Seasoning",6,10,10,20,4,Continental,Snack,Vegetarian
Tirunelveli Mor Kuzhambu Recipe,"Vellai Poosanikai, Tamarind Water, Curd, Salt, White Urad Dal, Methi Seeds, Dry Red Chilli, Cumin Seeds, Fresh Coconut, Coconut Oil, Mustard Seeds, White Urad Dal, Curry Leaves",13,15,35,50,4,South Indian Recipes,Lunch,Vegetarian
Amla Methi Sukhi Sabzi Recipe - Healthy Diabetic Sabzi,"Amla, Water, Sunflower Oil, Cumin Seeds, Fennel Seeds, Ajwain, Asafoetida, Green Chilli, Ginger, Garlic, Onion, Tomato, Salt, Turmeric Powder, Methi Leaves, Garam Masala Powder, Coriander Powder, Cumin Powder, Coriander",19,15,30,45,4,North Indian Recipes,Side Dish,Diabetic Friendly
Egg And Ridge Gourd Burji - Peerkangai Muttai Poriyal Recipe,"Ridge Gourd, Whole Eggs, Onion, Cumin Seeds, Mustard Seeds, White Urad Dal, Black Pepper Powder, Sunflower Oil, Salt, Curry Leaves",10,10,25,35,4,South Indian Recipes,Lunch,Eggetarian
Gingerbread Biscotti Recipe,"All Purpose Flour, Whole Wheat Flour, Baking Powder, Butter, Sunflower Oil, Brown Sugar, Molasses Dark Corn Syruphoneymelted Jaggery, Dry Ginger Powder, All Spice Powder, Whole Eggs, Salt, Hazelnut",12,15,60,75,4,Italian Recipes,Snack,Eggetarian
Beetroot Salad Recipe with Mixed Greens & Feta Cheese,"Beetroot, Onion, Cherry Tomato  Halved, Iceberg Lettuce, Rocket Leaves, Feta Cheese, Melon Seeds, Extra Virgin Olive Oil, Salt And Pepper, Za'Atar, Red Wine Vinaigrette",11,10,20,30,2,Continental,Appetizer,Vegetarian
Pineapple Chicken Tikka Recipe,"Chicken Breasts   Into Â½  In Size, Pineapple, Sunflower Oil, Hung Curd, Gram Flour, Garlic, Ginger, Kasuri Methi, Fennel Seeds, Ajwain, Cumin Powder, Coriander Powder, Black Pepper Powder, Turmeric Powder, Red Chilli Powder, Garam Masala Powder, Black Salt, Salt",18,30,15,45,4,North Indian Recipes,Appetizer,High Protein Non Vegetarian
Blueberry Parfait Recipe,"Marie Biscuit Bourbon Biscuits, Butter, Sugar, Blueberries, Blueberry Jam, Heavy Whipping Cream, Vanilla Extract",7,15,300,315,3,French,Dessert,Vegetarian
Andhra Style Pappu Charu Recipe,"Pigeonpea, Green Chilli Dry Red Chilli, Garlic, Tomato, Onion, Tamarind Paste, Turmeric Powder, Salt, Ghee, Curry Leaves, Rye, Asafoetida",12,16,30,46,4,Andhra,Lunch,High Protein Vegetarian
Tawa Paneer Masala ,"Paneer, Kasuri Methi, Red Chilli Powder, Turmeric Powder, Salt, Oil, Cumin Seeds, Teaspoon Celery, Onion, Garlic, Coriander Powder, Tomato Puree, Royal Cumin, Cream, Teaspoon Green Chilli, Garam Masala Powder",16,30,20,50,5,North Indian Recipes,Dinner,Vegetarian
Rajasthani Sev Tamatar Ki Sabzi ,"Oil, Save, Mustard, Cumin Seeds, Asafetida, Ginger Garlic Paste, Green Chilli, Onion, Tomato, Turmeric Powder, Red Chilli Powder, Kashmiri Red Chilli Powder, Coriander Powder, Salt, Lemon Juice, Water, Of Green Coriander",17,10,20,30,2,Rajasthani,Lunch,Vegetarian
Farfalle Aglio-E-Olio Recipe,"Pasta, Cloves, Red Chilli Flakes, Salt, Parsley Leaves, Extra Virgin Olive Oil",6,10,30,40,2,Italian Recipes,Dinner,Vegetarian
Varan Bhaat Recipe,"Arhar Dal, Green Chilli, Coconut, Cumin Seeds, Turmeric Powder, Salt, Ghee, Asafoetida, Cumin Seeds",9,10,30,40,2,Goan Recipes,Lunch,Vegetarian
Mixed Vegetable Koora Recipe - Mixed Vegetable Poriyal,"Sweet Potato, Potato, Carrot, Avarekai, Methi Leaves, Green Chilli, Water, Sesame Seeds, Fresh Coconut, Jaggery, Salt, Turmeric Powder, Sunflower Oil, Mustard Seeds, Cumin Seeds, Curry Leaves",16,15,20,35,5,Andhra,Main Course,Vegetarian
Baked Pumpkin Cream Cheese French Toast Recipe - Breakfast Bread Pudding Recipe,"Whole Wheat Brown Bread, Britannia Cream Cheese, Milk, Kaddu, Sugar, Nutmeg Powder, Cinnamon Powder, Vanilla Extract, All Purpose Flour, Brown Sugar, Cinnamon Powder, Butter, Walnuts, Salt",14,5,60,65,4,Continental,World Breakfast,Vegetarian
Thalassery Chicken Biriyani Recipe,"Bay Leaves, Cardamom, Whole Black Peppercorns, Cloves, Cinnamon Stick, Red Matta Rice, Salt, Ginger, Garlic, Green Chilli, Chicken, Onion, Tomato, Red Chilli Powder, Turmeric Powder, Garam Masala Powder, Coriander, Mint Leaves, Lemon Juice, Milk, Saffron Strands, Cashew Nuts, Ghee",23,20,60,80,4,Kerala Recipes,One Pot Dish,Non Vegeterian
Mochar Ghonto Recipe (Traditional Banana Blossom Curry From West Bengal),"Banana Flower, Potato, Turmeric Powder, Red Chilli Powder, Garam Masala Powder, Sugar, Salt, Fresh Coconut, Green Chilli, Mustard Oil, Bay Leaf, Cumin Seeds, Ginger, Garlic, Ghee",15,10,80,90,3,Bengali Recipes,Dinner,Vegetarian
Savoury Oatmeal Breakfast Crepes ,"Oatmeal, Wheat Flour, Semolina, Yogurt, Water, Green Chilli, Cumin Powder, Whole Pepper, Coriander, Oil, Salt",11,20,30,50,4,South Indian Recipes,South Indian Breakfast,High Protein Vegetarian
Pakodi Koora Recipes,"Brinjal, Cauliflower, Potato, Onion, Onion, Sesame Seeds, Raw Peanuts, Red Chilli Powder, Coriander Powder, Coriander, Few Curry Leaves, Green Chilli, Ginger Garlic Paste, Turmeric Powder, Gram Flour, Rice Flour, Few  Coriander, Salt, Sunflower Oil",19,20,40,60,4,Indian,Dinner,Vegetarian
Sweet And Spicy Thai Style Paneer Recipe,"Paneer, Thai Red Curry Paste, Sriracha Sauce, Lemon, Garlic, Green Chilli, Salt And Pepper, Sunflower Oil, Sesame Seeds, Roasted Peanuts, Onion, Lemon Wedges, Spring Onion Greens, Coriander",14,15,40,55,5,Indian,Snack,Vegetarian
Coconut Rice Pulao With Coconut Cream Recipe,"Basmati Rice, Coconut Milk, Ghee, Bay Leaves, Cardamom, Whole Black Peppercorns, Cumin Seeds, Ginger, Carrot, Green Peas, Cashew Nuts, Fresh Coconut, Salt",13,20,30,50,2,Indian,Lunch,Vegetarian
Chakolaya Recipe (Maharastrian Varan Phal),"Whole Wheat Flour, Sunflower Oil, Ajwain, Salt, Arhar Dal, Red Chilli Powder, Coriander Powder, Turmeric Powder, Mustard Seeds, Sunflower Oil, Kokum, Sugar, Water, Onion",14,10,40,50,4,Maharashtrian Recipes,Lunch,Vegetarian
Broccoli Almond Soup Recipe - Healthy Soup Weight Loss,"Broccoli, Onion, Garlic, Milk, Badam, Salt, Whole Black Peppercorns, Extra Virgin Olive Oil",8,10,20,30,4,Continental,Appetizer,High Protein Vegetarian
Mangalorean Manoli Bheeja Upkari Recipe - Ivy Gourd & Cashew Sabzi,"Tindora, Cashew Nuts, Fresh Coconut, Sugar, Salt, Coconut Oil, White Urad Dal, Mustard Seeds, Dry Red Chilli, Turmeric Powder, Curry Leaves",11,10,20,30,4,Mangalorean,Side Dish,Vegetarian
Shrimp Deviled Eggs Recipe,"Whole Eggs, Spring Onion, Shrimps, Classic Mayonnaise, Mustard Sauce, Black Pepper Powder, Garlic Powder, Spring Onion Greens, Salt",9,10,35,45,4,Continental,Appetizer,Eggetarian
Gutti Vankaya Recipe - Andhra Style Stuffed Brinjal,"Brinjal, Tamarind Paste, Onion, Fresh Red Chilli  Dry, Raw Peanuts, Sesame Seeds, Fresh Coconut Dessicated Coconut, Coriander, Cumin Seeds, Cardamom, Garlic, Chana Dal, Sunflower Oil, Bay Leaf, Cumin Seeds, Curry Leaves",16,15,40,55,4,Andhra,Lunch,Vegetarian
Himachal Style Panchkuti Khichdi Recipe,"Bajra, Chana Dal, Arhar Dal, Green Moong Dal, Yellow Moong Dal, Masoor Dal, Cumin Seeds, Mustard Seeds, Whole Black Peppercorns, Dry Red Chilli, Cinnamon Stick, Cloves",12,30,20,50,4,Himachal,North Indian Breakfast,Vegetarian
Kashmiri Kesar Pulao - Saffron Fennel Rice Recipe,"Rice, Saffron Strands, Milk, Cumin Seeds, Fennel Seeds, Cinnamon Stick, Cloves, Salt, Ghee",9,5,20,25,4,Kashmiri,Main Course,Vegetarian
Cauliflower And Soya Chunks Sabzi Recipe,"Cauliflower, Soy Chunks, Onion, Mustard Seeds, Cumin Seeds, Fresh Coconut, Green Chilli, Red Chilli Powder, Garam Masala Powder, Turmeric Powder, Coriander, Curry Leaves, Sunflower Oil, Salt, Water, Lemon Juice",16,30,15,45,4,North Indian Recipes,Side Dish,Vegetarian
Saffron Mango Ice-cream Recipe,"Mango, Heavy Whipping Cream, Condensed Milk  Sweetened, Saffron Strands, Milk, Ice Cubes",6,15,240,255,4,Continental,Dessert,Vegetarian
Sweet Potato & Neem Leaves Vegetable Curry ,"Sweet Potato, Neem Leaves, Asafetida, Mustard, White Urad Dal, Red Chili, Bengal Lentils, , Salt, Groundnut",10,20,30,50,4,Indian,Lunch,Vegetarian
Potato And Peas Curry Recipe In Coconut Milk Gravy,"Fresh Coconut, Lukewarm Water, Potato, Green Peas, Onion, Tomato, Ginger, Garlic, Cloves, Cumin Powder, Coriander Powder, Whole Black Peppercorns, Turmeric Powder, Garam Masala Powder, Coconut Milk, Salt",16,5,20,25,4,Indian,Main Course,Vegetarian
Dry Ginger Coffee Recipe,"Water, Ginger Powder, Black Pepper Powder, Instant Coffee Powder, Tulsi, Cumin Seeds, Cardamom Powder, Jaggery",8,2,10,12,4,Kerala Recipes,Snack,Vegetarian
Nutella & Kiwifruit Filled Whole Wheat Crepe Recipe,"Whole Wheat Flour, Sugar, Milk, Salt, Whole Egg, Kiwi, Nutella Spread",7,15,20,35,4,Continental,World Breakfast,Eggetarian
Yellow Thai Curry Paste Recipe,"Stalks Lemongrass, Galangal Ginger, Onion, Dry Red Chilli, Kaffir Lime Leaves Basil Leaves, Garlic, Coriander, Cumin Seeds, Whole Black Pepper Corns, Turmeric Powder",10,15,0,15,1,Thai,Main Course,Vegetarian
Vendakkai Varuval Recipe - Tamil Nadu Style Okra Stir Fry,"Bhindi, Gram Flour, Red Chilli Powder, Turmeric Powder, Coriander Powder, Garam Masala Powder, Amchur, Salt, Sunflower Oil",9,10,30,40,4,Tamil Nadu,Side Dish,Vegetarian
Sev Tamatar Ki Sabzi ,"Tomato, Ginger, Cumin Seeds, Jaggery, Curry Leaves, Save, Oil, Salt",8,0,15,15,4,Gujarati Recipesï»¿,Side Dish,No Onion No Garlic (Sattvic)
Kathirikai Rasa Vangi Recipe,"Brinjal, Arhar Dal, Turmeric Powder, Tamarind, Jaggery, Salt, Chana Dal, Spoon Coriander Seeds, Dry Red Chilli, , Coconut, Sesame Oil, Rye, Curry Leaves",14,15,20,35,2,Tamil Nadu,Lunch,Vegetarian
Ajwaini Tamatar Bhindi Recipe,"Bhindi, Ajwain, Asafoetida, Red Chilli Powder, Homemade Tomato Puree, Sugar, Cashew Nuts, Salt",8,15,25,40,4,Indian,Lunch,No Onion No Garlic (Sattvic)
Jal Jeera Recipe - Sweet And Sour Cumin Water Recipe,"Cumin Seeds, Mint Powder, Kashmiri Dry Red Chilli, Whole Black Peppercorns, Asafoetida, Amchur, Black Salt, Sea Salt Regular Salt, Mint Leaves, Tamarind Paste, Coriander, Sugar, Pineapple, Chilled Water, Boondi Serve",15,0,20,20,4,Maharashtrian Recipes,Appetizer,Vegetarian
Vegetable Tortilla Soup Recipe,"Olive Oil, Garlic, Onion, Gleppino, Cumin Powder, Red Chilli Sauce, Sweet Corn, Zucchini, Capsicum, Capsicum, Capsicum, Black Beans, Tomato, Vegetable Stock, Salt, Black Pepper Powder, Water, Onion, Tomato  Finely, Garlic, Jalepino, Salt, Black Pepper Powder, Tortilla, Avocado, Coriander",26,20,30,50,6,Mexican,Side Dish,High Protein Vegetarian
Awadhi Style Zarda Pulao Recipe,"Cardamom, Cloves, Cinnamon Stick, Bay Leaf, Basmati Rice, Sugar, Badam, Cashew Nuts, Raisins, Dry Coconut, Paneer, Orange Zest, Lemon Juice, Saffron Strands, Salt, Sunflower Oil",16,5,30,35,4,Awadhi,Lunch,Vegetarian
Bread Batata Vada Recipe-Crispy Bread Bonda Stuffed With Spicy Aloo,"Whole Wheat Brown Bread  Whitebrown, Water, Sunflower Oil  For Frying, Potato, Green Chilli, Ginger, Turmeric Powder, Lemon Juice, Coriander, Sunflower Oil, Salt",11,15,20,35,8,Indian,Snack,Vegetarian
Kolkata Club Style Baked Kachori Aloo Recipe,"All Purpose Flour, Ajwain, Sunflower Oil, Salt, Water, Sunflower Oil, Red Chilli Powder, Cumin Powder, Coriander, Garam Masala Powder, Amchur, Turmeric Powder, Yellow Moong Dal, Salt, Coriander, Sunflower Oil Brush, Potato, Sunflower Oil, Dry Red Chilli, Mustard Seeds, Cumin Seeds, Ginger Garlic Paste, Onion, Tomato, Green Chilli, Garam Masala Powder, Coriander, Turmeric Powder, Cumin Powder, Red Chilli Powder, Salt, Coriander, Coriander",33,45,15,60,4,North Indian Recipes,Snack,Vegetarian
Vellarikka Manga Curry Recipe - Cucumber Mango Pulissery,"Cucumber, Mango, Green Chilli, Turmeric Powder, Water, Fresh Coconut, Cumin Seeds, Mustard Seeds, White Urad Dal, Curry Leaves, Dry Red Chilli, Salt",12,10,10,20,4,Kerala Recipes,Lunch,Vegetarian
Gehun Ki Bikaneri Khichdi Recipe (Wheat Kernel And Moong Dal Khichdi),"Wheat Berries Whole Wheat, Yellow Moong Dal, Ghee, Cumin Seeds, Green Chilli, Asafoetida, Cinnamon Stick, Salt",8,20,30,50,4,Rajasthani,Dinner,High Protein Vegetarian
Mexican Style Bunuelos Recipe-Sweet Fritter,"All Purpose Flour, Baking Powder, Sugar, Butter, Whole Egg, Milk, Salt, Sunflower Oil, Caster Sugar, Cinnamon Powder",10,20,15,35,4,Mexican,Dessert,Eggetarian
Umm Ali Recipe - Egyptian Dessert Recipe With Puff Pastry,"Puff Pastry Sheet, Milk, Condensed Milk, Sugar, Saffron Strands, Slivered Almonds, Raisins, Pistachios, Dessicated Coconut, Heavy Whipping Cream",10,15,30,45,8,Middle Eastern,Dessert,Vegetarian
Stuffed Bhindi Recipe With Peanuts,"Bhindi, Garlic, Ginger, Onion, Tomato, Figaro Pure Olive Oil, Roasted Peanuts, Sesame Seeds, Coriander Powder, Garam Masala Powder, Turmeric Powder, Red Chilli Powder, Amchur, Gram Flour, Sugar, Salt, Figaro Pure Olive Oil",17,20,30,50,4,South Indian Recipes,Main Course,Vegetarian
"Carrot, Roasted Pumpkin Seeds, Granola Savory Parfaits Recipe","Carrot, Hung Curd, Dill Leaves, Pumpkin Seeds, Granola, Salt And Pepper",6,15,0,15,4,French,World Breakfast,Vegetarian
Ginger Garlic Tofu Curry ,"Tofu, Ginger, Garlic, Carrot, Green Onion, Green Onion Leaves, Green Chili, Coconut Milk, Vegetable Stock, Turmeric Powder, Black Pepper Powder, Garam Masala Powder, Red Chilli Sauce, Salt, Soy Sauce, Corn Flour",16,15,30,45,2,Indian,Dinner,High Protein Vegetarian
Broccoli & Cheese Filled Crepe Recipe (with Roasted Red Peppers),"Crepes, Broccoli, Red Bell Pepper, Dijon Mustard, Britannia Cream Cheese, Salt, Red Chilli Flakes Tabasco Sauce For Spice, Butter, Cheddar Cheese",9,15,40,55,4,Continental,Dinner,Vegetarian
Lauki Yakhini ,"Gourd, Cinnamon, Cardamom, , Celery, Ginger Powder, Fennel Powder, Asafoetida, Yogurt, Yogurt, , Salt",12,15,35,50,4,Awadhi,Lunch,Vegetarian
Fried Egg Recipe - Sunny Side Up,"Whole Egg, Sunflower Oil, Salt And Pepper",3,2,2,4,1,Continental,World Breakfast,Eggetarian
Blueberry-Mango Marble Froyo Bars Recipe,"Hung Curd, Blueberries, Sugar, Hung Curd, Mango, Sugar",6,15,0,15,2,Continental,Dessert,Vegetarian
Saoji Egg Curry Recipe,"Whole Eggs, Onion, Ginger Garlic Paste, Tomato, Turmeric Powder, Coriander, Sunflower Oil, Salt, Dry Coconut, Guntur Dried Chilli, Kashmiri Dry Red Chilli, Poppy Seeds, Cumin Seeds, Fennel Seeds, Ajwain, Coriander, Cinnamon Stick, Cardamom, Cloves, Kapok Bud, Mace",21,10,20,30,4,Maharashtrian Recipes,Lunch,Eggetarian
Homemade Apple Pie Recipe With Whole Wheat Pie Crust,"Whole Wheat Flour, Salt, Sugar, Butter, Water  Ice Cold, Apples, Lemon, Sugar, Brown Sugar, All Purpose Flour, Cinnamon Powder, Salt, Milk, Honey, Sugar",15,10,60,70,9,Continental,Dessert,Vegetarian
Spicy Mushroom And Broccoli Stir Fry Recipe Flavored With Tandoori Mayo,"Button Mushrooms, Broccoli, Red Bell Pepper, Tomato, Garlic, Del Monte Tandoori Mayo, Red Chilli Powder, Salt, Sunflower Oil",9,15,30,45,4,Indian,Dinner,High Protein Non Vegetarian
Dudhi Dhokli Nu Shaak Recipe - Bottle Gourd And Steamed Dumplings Curry,"Bottle Gourd, Gram Flour, Salt, Turmeric Powder, Red Chilli Powder, Ajwain, Coriander, Enos Fruit Salt, Water, Sunflower Oil, Curry Leaves, Cumin Seeds, Mustard Seeds, Asafoetida, Ginger Garlic Paste, Tomato, Salt, Garam Masala Powder, Red Chilli Powder, Gram Flour, Buttermilk, Coriander",22,15,20,35,4,Gujarati Recipesï»¿,Lunch,Vegetarian
Creamy Stuffed Chicken With Pepper Cilantro Sauce Recipe,"Chicken Breasts, Whole Black Peppercorns, Coriander, Lemon Zest, Dried Thyme Leaves, Rosemary, Dried Oregano, Sage, Salt, Britannia Cream Cheese, Del Monte Black Olives, Extra Virgin Olive Oil, Corn Flour, Whole Black Peppercorns, Salt, Sugar, Garlic, Milk, Coriander",19,25,25,50,4,Continental,Lunch,Vegetarian
White Bean Pasta Recipe,"Conchiglie Pasta, White Beans, Coriander, Mint Leaves, Pine Nuts, Badam, Green Chilli, Extra Virgin Olive Oil, Lemon Juice, Salt",10,10,30,40,2,Italian Recipes,Dinner,Vegetarian
Capsicum Masala Gravy ,"Capsicum, Onion, Tomato, Cashews, Sesame, Peanuts, Kasuri Methi, Red Chili Powder, Coriander Powder, Garam Masala Powder, Oil, Ginger, Green Chilli, Large Cardamom, Bay Leaves, Turmeric Powder, Cumin Seeds, , Salt",19,15,20,35,4,Indian,Lunch,Vegetarian
Andhra Style Bobbarlu Vada/ Alsanda Vada Recipe -Spicy Lobia Vada Recipe,"Black Eyed Beans, Onion, Green Chilli, Red Chilli Powder, Curry Leaves, Ginger, Garlic, Cumin Seeds, Salt, Turmeric Powder, Sunflower Oil",11,120,30,150,4,Andhra,Snack,Vegetarian
Beetroot Poriyal Sabzi Recipe For Babies And Toddlers Over 10 months,"Beetroot, Salt, Butter, Mustard Seeds, Curry Leaves, Asafoetida",6,5,10,15,2,Indian,Lunch,Vegetarian
Chow Chow Kothamalli Chutney Recipe,"Chow Chow, Green Coriander, White Urad Dal, Chana Dal, Tamarind, Dry Red Chilli, Oil, Salt",8,20,20,40,4,South Indian Recipes,Side Dish,Diabetic Friendly
Haleem Ke Kebab Recipe,"Broken Wheat, White Urad Dal, Yellow Moong Dal, Chana Dal, Mutton, Ginger, Garlic, Salt, Saffron Strands, Green Chilli, Red Chilli Powder, Turmeric Powder, Coriander, Cumin Powder, Chaat Masala Powder, Gram Flour, Mint Leaves, Ghee",18,15,60,75,8,North Indian Recipes,Appetizer,High Protein Non Vegetarian
Paneer In Lemon Honey Sauce Recipe,"Paneer, Extra Virgin Olive Oil, Garlic, Lemon Juice, Lemon Zest, Honey, Turmeric Powder, Salt, Black Pepper Powder, Coriander",10,15,60,75,8,Asian,Appetizer,High Protein Vegetarian
Andhra Style Corn Vada Recipe,"Chana Dal, Sweet Corn, Green Chilli, Ginger, Dry Red Chilli, Onion, Cumin Seeds, Curry Leaves, Coriander, Gram Flour, Salt",11,20,30,50,4,South Indian Recipes,Snack,Vegetarian
Baked Paneer Bread Pakora Recipe,"Whole Wheat Brown Bread, Paneer, Ginger, Mint Leaves, Coriander, Red Chilli Flakes, Salt And Pepper, Butter",8,10,30,40,4,Indian,Snack,Vegetarian
Chettinad Beans & Cauliflower Poriyal ,"Cabbage, Green Beans, Mustard, White Urad Dal, Curry Leaves, Red Chilli Powder, Turmeric Powder, Salt, As Per",9,10,30,40,4,Chettinad,Lunch,Vegetarian
Malvani Mutton Curry Recipe,"Mutton, Salt, Turmeric Powder, Water, Malwani Masala, Sunflower Oil, Onion, Ginger, Garlic, Tomato",10,10,15,25,4,Malvani,Main Course,Non Vegeterian
Chinese 5 spice powder Recipe,"Star Anise, Cinnamon Stick, Whole Black Peppercorns, Cumin Seeds, Cloves, Cloves",6,0,10,10,4,Chinese,Dessert,Eggetarian
Coffee Ice Cream Recipe,"Fresh Cream, Milk, Sugar, Vanilla Extract, Instant Coffee Powder",5,20,480,500,4,Continental,Dessert,Vegetarian
Udupi Style Mixed Vegetable Sambar Recipe (Lentil Curry With Vegetables),"Arhar Dal, Water, Small Brinjal, Potato, Carrot, Green Beans, Pearl Onion, Tomato, Turmeric Powder, Jaggery, Tamarind Water, Water, Salt, Coriander, Cumin Seeds, Dry Red Chilli, Whole Black Peppercorns, Methi Seeds, Fresh Coconut, Garlic, Mustard Seeds, Garlic, Asafoetida, Dry Red Chilli, Curry Leaves, Sunflower Oil, Sunflower Oil",27,20,30,50,4,Mangalorean,Lunch,Vegetarian
Paneer Butter Masala Recipe,"Paneer, Tomato, Red Chilli Powder, Cumin Powder, Garam Masala Powder, Fresh Cream, Butter, Salt, Kasuri Methi, Onion, Ginger, Garlic, Cashew Nuts",13,20,40,60,4,North Indian Recipes,Lunch,Vegetarian
Kashmiri Saag Recipe,"Garlic, Spinach, Large Cardamom, Dry Kashmiri Chilli, Cumin, Fennel Powder, Mustard Oil, Asafetida, Salt",9,10,20,30,4,Kashmiri,Side Dish,Vegetarian
Pizza Pinwheels Recipe,"Whole Wheat Flour, All Purpose Flour, Lukewarm Water, Active Dry Yeast, Salt, Sugar, Extra Virgin Olive Oil, Onion, Tomato, Green Bell Pepper, Extra Virgin Olive Oil, Homemade Pizza And Pasta Sauce, Mozzarella Cheese, Dried Oregano, Red Chilli Flakes",15,60,15,75,4,Continental,Appetizer,Vegetarian
Radish Greens Poriyal Recipe (South Indian Style Radish Greens Stir Fry),"Shallots, Tomato, Mooli Ke Patte, Turmeric Powder, Salt, Arhar Dal, Fresh Coconut, Dry Red Chilli, Sesame, Cumin Seeds, Ginger, Asafoetida, Curry Leaves",13,10,20,30,4,South Indian Recipes,Lunch,Vegetarian
Goan Lady Fish Curry Recipe - Muddoshi Hooman,"Lady Fish, Fresh Coconut, Tamarind, Turmeric Powder, Mooli Mullangi, Dry Red Chilli, Whole Black Peppercorns, Coriander, Onion, Sunflower Oil, Turmeric Powder, Red Chilli Powder, Salt",13,10,30,40,4,Goan Recipes,Lunch,High Protein Non Vegetarian
Khatta Meetha Petha ,"Pumpkin, Green Chilli, Whole Black Pepper, Oil, Fennel, Sugar, Salt, Mango Powder, Coriander",9,10,30,40,2,Indian,Lunch,Vegetarian
Homemade Chocolate Mousse With Pineapple Recipe,"Dark Chocolate, Egg White, Egg Yolks, Double Cream, Caster Sugar, Pineapple",6,20,500,520,6,Continental,Dessert,Vegetarian
Urad Dal Vada Recipe,"White Urad Dal, Asafetida, Green Chilies, Ginger, Salt     Of Olive Oil, As Per",6,240,20,260,4,South Indian Recipes,Snack,Vegetarian
Maharastrian Kairichi Amti Recipe - Raw Mango Curry Recipe,"Mango, Jaggery, Salt, Fresh Coconut, White Urad Dal, Coriander, Methi Seeds, Dry Red Chilli, Turmeric Powder, Mustard Seeds, Dry Red Chilli, Asafoetida",12,10,30,40,4,Maharashtrian Recipes,Side Dish,Vegetarian
Garlic Bread With Herb Butter Recipe,"French Loaf, Garlic, Herb Butter",3,20,10,30,4,Continental,Dinner,Vegetarian
Eggless Paan Cheesecake Recipe,"Betel Leaves, Hung Curd, Paneer, Fresh Cream, Caster Sugar, Agar Agar Gelatin, Gulkand, Vanilla Extract, Water",9,15,30,45,12,Fusion,Dessert,Vegetarian
Grilled Quesadillas Recipe With Chilli Mushroom & Corn,"Tortillas, Cheese, Butter, Button Mushrooms, Sweet Corn, Spring Onion, Garlic, Ginger, Green Chilli, Corn Flour, Soy Sauce, Tomato Ketchup, Sweet And Spicy Red Chilli Sauce, Sunflower Oil, Salt",15,20,20,40,4,Mexican,Appetizer,Vegetarian
Tandoori Paneer Tikka Masala Recipe,"Paneer, Coal, Homemade Tomato Puree, Heavy Whipping Cream, Mint Leaves, Clove Garlic, Ginger, Fennel Seeds, Ajwain, Saffron Strands, Cumin Powder, Coriander Powder, Chaat Masala Powder, Garam Masala Powder, Black Pepper Powder, Red Chilli Powder, Black Salt, Turmeric Powder, Salt",19,20,40,60,4,North Indian Recipes,Side Dish,High Protein Vegetarian
Ambe Dal Recipe - Maharashtrian Salad with Raw Mango & Chana Dal,"Chana Dal, Mango, Sugar, Salt, Sunflower Oil, Mustard Seeds, Cumin Seeds, Curry Leaves, Asafoetida, Dry Red Chilli",10,10,15,25,2,Maharashtrian Recipes,Lunch,High Protein Vegetarian
Naked Burrito Bowl Recipe,"Garlic, Onion, Green Zucchini, Carrot, Green Bell Pepper, Red Bell Pepper, Button Mushrooms, Extra Virgin Olive Oil, Salt, Brown Rice, Vegetable Stock, Coriander, Garlic, Onion, Lemon, Lemon Zest, Black Pepper Powder, Extra Virgin Olive Oil, Tomato, Onion, Coriander, Cumin Powder, Lemon, Black Pepper Powder, Pickled Jalapenos, Salt, Avocado, Lemon, Salt, Cashew Nuts, Apple Cider Vinegar, Lemon Juice, Salt, Water, Canned Black Beans, Iceberg Lettuce, Sweet Corn, Corn Chips, Tabasco Original  Hot Sauce  As Needed",39,14,40,54,4,Mexican,Dinner,Vegetarian
Curd Jantikalu Recipe - Crispy Curd Snacks,"Rice Flour, All Purpose Flour, Curd, Sesame Seeds, Ajwain, Red Chilli Powder, Salt, Butter, Sunflower Oil, Water",10,10,20,30,3,South Indian Recipes,Snack,Vegetarian
Roasted Peanut & Fried Gram Chikki Recipe,"Roasted Peanuts, Roasted Gram Dal, Jaggery, Ghee",4,10,45,55,10,Indian,Snack,High Protein Vegetarian
Green Mango Masoor Dal Recipe,"Masoor Dal, Mango, Green Chilli, Turmeric Powder, Salt, Mustard Oil, Cumin Seeds, Mustard Seeds, Kalonji, Fennel Seeds, Methi Seeds, Dry Red Chilli",12,10,20,30,4,North Indian Recipes,Dinner,High Protein Vegetarian
Mango Tiramisu Recipe With Savoiardi,"Whole Eggs, Caster Sugar, All Purpose Flour, Mascarpone Cheese, Heavy Whipping Cream, Icing Sugar, Mango, Mango Pulp, Caster Sugar, Water, Mango",11,30,400,430,6,Italian Recipes,Dessert,Eggetarian
Cheesy Bread Pizza Recipe With Roasted Veggies,"Panini Bread, Butter, Homemade Pizza And Pasta Sauce, Del Monte Cheesy Garlic Mayo, Onion, Broccoli, Yellow Bell Pepper, Carrot, Extra Virgin Olive Oil, Salt And Pepper",10,20,30,50,4,Continental,Snack,Vegetarian
Spicy Tomato Uttapam With Garlic Recipe,"Idli Rice, Rice, Arhar Dal, Black Urad Dal, Methi Seeds, Salt, Tomato, Clove Garlic, Green Chilli, Salt, Sunflower Oil",11,20,30,50,4,South Indian Recipes,South Indian Breakfast,Vegetarian
Mexican Style Fresh Rajma Bean & Raw Mango Salad Recipe,"Lemon Juice, Honey, Cumin Powder, Canola Oil Olive Oil, Salt, Black Pepper Powder, Mango, Green Bell Pepper, Rajma, Pickled Jalapenos, Red Onion, Tomato, Coriander",13,10,20,30,4,Mexican,Appetizer,Vegetarian
Sabsige Soppu Kootu (Dill Leaf Curry) Recipe,"Dill Leaves, Fresh Coconut, Arhar Dal, Potato, Raw Peanuts, Black Pepper Powder, White Urad Dal, Green Chilli, Jaggery, Salt, Dry Red Chilli, Curry Leaves, Mustard Seeds, Sunflower Oil",14,10,30,40,4,South Indian Recipes,Lunch,Vegetarian
Yeruvalli Kuzhambu Recipe | Iru Puli Kuzhambu | Tangy Coconut Curry,"Carrots, Green Bell Pepper, Drumstick, Tamarind Water, Salt, Fresh Coconut, Dry Red Chilli, Methi Seeds, White Urad Dal, Mustard Seeds, Curry Leaves, Coconut Oil",12,10,30,40,4,South Indian Recipes,Lunch,Vegetarian
Kiwi Popsicles Recipe - Without Sugar,"Hung Curd, Kiwi, Honey",3,10,370,380,5,Continental,Snack,Vegetarian
Coorg Style Kumbala Curry Recipe (Pumpkin Sabzi),"Kaddu, Turmeric Powder, Salt, Fresh Coconut, Cumin Seeds, Green Chilli, Sunflower Oil, Mustard Seeds, Curry Leaves, Dry Red Chilli, Dry Red Chilli",11,15,15,30,4,Coorg,Side Dish,Vegetarian
Coriander Chicken Roast Recipe,"Chicken, Red Chilli Powder, Garam Masala Powder, Turmeric Powder, Salt, Ginger Garlic Paste, Coriander, Sunflower Oil",8,60,15,75,3,North Indian Recipes,Appetizer,High Protein Non Vegetarian
Sweet & Spicy Amla Chutney Recipe,"Amla, Cumin Seeds, Mustard Seeds, Curry Leaves, Red Chilli Powder, Asafoetida, Jaggery, Salt, Sunflower Oil",9,10,45,55,4,North Indian Recipes,Side Dish,Vegetarian
Nariyal Ki Kheer Recipe - Coconut Pudding,"Fresh Coconut, Milk, Sugar, Cardamom Powder, Badam, Whole Cashews, Pistachios, Saffron Strands",8,20,50,70,5,Indian,Dessert,Vegetarian
Baked Stuffed Baati With Churma And Panchratna Dal Recipe,"Whole Wheat Flour, Sooji, Ghee, Caster Sugar, Badam, Pistachios, Chana Dal, Arhar Dal, Green Moong Dal, White Urad Dal, Tomato, Turmeric Powder, Red Chilli Powder, Coriander Powder, Garam Masala Powder, Coriander, Ghee, Mustard Seeds, Cloves, Cumin Seeds, Cinnamon Powder, Asafoetida, Curry Leaves, Kashmiri Dry Red Chilli, Bay Leaf, Whole Wheat Flour, Sooji, Gram Flour, Ghee, Salt, Milk, Sunflower Oil, Green Chilli, Fennel Seeds, Coriander, Asafoetida, Green Peas, Turmeric Powder, Red Chilli Powder, Coriander Powder, Salt, Lemon, Green Chilli, Papad, Ghee",45,20,40,60,2,Rajasthani,Lunch,Vegetarian
Mexican Cornbread Recipe,"Makki Ka Atta, All Purpose Flour, Green Chilli Jalapenos, Onion, Baking Powder, Butter, Whole Egg, Sweet Corn, Buttermilk, Sugar, Salt",11,5,25,30,4,Mexican,Snack,Vegetarian
Gujarati Khichu Recipe - Steamed Rice Flour Savory Donuts,"Cups Water, Rice Flour, Ajwain, Cumin Seeds, Salt, Green Chilli, Ginger",7,5,10,15,4,Gujarati Recipesï»¿,North Indian Breakfast,Vegetarian
Cucumber Pineapple Raw Mango Salad Recipe,"Cucumber, Pineapple, Mango, Green Chutney, Mint Leaves",5,15,0,15,2,Indian,Side Dish,Vegetarian
Chilka Roti Recipe (Jharkhand Style Rice and Lentil Roti),"Rice  Soaked Overnight, Chana Dal, Sunflower Oil, Salt",4,10,10,20,3,Jharkhand,North Indian Breakfast,High Protein Vegetarian
Potato Stir Fry ,"Potato, Onion, Green Chili, Ginger Garlic Paste, Turmeric Powder, Red Chili Powder, Sambar Powder, Salt, Oil",9,10,30,40,4,Maharashtrian Recipes,Lunch,Vegetarian
Curd Oats Recipe,"Instant Oats, Water, Curd, Ginger, Green Chilli, Salt, Sunflower Oil, Chana Dal, Mustard Seeds, Curry Leaves, Asafoetida",11,10,10,20,4,Indian,Lunch,Vegetarian
Protein Rich Soy Dosa Recipe,"Soy Flour, White Urad Dal, Rice Flour, Water, Salt, Sunflower Oil Smear On Dosa",6,10,20,30,4,South Indian Recipes,South Indian Breakfast,High Protein Vegetarian
Rice Paper Vegetarian Spring Rolls Recipe (Healthy Summer Rolls),"Rice Paper Rolls, Tofu, Button Mushrooms, Red Bell Pepper, Raw Papaya, Cucumber  Deseeded, Carrot, Spring Onion, Mint Leaves, Rice Vinegar, Red Chilli Sauce, Honey, Lemon Juice, Coriander, Salt",15,15,40,55,10,Fusion,Appetizer,Vegetarian
Kerala Style Potatoes In Shallots And Roasted Coconut ,"Small Potato, Small Onion Sambar, Tomato, Green Chilli, Ginger, Pieces Garlic, Coriander Powder, Red Chilli Powder, Turmeric, Garam Masala Powder, Nuggets Curry Leaves, Small Onion Sambar Ones, Coconut, Cumin, Whole Pepper, Coconut Oil Cook, Salt",17,20,45,65,4,Kerala Recipes,Lunch,Vegetarian
Choco Badam Barfi / Choco Almond Fudge Recipe,"Khoya, Sugar, Almond Meal, Cocoa Powder, Ghee",5,10,20,30,4,North Indian Recipes,Dessert,Vegetarian
Chana Dal And Methi Ki Sabzi Recipe,"Chana Dal, Methi Seeds, Water, Cumin Seeds, Mustard Seeds, Asafoetida, Curry Leaves, Red Chilli Powder, Turmeric Powder, Amchur, Coriander Powder, Salt, Sunflower Oil",13,20,30,50,4,North Indian Recipes,Side Dish,Vegetarian
Kollu Thogayal Recipe (Horsegram Chutney),"Horse Gram Dal, Chana Dal, White Urad Dal, Fresh Coconut, Dry Red Chilli, Sunflower Oil, Mustard Seeds, Curry Leaves, Asafoetida, Turmeric Powder, Salt, Water",12,5,10,15,4,South Indian Recipes,Side Dish,Vegetarian
Khaja Recipe (Layered Fritters Dunked In Sugar Syrup),"All Purpose Flour, Ghee, Cardamom Powder, Black Pepper Powder, Cinnamon Powder, Sunflower Oil Cook, Chilled Water, Sugar, Water",9,10,60,70,4,Bihari,Dessert,Vegetarian
Himachali Chana Madra Recipe (Chickpeas In Yogurt Based Gravy),"Kabuli Chana, Mustard Oil, Asafoetida, Cloves, Cinnamon Stick, Black Cardamom, Whole Black Peppercorns, Cumin Seeds, Onion, Garam Masala Powder, Coriander Powder, Turmeric Powder, Red Chilli Powder, Salt, Green Chilli, Hung Curd, Rice Flour, Ghee",18,520,30,550,4,Himachal,Lunch,Vegetarian
Plain Dalia Recipe- How To Cook Broken Wheat In Pressure Cooker,"Broken Wheat, Water",2,5,20,25,4,Indian,Lunch,Vegetarian
Bhagar Recipe - Maharashtrian Style Spicy Barnyard Millet Pulao,"Barnyard Millet, Green Chilli, Cumin Seeds, Potato, Kokum, Roasted Peanuts, Ghee, Water, Sugar, Salt, Coriander",11,15,30,45,4,Maharashtrian Recipes,North Indian Breakfast,Vegetarian
Thengai Paal Sadam Recipe - Coconut Milk Pulao,"Golden Harvest Sona Masuri Rice, Onion, Green Chilli, Garlic, Ginger, Cloves, Fennel Seeds, Star Anise, Bay Leaf, Coconut Milk, Mint Leaves, Salt, Ghee, Ghee, Cashew Nuts",15,15,40,55,2,South Indian Recipes,Lunch,Vegetarian
Makki Paneer Pakora Recipe,"Sweet Corn  Mashed, Paneer, Onion, Coriander, Curry Leaves, Gram Flour, Salt, Sunflower Oil Deep Fry, Fennel Seeds, Green Chilli, Ginger",11,15,10,25,2,Indian,Snack,Vegetarian
Homemade Rice Puttu Recipe | Kerala Matta Rice or Basmati Rice,"Red Matta Rice Basmati Rice, Fresh Coconut  Grated, Salt",3,495,40,535,6,Kerala Recipes,South Indian Breakfast,Vegetarian
"Italian Open Toast Recipe With Grilled Ham, Cheese & Olives","Whole Wheat Brown Bread, Chicken Ham, Homemade Pizza And Pasta Sauce, Dill Leaves, Swiss Cheese, Black Olives, Extra Virgin Olive Oil, Salt, Black Pepper Powder",9,10,30,40,3,Italian Recipes,World Breakfast,High Protein Non Vegetarian
Vegetarian Shami Kebab Recipe (Chane Ke Kebab),"Kabuli Chana, Ginger, Coriander, Fennel Seeds, Potato, Paneer, Gram Flour, Chaat Masala Powder, Cumin Powder, Red Chilli Powder, Salt, Sunflower Oil",12,15,90,105,4,Awadhi,Appetizer,Vegetarian
Soya Spring Rolls Recipe,"Spring Roll Wrappers, Carrot, Green Beans, Green Peas, Cauliflower, Cabbage, Green Bell Pepper, Soy Granules, Spring Onion Greens, Ginger, Garlic, Tofu, Sesame, Green Chilli, Soy Sauce, Rice Wine Vinegar, P Sugar, Salt, Black Pepper Powder, Sunflower Oil, Corn Flour",21,10,60,70,4,Chinese,Appetizer,Vegetarian
Medu Vada Recipe (Traditional Fried Urad Dal Vada Using Vada Maker),"White Urad Dal, Ginger, Green Chilli, Coriander",4,15,20,35,4,South Indian Recipes,South Indian Breakfast,Vegetarian
Vazhakkai Poriyal Recipe - Raw banana Roast With Pepper,"Sesame, Mustard Seeds, White Urad Dal, Curry Leaves, Raw Banana, Black Pepper Powder, Turmeric Powder, Asafoetida, Salt",9,5,30,35,4,Tamil Nadu,Side Dish,Diabetic Friendly
Godhumai Idli Recipe (Instant Whole Wheat Flour Idli),"Curd, Whole Wheat Flour, Enos Fruit Salt, Sesame, Salt, Ghee, Chana Dal, Cumin Seeds, Whole Black Peppercorns, Cashew Nuts, Mustard Seeds, Curry Leaves, Green Chilli",13,10,50,60,2,South Indian Recipes,South Indian Breakfast,Vegetarian
Coimbatore Style Drumstick Sambar Recipe,"Onion, Drumstick, Tomato, Arhar Dal, Curry Leaves, Coriander, Cumin Seeds, Methi Seeds, Salt, Tamarind Paste, Turmeric Powder, Red Chilli Powder, Dry Red Chilli, Fresh Coconut, Mustard Seeds, Gingelly Oil, Ghee",17,15,30,45,4,Tamil Nadu,Side Dish,Vegetarian
Habshi Halwa Recipe,"Milk, Lemon Salt, White Vinegar, All Purpose Flour, Ghee, Sugar, Cardamom Powder, Saffron Strands, Cocoa Powder, Slivered Almonds",10,10,60,70,4,Indian,Dessert,Vegetarian
Ragi Badam Soup Recipe - Finger Millet Almond Soup With Vegetables,"Ragi Flour, Onion, Ginger, Carrots, Green Beans, Badam, Salt, Whole Black Peppercorns, Cumin Powder, Ghee",10,15,10,25,2,Indian,Dinner,Diabetic Friendly
Iranian Berry Pulao Recipe With Caramelized Onion & Cranberry,"Rice, Ghee, Onion, Bay Leaf, Cinnamon Stick, Star Anise, Cardamom, Cloves, Salt, Sugar, Saffron Strands, Milk, Cranberries, Cranberries, Caramelized Onion Garnish, Cashew Nuts",16,10,20,30,3,Parsi Recipes,Lunch,Vegetarian
Deviled Eggs Recipe With Mayo And Mustard Recipe,"Whole Eggs, Dijon Mustard, Classic Mayonnaise, Dill Leaves, Cayenne Pepper, Salt",6,15,15,30,4,Continental,Appetizer,Eggetarian
Strawberry Compote Galette Recipe,"All Purpose Flour, Butter, Salt, Caster Sugar, Water  Chilled, Strawberries  Large, Corn Flour, Caster Sugar, Vanilla Extract, Whole Egg, Caster Sugar",11,45,45,90,4,Continental,Dessert,Eggetarian
Brinjal Capsicum Sabji Recipe,"Brinjal, Green Bell Pepper, Garlic, Asafoetida, Green Chilli, Tomato, Turmeric Powder, Red Chilli Powder, Coriander Powder, Garam Masala Powder, Salt, Coriander, Sunflower Oil",13,10,15,25,4,Indian,Lunch,Vegetarian
Ulava Charu Recipe - Spicy Andhra Horse Gram Rasam,"Horse Gram Dal, Onion, Tomato, Green Chilli, Dry Red Chilli, Fresh Coconut, Curry Leaves, Turmeric Powder, Salt, Sunflower Oil, Sunflower Oil, Mustard Seeds, Curry Leaves, White Urad Dal, Dry Red Chilli",15,10,30,40,2,South Indian Recipes,Lunch,High Protein Vegetarian
Dudhi Dal Gosht Recipe-Mutton With Bottle Gourd & Lentils,"Bottle Gourd, Mutton, Chana Dal, Masoor Dal, Arhar Dal, Tomato, Onion, Amchur, Cinnamon Stick, Bay Leaf, Whole Black Peppercorns, Cardamom, Cumin Seeds, Sunflower Oil, Ghee, Mint Leaves, Salt, Ginger Garlic Paste, Red Chilli Powder, Cumin Powder, Coriander Powder, Turmeric Powder, Coriander",23,15,40,55,2,Indian,Dinner,Non Vegeterian
Beetroot Soft Tart Recipe,"All Purpose Flour, Active Dry Yeast, Salt, Sugar, Milk Powder, Milk, Butter, Beetroots, Carrot, Onion, Cabbage, Green Bell Pepper, Salt, Red Chilli Powder, Dried Oregano, Del Monte Tandoori Mayo, Mozzarella Cheese, Sunflower Oil, Butter",19,30,60,90,4,Continental,Main Course,Vegetarian
Mixed Vegetable Dry Manchurian Recipe,"Red Cabbage, Carrot, Cabbage, Green Beans, Green Bell Pepper, Salt, Black Pepper Powder, Corn Flour, All Purpose Flour, Sunflower Oil, Garlic, Ginger, Green Chilli, Spring Onion, Tomato Ketchup, Soy Sauce, Red Chilli Sauce, Vinegar, Salt, Corn Flour, Hot Water, Sugar",22,10,60,70,4,Chinese,Appetizer,Vegetarian
Tawa Paneer Masala Recipe,"Paneer, Kasuri Methi, Red Chilli Powder, Turmeric Powder, Salt, Sunflower Oil Cook, Cumin Seeds, Ajwain, Onion, Garlic, Green Chilli, Coriander Powder, Homemade Tomato Puree, Ajwain, Fresh Cream, Garam Masala Powder",16,30,20,50,5,North Indian Recipes,Dinner,Vegetarian
Sweet Ulundhu Kanji Recipe | Urad Dal Porridge,"White Urad Dal, Water, Jaggery, Cardamom, Fresh Coconut",5,30,15,45,5,South Indian Recipes,South Indian Breakfast,High Protein Vegetarian
Mediterranean Dajaj Mechwi Recipe,"Chicken Wings, Extra Virgin Olive Oil, Paprika Powder, Black Pepper Powder, Dried Oregano, Mint Leaves, Salt, Garlic",8,20,30,50,2,Mediterranean,Main Course,Non Vegeterian
Delicious Strawberry Tea Cake Recipe,"Butter, Brown Sugar, Whole Wheat Flour, All Purpose Flour, Baking Powder, Whole Egg Flaxmeal Egg Replacer, Milk, Vanilla Extract, Strawberries",9,20,50,70,8,Continental,Dessert,Vegetarian
"Carrot, Sweet Potato, Mushrooms Fritters Recipe ","Carrots, Sweet Potato, Onion, Button Mushrooms, Tofu, Oats Flour, Coriander, Cumin Seeds, Sunflower Oil, Salt And Pepper, Sunflower Oil",11,25,15,40,4,Continental,Appetizer,Vegetarian
Nanaimo Bars Recipe (No Bake),"Fresh Coconut, Walnuts, Vanilla Extract, Dark Chocolate, Butter, Marie Biscuit Any Other Biscuits, Milk, Custard Powder, Caster Sugar, Milk, Dark Chocolate, Butter",12,10,180,190,20,American,Dessert,Vegetarian
Mango Rice Recipe,"Fresh Coconut, Mango, Dry Red Chilli, Mustard Seeds, White Urad Dal, Raw Peanuts, Asafoetida, Turmeric Powder, Curry Leaves, Jaggery, Salt, Rice, Water, Sunflower Oil, Asafoetida",15,15,40,55,4,Indian,Lunch,Vegetarian
Moroccan Chicken Stew Recipe With Sauteed Zucchini & Onion Dressing,"Boneless Chicken, Salt, Onion, Garlic, Carrots, Stalks Celery, Ginger, Paprika Powder, Cumin Powder, Dried Oregano, Cayenne Pepper, Turmeric Powder, Water, Tomato, Kabuli Chana, Green Zucchini, Lemon Juice, Green Zucchini, Onion, Strawberries",20,20,45,65,3,African,Main Course,Non Vegeterian
Khatta-Meetha Aam Ka Murabba Recipe,"Mango, Sugar, Water, Red Chilli Powder, Cardamom Powder, Salt, Saffron Strands",7,20,60,80,6,Rajasthani,Side Dish,Vegetarian
Dal Chawal/ Paruppu Sadam -Baby & Toddler Recipe above 10 months,"Yellow Moong Dal, Turmeric Powder, Rice, Water, Butter, Salt, Asafoetida",7,2,20,22,2,Indian,Lunch,Vegetarian
Fish Sukka Recipe - Fish With Spicy Masala Filling,"Fish, Ginger Garlic Paste, Turmeric Powder, Tablespoon Red Chilli Powder, Tablespoon Sunflower Oil, Coriander, Lemon Juice, Green Chilli, Salt, Coriander, Cloves, Whole Black Peppercorns, Black Cardamom, Cinnamon Stick, Tablespoons Poppy Seeds, Cup Dessicated Coconut, Tablespoon Red Chilli Powder, Onion",18,15,20,35,4,Indian,Appetizer,High Protein Non Vegetarian
Kosamalli Recipe (Chettinad Style Brinjal and Potato Mash),"Brinjal, Potato, Shallots, Tomato, Green Chilli, Sunflower Oil, Mustard Seeds, Red Chilli Powder, Tamarind, Curry Leaves, Few  Coriander, Salt",12,15,20,35,4,Chettinad,Lunch,Vegetarian
Thai Pineapple Vegetarian Curry Recipe,"Garlic, Ginger, Spring Onion, Stalks Lemon Grass, Green Chilli, Coriander, Water, Cauliflower, Red Bell Pepper, Green Beans, Pineapple, Coconut Milk, Brown Sugar, Soy Sauce, Salt, Basil Leaves, Sunflower Oil",17,20,40,60,4,Thai,Side Dish,Vegetarian
Varagu Arisi Pongal Recipe -Kodo Millet Pongal,"Kodo Millet, Green Moong Dal, Water, Turmeric Powder, Salt, Ghee, Sesame, Cumin Seeds, Whole Black Peppercorns, Ginger, Curry Leaves, Asafoetida",12,19,50,69,4,South Indian Recipes,South Indian Breakfast,Vegetarian
No Onion No Garlic Black Eyed Beans Curry Recipe,"Black Eyed Beans, Sunflower Oil, Mustard Seeds, Cumin Seeds, Asafoetida, Turmeric Powder, Fresh Coconut, Groundnut Powder, Kokum, Jaggery, Maharashtrian Goda Masala, Red Chilli Powder, Salt",13,10,30,40,2,North Indian Recipes,Lunch,High Protein Vegetarian
Tomato & Beetroot Soup Recipe,"Tomato, Onion, Beetroot, Garlic, Whole Black Peppercorns, Cinnamon Stick, Cloves, Cardamom, Butter, Sunflower Oil, Water, Milk, Salt",13,10,20,30,4,Continental,Appetizer,Vegetarian
Kolhapuri Khanda Lasun Masala Spice Mix Recipe,"Dry Red Chilli, Byadagi Dried Chilli, Dry Coconut, Onion, Ginger, Garlic, Salt, Coriander, Sesame Seeds, Fennel Seeds, Cumin Seeds, Bay Leaves, Whole Black Peppercorns, Cloves, Cardamom, Star Anise, Stone Flower, Asafoetida",18,10,30,40,4,Maharashtrian Recipes,Lunch,Non Vegeterian
"Bacon, Caramelised Onions And Cheese Crepes Recipe ","All Purpose Flour, Confectioners Sugar, Salt, Sunflower Oil, Whole Egg, Milk, Bacon Strips, Onion, Sugar, Butter, Cheese, Salt, Black Pepper Powder, Mixed Herbs",14,10,12,22,2,French,World Breakfast,Non Vegeterian
Gujarati Trevti Dal Recipe (Creamy Lentils Cooked In Mild Spices),"Yellow Moong Dal, Chana Dal, Arhar Dal, Ginger, Garlic, Onion, Tomato, Green Chilli, Dry Red Chilli, Turmeric Powder, Red Chilli Powder, Cumin Seeds, Lemon, Coriander, Sunflower Oil, Salt",16,10,15,25,4,Gujarati Recipesï»¿,Side Dish,Vegetarian
Curd Rice Recipe With Mint Flavour,"Rice, Curd, Mint Leaves, Sunflower Oil, Milk, Ginger, Carrot, Coriander, Salt, Mustard Seeds, Green Chilli, Asafoetida, Curry Leaves",13,10,20,30,3,Indian,Lunch,Vegetarian
Goan Style Patol Bhaji Recipe- Green peas Curry Recipe,"Dried Green Peas, Jaggery, Tamarind Water, Salt, Sunflower Oil, Onion, Fresh Coconut, Dry Red Chilli, Coriander, Cloves, Cumin Seeds, Fennel Seeds, Cinnamon Stick, Sichuan Peppercorns, Garlic, Ginger, Nutmeg, Star Anise, Turmeric Powder",19,60,30,90,4,Goan Recipes,Lunch,Vegetarian
Doli Ki Roti Recipe | Classic Sourdough Bread Recipe from Multan,"Brown Cardamom, Fennel Seeds, Chana Dal, Poppy Seeds, Sugar, Water, Whole Wheat Flour, Whole Wheat Flour, Sugar, Salt, Lukewarm Water Knead, Sunflower Oil Deep Fry, Chana Dal, Salt, Red Chilli Powder, Coriander Powder, Garam Masala Powder, Turmeric Powder, Ginger, Onion, Water",21,30,20,50,12,North Indian Recipes,Indian Breakfast,Vegetarian
Bhuna Murgh Recipe,"Chicken, Onion, Tomato, Cashew Nuts, Garlic, Ginger, Green Chilli, Red Chilli Powder, Coriander Powder, Turmeric Powder, Garam Masala Powder, Lemon Juice, Bay Leaf, Ajwain, Cardamom, Star Anise, Whole Black Peppercorns, Cloves, Black Cardamom, Cinnamon Stick, Kasuri Methi, Ghee Oil, Salt",23,15,25,40,2,North Indian Recipes,Lunch,High Protein Non Vegetarian
Ram Ladoo Recipe,"Yellow Moong Dal, Chana Dal, Green Chilli, Ginger, Coriander, Salt, Mooli Mullangi, Chaat Masala Powder, Mint Leaves, Coriander, Garlic, Ginger, Amchur, Salt, Green Chilli",15,220,10,230,4,North Indian Recipes,Snack,Vegetarian
Carrot Bran Breakfast Muffin Recipe,"All Purpose Flour, Whole Wheat Flour, Wheat Bran, Baking Powder, Baking Soda, Cinnamon Powder, Salt, Milk, Sunflower Oil, Honey Maple Syrup, Vanilla Extract, Whole Egg, Carrots, Orange Marmalade Jam, Grand Marnier",15,20,40,60,8,Continental,World Breakfast,Eggetarian
Mutton Galouti Kebab Recipe,"Mutton, Papaya, Cumin Powder, Coriander Powder, Garam Masala Powder, Onion, Ginger Garlic Paste, Black Pepper Powder, Gram Flour, Mint Leaves, Lemon Juice, Salt, Ghee, Sunflower Oil",14,540,30,570,4,North Indian Recipes,Appetizer,Non Vegeterian
Thai Green Curry Recipe With Sweet Potato & Green Beans,"Ginger, Garlic, Green Chilli, Lemongrass, Coriander, Coriander, Kaffir Lime Leaves, Green Beans, Sweet Potato, Turmeric Powder, Thai Yellow Curry Paste, Brown Sugar, Coconut Milk, Salt, Coconut Milk, Salt, Coconut Milk, Salt",18,20,30,50,4,Thai,Dinner,Vegetarian
Sabbakki Rava Idli Recipe- Sabudana Rava Idli,"Sooji, Mustard Seeds, Cumin Seeds, Chana Dal, Black Urad Dal, Cashew Nuts, Curry Leaves, Ginger, Green Chilli, Asafoetida, Sunflower Oil, Coriander, Enos Fruit Salt, Sabudana, Curd, Salt, Sunflower Oil Grease Idli Plates",17,20,35,55,4,South Indian Recipes,South Indian Breakfast,Vegetarian
Cabbage Slaw with Ginger Tahini Dressing Recipe,"Water, Tahini, Lemon Juice, Mustard Sauce, Tabasco Original, Honey, Ginger, Red Chilli Flakes, Red Cabbage, Cabbage, Carrots, Beetroot, Mint Leaves, Raw Peanuts",14,30,0,30,4,Continental,Appetizer,Vegetarian
Cabbage and Methi Paratha Recipe,"Whole Wheat Flour, Instant Oats, Cabbage, Methi Leaves, Onion, Red Chilli Powder, Ajwain, Curd, Salt, Sunflower Oil",10,20,25,45,4,Indian,North Indian Breakfast,Vegetarian
Nimbu Chunda Recipe (Lemon Chutney) - No Cook And Oil Free,"Lemons, Sugar, Salt, Red Chilli Powder",4,15,0,15,500,North Indian Recipes,Appetizer,Vegetarian
Panchratan Dal Paniyaram Recipe,"Barnyard Millet, Chana Dal, Arhar Dal, Green Moong Dal, White Urad Dal, Pink Masoor Dal, Onion, Green Chilli, Curry Leaves, Black Urad Dal, Mint Leaves, Ginger, Salt, Asafoetida, Sunflower Oil",15,20,30,50,4,South Indian Recipes,Snack,Vegetarian
Rajasthani Kachri Phali Ki Sabzi Recipe -Wild Cucumber And Beans Sabzi,"Gawar Phali, Kachri, Sunflower Oil, Cumin Seeds, Asafoetida, Turmeric Powder, Red Chilli Powder, Salt, Coriander Powder, Amchur",10,10,20,30,5,Rajasthani,Side Dish,Vegetarian
Mixed Vegetable Noodle Cutlet Recipe,"Rice Vermicelli Noodles, Potato, Carrot, Green Bell Pepper, Classic Mayonnaise, Tomato Salsa, Cheese, Salt, Black Pepper Powder, Whole Wheat Brown Bread, Oat Bran, Extra Virgin Olive Oil Shallow Fry",12,15,30,45,4,North Indian Recipes,Appetizer,Vegetarian
Cabbage & Dal Stuffed Paratha Recipe,"Whole Wheat Flour, Sunflower Oil, Water, Salt, Cabbage, Yellow Moong Dal, Green Chilli, Onion, Garlic, Cumin Seeds, Turmeric Powder, Red Chilli Powder, Ghee Oil For Smearing, Salt",14,30,30,60,4,Indian,Indian Breakfast,Diabetic Friendly
Lemon Rice Recipe - Elumichai Sadam/Chitranna,"Cooked Rice, Mustard Seeds, White Urad Dal, Raw Peanuts, Curry Leaves, Ginger, Green Chilli, Turmeric Powder, Salt, Sesame, Coriander",11,10,20,30,4,South Indian Recipes,Lunch,No Onion No Garlic (Sattvic)
Cheesy Paneer Masala Curry Recipe,"Paneer, Tomato, Britannia Cheese Spread, Onion, Ginger, Garlic, Black Cardamom, Turmeric Powder, Red Chilli Powder, Garam Masala Powder, Honey, Salt, Kasuri Methi, Sunflower Oil",14,15,50,65,6,North Indian Recipes,Side Dish,High Protein Vegetarian
No Bake Oreo Chocolate Tart Recipe,"Oreo Biscuits, Butter, Dark Chocolate, Heavy Whipping Cream, Fresh Cherries Fresh Strawberries, Oreo Biscuits, Mixed Nuts",7,10,20,30,4,Continental,Dessert,Vegetarian
Chicken Tikka Masala Recipe,"Chicken, Curd, Cumin Powder, Coriander Powder, Turmeric Powder, Ginger, Garlic, Red Chilli Powder, Kasuri Methi, Salt, Onion, Tomato, Cashew Nuts, Cumin Powder, Coriander Powder, Cloves, Cinnamon Powder, Cardamom Powder, Fresh Cream, Butter, Sunflower Oil, Salt",22,10,50,60,3,North Indian Recipes,Lunch,High Protein Non Vegetarian
Khus And Cucumber Mojito Recipe,"Cucumber, Lemon Juice, Sugar Syrup, Khus Syrup, Aerated Water, Ice Cubes, Mint Leaves, Lemon, Cucumber",9,5,15,20,4,Continental,Appetizer,Vegetarian
Pizza Margherita Recipe,"Whole Wheat Flour, Extra Virgin Olive Oil, Active Dry Yeast, Sugar, Dried Oregano, Mozzarella Cheese, Homemade Pizza And Pasta Sauce, Italian Seasoning, Basil Leaves",9,10,180,190,2,Italian Recipes,Dinner,Vegetarian
Chiba Dhokli Recipe,"Gram Flour, Green Chilli, Kasuri Methi, Asafoetida, Turmeric Powder, Caster Sugar, Salt, Lemon Juice, Sunflower Oil, Sunflower Oil, Mustard Seeds, Sesame Seeds, Pickle Masala",13,10,10,20,2,Gujarati Recipesï»¿,Snack,Vegetarian
Eggless Traditional Christmas Cake Recipe - Vegan Options,"Raisins, Prunes, Apricots, Dates, Dried Figs, Rum Brandy, Fresh Orange Juice, Orange Zest, All Purpose Flour, Baking Powder, Butter, Brown Sugar, Almond Meal, Cinnamon Powder, Cloves, Dry Ginger Powder, Badam, Flax Seed Powder, Chilled Water",19,20,70,90,6,Continental,Dessert,Vegetarian
Devil Chicken Recipe,"Kg Chicken, Roasted Tomato Pasta Sauce, Worcestershire Sauce, Ginger, Brown Sugar, Garlic, Onion, Red Chilli Flakes",8,60,25,85,4,Continental,Appetizer,High Protein Non Vegetarian
Vanilla Fruit Sauce With Left Over Fruits Recipe,"Apples, Ripe Bananas, Blueberries, Honey Dew Melon, Water, Vanilla Extract, Honey",7,0,30,30,6,Continental,Dessert,Vegetarian
Peanut Butter Cookies Recipe,"Vivatta Maida, Baking Powder, Peanut Butter, Vanilla Extract, Icing Sugar, Butter",6,20,15,35,15,Continental,Snack,Vegetarian
Thalapakattu Chicken Biryani Recipe,"Cumin Seeds, Fennel Seeds, Cardamom, Cloves, Cinnamon Stick, Mace, Dagad Phool, Star Anise, Chicken, Seeraga, Onion, Green Chilli, Tomato, Ginger, Garlic, Coriander Powder, Turmeric Powder, Red Chilli Powder, Coriander, Mint Leaves, Water, Salt, Sunflower Oil Cook",23,20,30,50,2,Tamil Nadu,Main Course,Non Vegeterian
Creamy Polenta Recipe  - Savory Cornmeal Porridge,"Polenta, Water, Milk, Extra Virgin Olive Oil, Butter, Black Pepper Powder, Salt",7,0,20,20,4,Italian Recipes,Side Dish,Vegetarian
Croissant Recipe,"All Purpose Flour, Butter, Salt, Butter",4,120,45,165,10,French,World Breakfast,Vegetarian
Open Toast Macaroni Recipe,"Whole Wheat Brown Bread, Butter, Macaroni Pasta, Butter, All Purpose Flour, Milk, Dried Thyme Leaves, Black Pepper Powder, Roasted Tomato Pasta Sauce, Cheese, Salt, Basil Leaves",12,0,35,35,4,Continental,World Breakfast,Vegetarian
Foxtail Millet Nippattu Recipe,"Foxtail Millet Flour, Rice Flour, Gram Flour, Raw Peanuts, Dry Red Chilli, Dessicated Coconut, Cumin Seeds, Sesame Seeds, Dill Leaves, Asafoetida, Butter, Hot Water, Salt, Sunflower Oil Deep Fry",14,10,20,30,4,South Indian Recipes,Snack,Vegetarian
Makhana Moongphali Kadhi With Samvat Rice Recipe,"Curd, Singoda Flour, Phool Makhana, Roasted Peanuts, Rock Salt, Red Chilli Powder, Sugar, Ghee, Cinnamon Powder, Dry Red Chilli, Few Curry Leaves, Cumin Seeds, Mustard Seeds, Few Roasted Peanuts, Phool Makhana, Coriander, Cumin Seeds, Cinnamon Stick, Cardamom, Cloves, Whole Black Peppercorns, Ginger, Green Chilli, Curry Leaves, Coriander, Raw Peanuts, Potato, Cashew Nuts  Optional, Raw Peanuts, Ghee Oil, Water, Rock Salt",32,30,15,45,4,Indian,Lunch,Vegetarian
Hariyali Machali Recipe - Carp Fish In Green Spinach And Coriander Gravy,"Carp Fish, Ginger, Garlic, Onion, Tomato, Dry Red Chilli, Kashmiri Red Chilli Powder, Garam Masala Powder, Cumin Seeds, Mustard Oil, Spinach, Coriander, Green Chilli, Black Pepper Powder, Salt",15,15,15,30,2,Indian,Dinner,High Protein Non Vegetarian
Sweet Potato Tacos With Black Beans And Avocado Cream Recipe,"Sweet Potato, Canned Black Beans, Paprika Powder, Cumin Powder, Salt, Sunflower Oil, Corn Flour Tortilla, Avocado, Shallots, Garlic, Purple Cabbage, Lemon Juice, Vinegar, Salt",14,20,30,50,4,Mexican,Dinner,Vegetarian
Healthy Vanilla Chocolate Chip Breakfast Muffins Recipe,"Instant Oats, Buckwheat Flour, Ripe Bananas, Peanut Butter, Maple Syrup Honey, Vanilla Extract, Baking Powder, Kala Chana, Enos Fruit Salt, Salt, Chocolate Chips",11,30,20,50,4,Continental,World Breakfast,Vegetarian
Avarekalu Usli Recipe,"Avarekai, Onion, Green Chilli, Turmeric Powder, Fresh Coconut, Cumin Seeds, Mustard Seeds, White Urad Dal, Dry Red Chilli, Curry Leaves, Coriander, Sunflower Oil, Salt",13,5,15,20,4,South Indian Recipes,Lunch,Vegetarian
Bengali Aam Chingri Recipe - Prawn Mango Curry In Mustard Sauce,"Prawns, Fresh Coconut, Mustard Seeds, Mango, Green Chilli, Mustard Oil, Kashmiri Red Chilli Powder, Turmeric Powder, Salt, Jaggery, Coconut Milk",11,20,15,35,4,Bengali Recipes,Side Dish,Non Vegeterian
Apple Pie Ice Cream Recipe,"Apples, Cinnamon Powder, Tablespoon Butter, Salt, Cup Heavy Whipping Cream, Cup Condensed Milk",6,30,120,150,6,Indian,Dessert,Vegetarian
Savory Melon Salad Recipe - Spiced with Ginger & Mint,"Watermelon, Musk Melon, Cucumbers, Mint Leaves, Extra Virgin Olive Oil, Lemon Juice, Honey, Ginger, Tabasco Original  Hot Sauce  Drizzle Over As Per Preference, Salt",10,10,15,25,2,Continental,Side Dish,Vegetarian
Baked Cheesy Masala Macaroni Recipe,"Macaroni Pasta, Garlic, Onion, Carrots, Green Bell Pepper, Homemade Tomato Puree, Pav Bhaji Masala, Mixed Herbs, Red Chilli Powder, Sunflower Oil, Salt, Sugar, Britannia Cheese Block",13,10,30,40,4,Fusion,Dinner,Vegetarian
Golgappa Chaat Recipe,"Sooji, All Purpose Flour, Sunflower Oil, Cumin Powder, Red Chilli Powder, Green Chutney, Sweet Chutney, Coriander, Mint Leaves, Potato, Kala Chana, Boondi, Curd, Sugar",14,60,40,100,4,North Indian Recipes,Snack,Vegetarian
Vendaikai (Okra) Puli Kootu Recipe,"Bhindi, Shallots, Onion, Garlic, Tomato, Ginger Garlic Paste, Tamarind, Red Chilli Powder, Cumin Seeds, Mustard Seeds, Sunflower Oil, Curry Leaves, Salt",13,15,25,40,6,Tamil Nadu,Lunch,Vegetarian
Patta Gobi Sabzi Recipe - Cabbage Tomato Sabzi,"Cabbage, Mustard Seeds, Cumin Seeds, Green Chilli, Tomato, Turmeric Powder, Coriander Powder, Red Chilli Powder, Salt, Sunflower Oil, Coriander",11,10,15,25,4,North Indian Recipes,Lunch,Vegetarian
Methi Matar Pulao Recipe - Fenugreek Green Peas Pulao,"Green Peas, Rice, Methi Leaves, Cumin Seeds, Ginger, Green Chilli, Coconut Milk, Turmeric Powder, Cloves, Cardamom, Cinnamon Stick, Bay Leaf, Ghee Sesame Oil, Salt",14,20,45,65,4,Indian,Lunch,Vegetarian
Masoor Dal And Palak Khichdi Recipe,"Rice, Masoor Dal, Spinach Leaves, Ginger, Asafoetida, Panch Phoran Masala, Cinnamon Stick, Bay Leaf, Turmeric Powder, Cardamom, Green Chilli, Tomato, Ghee, Salt",14,25,45,70,2,Indian,Dinner,High Protein Vegetarian
Grilled Hummus Paneer Bhurji Sandwich Recipe,"Kabuli Chana, Sesame Seeds, Garlic, Lemon, Cumin Powder, Extra Virgin Olive Oil, Onion, Green Bell Pepper, Carrots, Paneer, Britannia Cheese Block, Cumin Powder, Red Chilli Powder, Salt, Extra Virgin Olive Oil, Whole Wheat Brown Bread",16,15,15,30,6,Fusion,Indian Breakfast,High Protein Vegetarian
Udupi Tomato Rasam Recipe,"Arhar Dal, Tomato, Tamarind Water, Jaggery, Coriander, Methi Seeds, Mustard Seeds, Cumin Seeds, Coriander, Fresh Coconut, Dry Red Chilli, Asafoetida, Curry Leaves, Ghee, Mustard Seeds, Dry Red Chilli, Curry Leaves",17,10,45,55,4,Udupi,Main Course,Vegetarian
Sweet Dashami Recipe (Maharashtrian Flatbread Made With Wheat Flour & Sugarcane Juice),"Sugarcane Juice, Whole Wheat Flour, Nutmeg Powder, Ghee, Salt",5,15,20,35,4,Maharashtrian Recipes,Main Course,Vegetarian
Ginger Brandy Cookie Recipe,"All Purpose Flour, Salt, Baking Powder, Dry Ginger Powder, Cinnamon Powder, Butter, Sugar, Honey, Whole Eggs, Brandy",10,20,45,65,6,Continental,Snack,Vegetarian
Potato Sagu Recipe for Rava Idli,"Potato, Onion, Green Chilli, Ginger, Curry Leaves, Mustard Seeds, White Urad Dal, Chana Dal, Asafoetida, Turmeric Powder, Coriander Powder, Coriander, Sugar, Lemon Juice, Salt, Sunflower Oil",16,20,35,55,4,South Indian Recipes,South Indian Breakfast,Vegetarian
Homemade Mysore Pak Recipe | Traditional Recipe Made With Ghee,"Gram Flour, Ghee, Sugar, Water",4,15,20,35,12,Karnataka,Dessert,Vegetarian
Mushroom and Broccoli Soup Recipe,"Broccoli, Button Mushrooms, Cumin Seeds, Whole Black Peppercorns, Salt, Fresh Cream, Coriander, Sunflower Oil",8,20,20,40,4,Continental,Appetizer,Vegetarian
Mediterranean Cucumber Salad Recipe,"Cucumber, Tomato, Onion, Mint Leaves, Coriander, Extra Virgin Olive Oil, Salt, Lemon Juice, Black Pepper Powder",9,20,0,20,4,Mediterranean,Appetizer,Vegetarian
Mixed Vegetable Spaghetti Pasta Recipe,"Del Monte Spaghetti Pasta, Onion, Tomato, Green Bell Pepper, Baby Corn, Ginger Garlic Paste, Extra Virgin Olive Oil, Green Chilli Sauce, Roasted Tomato Pasta Sauce, Red Chilli Flakes, Italian Seasoning, Salt",12,10,30,40,2,Italian Recipes,Dinner,Vegetarian
Mascarpone Fruit Dessert Recipe,"Mascarpone Cheese, Honey, Sugar, Vanilla Extract, Strawberries, Kiwi, Ripe Bananas, Dried Raspberries, Blueberries, Choco Thins",10,20,260,280,4,Italian Recipes,Dessert,Vegetarian
Nagli Rava Upma Recipe - Healthy Ragi Rava Upma Recipe,"Ragi Rava, Carrot, Green Beans, Cauliflower, Garlic, Ghee, Sunflower Oil, Mustard Seeds, Cumin Seeds, Curry Leaves, Ginger, Asafoetida, Roasted Peanuts, Green Chilli, Mint Leaves, Lemon Juice",16,20,25,45,4,South Indian Recipes,South Indian Breakfast,Vegetarian
Rajasthani Pyaaz Ki Kadhi Recipe - Onion Kadhi Recipe,"Curd, Gram Flour, Turmeric Powder, Red Chilli Powder, Water, Onion, Ginger, Mustard Seeds, Methi Seeds, Ssp Asafoetida, Ghee, Ghee, Cumin Seeds, Coriander, Dry Red Chilli, Curry Leaves",16,10,15,25,4,Rajasthani,Side Dish,High Protein Vegetarian
Spicy Chow Mein Noodle Wrap Recipe,"Rice Paper Rolls, Hakka Noodles, Mixed Vegetables, Ginger, Green Chilli, Soy Sauce, Green Chilli Sauce, Red Chilli Sauce, Roasted Tomato Pasta Sauce, Vinegar, Whole Black Peppercorns, Salt, Sugar, Extra Virgin Olive Oil, Lukewarm Water",15,10,30,40,4,Fusion,Snack,Vegetarian
"Spicy Peanut, Black Rice Salad With Mango, Grapes And Avocado Recipe","Black Rice, Orange, Lemon Juice, Extra Virgin Olive Oil, Homemade Hoisin Sauce, Green Seedless Grapes, Mango, Avocado, Coriander, Onion, Boiled Peanuts, Green Chilli, Clove Garlic, Spring Onion, Salt And Pepper",15,45,15,60,4,Continental,Appetizer,Vegetarian
Baked Cheesy Rigati Pasta Recipe With Roasted Veggies,"Del Monte Chifferi Rigati Pasta, Green Zucchini, Carrot, Red Bell Pepper, Whole Wheat Bread Crumbs, Cheese, Onion, Garlic, Homemade Tomato Puree, Basil Leaves, Sugar, Fresh Cream, Dried Oregano, Salt",14,30,45,75,4,Italian Recipes,Dinner,Vegetarian
Mediterranean Inspired Spicy Grilled Chicken Recipe,"Chicken, Red Chilli Paste, Ginger Garlic Paste, Onion Powder, Red Chilli Flakes, Cumin Powder, Dried Oregano, Parsley Leaves, Lemons, Extra Virgin Olive Oil",10,15,30,45,4,Mediterranean,Main Course,High Protein Non Vegetarian
Lauki Aloo Sabzi Recipe - Bottle Gourd Potato Vegetable Curry,"Potato, Bottle Gourd, Tomato, Onion, Ginger, Green Chilli, Turmeric Powder, Coriander Powder, Black Pepper Powder, Salt, Kalonji, Sunflower Oil",12,15,40,55,4,Indian,Lunch,Vegetarian
Aloo Beetroot and Baby Corn Mixed Sabzi Recipe,"Potato, Beetroot, Baby Corn, Carrots, Green Beans, Green Chilli, Mustard Oil, Mustard Seeds, Garlic, Ginger, Salt, Coriander",12,15,15,30,3,North Indian Recipes,Main Course,Vegetarian
Schezwan Poha Recipe (Fusion Recipe),"Poha, Onion, Garlic, Green Beans, Carrots, Red Yellow And Green Bell Peppers, Red Chilli Sauce, Whole Black Peppercorns, Sunflower Oil, Salt",10,10,15,25,4,Indo Chinese,Indian Breakfast,Vegetarian
Crunchy Asian Vegetable Salad Recipe With Honey Garlic Dressing,"Cucumber, Carrots, Purple Cabbage, Green Zucchini, Spring Onion Greens, Brown Sugar, Honey, Lemon Juice, Chilli Vinegar, Soy Sauce, Garlic, Ginger, Red Chilli Flakes, Salt, Sesame Seeds",15,15,0,15,4,Asian,Appetizer,Vegetarian
Murungai Keerai Thanni Saaru Recipe-Drumstick Leaves Soup,"Drumstick Leaves, Rice Water, Pearl Onion, Tomato, Green Chilli, Coconut Milk, Cumin Seeds, Whole Black Peppercorns, Salt, Cumin Seeds, Curry Leaves, Sunflower Oil, Dry Red Chilli",13,10,15,25,5,Tamil Nadu,Lunch,Vegetarian
Batani Gassi Recipe - Udupi Style Potatoes And Peas Curry,"Dried Green Peas, Potato, Turmeric Powder, Fresh Coconut, Coriander, White Urad Dal, Cumin Seeds, Dry Red Chilli, Jaggery, Tamarind Paste, Mustard Seeds, Curry Leaves, Salt",13,10,30,40,4,Udupi,Side Dish,Vegetarian
Roasted Baby Potatoes Recipe,"Baby Potato, Garlic, Black Pepper Powder, Dried Oregano, Stalk Spring Onion, Salt, Butter, Sunflower Oil",8,5,35,40,4,Continental,Side Dish,Vegetarian
Rajasthani Chawle Wale Dhokle Recipe,"Garlic, Green Chilli, Coriander, Makki Ka Atta, Baking Soda, Salt, Water, Black Eyed Beans, Turmeric Powder, Coriander Powder",10,10,30,40,6,Rajasthani,Dinner,Vegetarian
Ambode Recipe (Karnataka Style Masala Vada),"Chana Dal, Dill Leaves, Coriander, Onion, Green Chilli, Ginger, Rice Flour, Salt, Turmeric Powder, Asafoetida, Sunflower Oil",11,300,60,360,20,Karnataka,Snack,Vegetarian
Lemon Grass Oats & Almonds Pudding Recipe with Macerated Berries,"Blueberries, Cranberries, Water, Brown Sugar, Lemon Zest, Fresh Cream, Milk, Kaffir Lime Leaves, Lemongrass, Instant Oats, Almond Meal, Sugar, Badam",13,200,60,260,4,Continental,Dessert,Vegetarian
Andhra Style Mukkala Pulusu Recipe-Mixed Vegetable Sambar,"Mangalorean Cucumber, Carrot, Green Beans, Kaddu, Bottle Gourd, Drumstick, Shallots, Tomato, Green Chilli, Turmeric Powder, Tamarind, Jaggery, Sambar Powder, Coriander, Salt, Sunflower Oil, Mustard Seeds, Cumin Seeds, Methi Leaves, Asafoetida, Garlic, Dry Red Chilli, Curry Leaves",23,10,20,30,4,Andhra,Lunch,Vegetarian
Vegetable Quinoa Patty Recipe,"Quinoa, Onion, Sweet Corn, Carrot, Spinach, Corn Flour Besan, Black Pepper Powder, Red Chilli Flakes, Sunflower Oil, Salt",10,20,20,40,4,Continental,Snack,Vegetarian
Cekodok/Jemput-Jemput Pisang Recipe (Vegan Fried Banana Balls),"Ripe Bananas, All Purpose Flour, Baking Soda, Salt, Sugar, Sesame Seeds",6,10,25,35,4,Malaysian,Snack,Vegetarian
Homemade Chocolate Almond Spread Recipe,"Badam, Fresh Cream, Milk Chocolate, Dark Chocolate, Salt, Vanilla Extract",6,10,60,70,20,Continental,Side Dish,Vegetarian
Parsi Style Vegetable Dhansak Recipe- Parsi Vegetable Dal,"Arhar Dal, Yellow Moong Dal, Chana Dal, Methi Leaves, Mint Leaves, Green Chilli, Small Brinjal, Kaddu, Turnips, Onion, Turmeric Powder, Onion, Tomato, Sunflower Oil Ghee, Lemon Juice, Salt, Water, Garlic, Ginger, Green Chilli, Whole Black Peppercorns, Cumin Seeds, Cloves, Cinnamon Stick, Coriander",25,25,50,75,4,Parsi Recipes,Dinner,High Protein Vegetarian
Pavlova Recipe With Strawberries,"Egg White, Caster Sugar, Corn Flour, Vinegar, Mascarpone Cheese, Strawberry Compote Serve",6,30,80,110,6,Continental,Dessert,Eggetarian
Tofu Peanut Stir Fry Recipe,"Tofu, Corn Flour, Button Mushrooms, Bok Choy, Sunflower Oil, Salt, Roasted Peanuts, Peanut Butter, Rice Wine Vinegar, Soy Sauce, Brown Sugar, Ginger, Garlic, Salt, Sesame",15,15,15,30,4,Thai,Side Dish,High Protein Vegetarian
Banana Chia Seeds Muesli Muffin Recipe,"Whole Wheat Flour, Cocoa Powder, Salt, Baking Powder, Muesli, Chia Seeds, Ripe Bananas, Dates, Milk, Vanilla Extract, Honey, Extra Virgin Olive Oil, Egg Whites",13,20,45,65,4,Continental,Snack,Sugar Free Diet
Mocha Chingri Manohara Recipe (Shrimps Stuffed Banana Flower Kofta Curry),"Banana Flower, Buttermilk, Shrimps, Ginger Garlic Paste, Coriander Powder, Red Chilli Powder, Turmeric Powder, Gram Flour, Garam Masala Powder, Corn Flour, Sugar, Salt, Sunflower Oil Fry On Paniyaram Pan, Cinnamon Stick, Cardamom, Onion, Homemade Tomato Puree, Curd, Poppy Seeds, Cashew Nuts, Green Chilli, Red Chilli Powder, Garam Masala Powder, Sugar, Salt, Ghee Butter, Sunflower Oil",27,30,35,65,6,Bengali Recipes,Side Dish,Non Vegeterian
Kerala Style Chicken Stew Recipe,"Chicken, Cinnamon Stick, Whole Black Peppercorns, Carrot, Green Beans, Potato, Onion, Green Chilli, Garlic, Ginger, Cashew Nuts, Turmeric Powder, Black Pepper Powder, Coconut Oil, Salt, Onion, Garlic, Curry Leaves, Coconut Oil",19,10,25,35,4,Kerala Recipes,Lunch,High Protein Non Vegetarian
Mexican Hot Chocolate Recipe,"Milk, Cinnamon Stick, Dark Chocolate, Palm Sugar, Corn Flour",5,0,15,15,4,Mexican,Snack,Vegetarian
Steamed Chicken With Salad Recipe,"Chicken Breasts, Black Pepper Powder, Salt, Cabbage, Carrot, Red Bell Pepper, Whole Egg, Coriander, Fresh Orange Juice, Extra Virgin Olive Oil, Salt And Pepper",11,10,30,40,1,Continental,Appetizer,High Protein Non Vegetarian
Karwar Style Valval Recipe (Mixed Vegetables In Coconut Milk),"Green Beans, Carrot, Green Peas, Potato, Mangalorean Cucumber, Pointed Gourd, Green Chilli, Coconut Milk, Mustard Seeds, Cumin Seeds, Dry Red Chilli, Coconut Oil, Curry Leaves",13,15,20,35,4,Coastal Karnataka,Lunch,Vegetarian
Goan Style Dhayanche Fov Recipe (Curd Poha Recipe),"Poha, Hung Curd, Sugar, Cardamom, Salt",5,15,0,15,4,Goan Recipes,Snack,Vegetarian
Wheat Ladoo With Jaggery Recipe,"Whole Wheat Flour, Jaggery, Water, Ghee, Cardamom Powder",5,15,15,30,12,Indian,Dessert,Vegetarian
Turmeric Latte Recipe,"Cup Milk Almond Milk, Turmeric Powder, Honey, Cinnamon Powder, Nutmeg Powder, Maple Syrup, Fresh Coconut, Black Pepper Powder, Star Anise",9,10,10,20,2,Indian,Snack,Vegetarian
"Guilt-free Amaranth, Dates and Almond Ladoo Recipe","Amaranth Seeds, Dates, Cardamom Powder, Badam, Badam, Coconut Oil",6,10,45,55,5,Indian,Snack,High Protein Vegetarian
Cheese Stuffed Mashed Potato Balls Recipe (Non Fried),"Potato, Cup Carrot, Cup Cheese, Black Pepper Powder, Garlic Powder, Tablespoons Extra Virgin Olive Oil, Salt",7,20,10,30,9,Asian,Appetizer,Vegetarian
Plum Panna Shot Recipe,"Plums, Jaggery Sugar As Required, Cumin Powder, Mint Leaves, Black Salt, Water",6,15,0,15,4,Continental,Appetizer,Vegetarian
Garlic Spaghetti with Roasted Red Bell Pepper Sauce Recipe (Vegan),"Spaghetti Pasta, Extra Virgin Olive Oil, Garlic, Red Chilli Flakes, Rosemary Any Herb Of Your Choice, Red Bell Pepper, Garlic, Corn Flour, Red Chilli Flakes, Salt",10,10,20,30,2,Italian Recipes,Dinner,Vegetarian
Shukto Recipe - Bengali Mixed Vegetable in Mustard and Poppy Seed Gravy,"Karela, Raw Banana, Carrot, Potato, Ridge Gourd, Drumstick, Panch Phoran Masala, Mustard Seeds, Poppy Seeds, Milk, Sugar, Salt, Mustard Oil, Turmeric Powder, Bay Leaf, Ginger, Green Chilli, Dry Red Chilli",18,20,20,40,4,Bengali Recipes,Lunch,Vegetarian
Mixed Beans Salad Recipe,"Rajma, Soybeans, Black Eyed Beans, , Onion, Red Bell Pepper, Yellow Bell Pepper, Green Bell Pepper, Cherry Tomato  Halved, Spring Onion Greens, Coriander, Extra Virgin Olive Oil, White Wine Vinegar, Classic Mayonnaise, Dijon Mustard, Black Pepper Powder, Salt",17,350,15,365,2,Continental,Side Dish,Vegetarian
Sweet Pretzels Recipe - Bhonge Ladoo,"Wheat Bran  Plus  Tablespoons, Salt, Jaggery, Water  Divided, Sesame Seeds, Sunflower Oil",6,10,60,70,5,Maharashtrian Recipes,Snack,Vegetarian
Mozzarella & Parmesan Stuffed Meat Balls Recipe,"Mutton, Parmesan Cheese, Mozzarella Cheese, Onion, Black Pepper Powder, Green Chilli, Coriander, Parsley Leaves, Ginger Garlic Paste, Extra Virgin Olive Oil, Salt, Homemade Tomato Puree, Extra Virgin Olive Oil, Mixed Herbs, Basil Leaves, Dried Oregano, Black Pepper Powder, Rosemary, Salt",19,10,40,50,2,Italian Recipes,Dinner,Non Vegeterian
Bengali Style Raw Jackfruit Curry Recipe - Enchorâer Dalana,"Jackfruit Raw, Black Cardamom, Cinnamon Stick, Onion, Ginger Garlic Paste, Green Chilli, Hung Curd, Turmeric Powder, Red Chilli Powder, Cumin Powder, Garam Masala Powder, Salt, Sugar, Bay Leaves, Ghee, Mustard Oil",16,10,40,50,4,Bengali Recipes,Lunch,Vegetarian
"Sweet Corn, Methi & Tomato Rice Recipe","Cooked Rice, Tomato, Onion, Garlic, Garlic, Sweet Corn, Green Chilli, Methi Leaves, Salt, Sunflower Oil, Cumin Seeds, Cinnamon Stick, Cardamom, Star Anise, Bay Leaf, Turmeric Powder, Coriander Powder, Garam Masala Powder, Red Chilli Powder",19,10,35,45,4,North Indian Recipes,Lunch,Vegetarian
Paneer Bread Balls Recipe -Cottage Cheese & Bread Croquettes,"Paneer, Potato, Whole Wheat Brown Bread, Cumin Powder, Garam Masala Powder, Black Pepper Powder, Coriander, Salt, Sunflower Oil",9,10,30,40,4,North Indian Recipes,Appetizer,Vegetarian
Sandah Guri Recipe (Assamese Roasted Rice Flour Porridge),"Rice, Milk, Jaggery  Grated, Ghee, Raisins",5,150,15,165,2,Assamese,North Indian Breakfast,Gluten Free
Bengali Sita Bhog Recipe,"Govind Bhog Rice, Paneer, Cardamom Powder, Raisins, Pistachios, Few Saffron Strands, Sugar, Ghee Oil For Frying, Milk Powder, All Purpose Flour, Cooking Soda, Ghee, Curd, Sugar, Cardamom Powder",15,120,70,190,4,Bengali Recipes,Dessert,Vegetarian
Warqi Paratha Recipe,"All Purpose Flour, Ghee, Salt, Sugar, Milk, Ghee, Water, All Purpose Flour, Ghee Shallow Fry The Parathas",9,120,25,145,6,North Indian Recipes,Lunch,Vegetarian
Spinach Mushroom Scrambled Eggs Recipe,"Whole Eggs, Salt, Black Pepper Powder, Butter, Button Mushrooms, Spinach Leaves",6,10,15,25,2,Continental,World Breakfast,Eggetarian
Ginger Lemon Black Tea Recipe,"Water, Assam Tea Leaves, Lemon, Ginger, Honey",5,5,5,10,2,Indian,Snack,Vegetarian
Spicy Paneer Frankie Recipe,"Paneer, Corn Flour Tortilla Whole Wheat Flour Tortilla, Onion, Green Bell Pepper, Garlic, Green Chilli, Red Chilli Sauce, Soy Sauce, Roasted Tomato Pasta Sauce, Black Pepper Powder, Salt, Cabbage, Cheese Spread, Butter, Sunflower Oil",15,10,25,35,4,Maharashtrian Recipes,Snack,Vegetarian
Rava Rotti Recipe (Karnataka Style Semolina Flat Bread),"Sooji, Curd, Fresh Coconut, Cumin Seeds, Onion, Carrot, Green Chilli, Ginger, Coriander, Curry Leaves, Salt, Water, Sunflower Oil Roast",13,30,30,60,4,Coastal Karnataka,Snack,Vegetarian
No Yeast Thin Crust Veggie Pizza Recipe,"All Purpose Flour, Salt, Curd, Baking Powder, Extra Virgin Olive Oil, Extra Virgin Olive Oil, Green Bell Pepper, Onion, Homemade Pizza And Pasta Sauce, Tomato, Black Olives, Mozzarella Cheese, Mozzarella Cheese",13,10,60,70,2,Italian Recipes,Dinner,Vegetarian
Masoor Moong Phali Ki Dal Recipe,"Masoor Dal, Peanuts, Ginger, Green Chilli, Onion, Tomato, Bay Leaf, Turmeric Powder, Garam Masala Powder, Salt, Ghee, Cumin Seeds, Cinnamon, Coriander Leaves, Lemon Juice",15,10,35,45,4,North Indian Recipes,Lunch,High Protein Vegetarian
Macaroni Chaat,"Macaroni, Onion, Tomato, Sweet Corn, Peanuts, Red Chili Powder, Teaspoon Chaat Masala Powder, Green Chutney, Tamarind Chutney, Lemon Juice, Salt, Save, Green Coriander",13,20,10,30,2,Fusion,Snack,Vegetarian
Savoury Yogurt Parfait Recipe,"Hung Curd, Beetroot, Carrot, Red Radish   Couple Of Slices For Garnish, Mint Leaves, Cumin Seeds, Whole Black Peppercorns, Ginger, Roasted Peanuts, Green Moong Sprouts, Puffed Grains, Sunflower Seeds, Salt",13,20,0,20,4,Continental,World Breakfast,Vegetarian
Teriyaki Chicken Recipe,"Chicken Breasts, Corn Flour, Red Bell Pepper, Broccoli, Rice, Sunflower Oil, Brown Sugar, Honey, Soy Sauce, Red Chilli Sauce, Garlic, Ginger, Black Pepper Powder, Chilled Water",14,10,45,55,4,Japanese,Main Course,Non Vegeterian
Jimikand ke Kebab Recipe (Yam Kebabs),"Elephant Yam, Coriander, Green Chilli, Ginger, Garlic, Whole Black Peppercorns, Onion, Chaat Masala Powder, Cumin Powder, Gram Flour, Whole Wheat Bread Crumbs",11,15,45,60,4,Lucknowi,Appetizer,Vegetarian
Karnataka Style Bendekayi Gojju - Kayirasa Recipe,"Bhindi, Fresh Coconut, Dry Red Chilli, White Urad Dal, Chana Dal, Tamarind, Jaggery, Mustard Seeds, Dry Red Chilli, Curry Leaves, Sunflower Oil, Salt",12,10,20,30,4,North Karnataka,Lunch,Vegetarian
Kodava Kootu Curry Recipe - Coorg Style Mixed Vegetable Stew,"Carrots, Green Beans, Brinjal, Tomato, Arhar Dal, Salt, Ghee, Mustard Seeds, Cumin Seeds, Coriander, White Urad Dal, Chana Dal, Dry Red Chilli, Rice, Fresh Coconut, Tamarind, Turmeric Powder, Ghee, Mustard Seeds, Curry Leaves, Asafoetida, Garlic, Ghee",23,10,25,35,4,Coorg,Lunch,Vegetarian
Thenthuk Soup Recipe - Tibetan Style Noodle Soup,"Whole Wheat Flour, Instant Oats, Salt, Sunflower Oil, Water Knead, Onion, Ginger, Garlic, Tomato, Green Zucchini, Red Chilli Sauce, Green Chilli Sauce, Soy Sauce",13,10,30,40,3,Asian,Appetizer,Vegetarian
Broccoli Egg Scramble Recipe,"Whole Eggs, Broccoli, Black Pepper Powder, Salt, Sunflower Oil",5,5,30,35,4,Continental,World Breakfast,Eggetarian
Lucknowi Murgh Biryani Recipe - Awadhi Style Chicken Biryani,"Basmati Rice, Chicken, Onion, Ginger Garlic Paste, Green Chilli, Mint Leaves, Coriander, Fresh Coconut, Khuskhus, Fresh Cream, Hung Curd, Coriander Powder, Red Chilli Powder, Turmeric Powder, Salt, Sunflower Oil, Ghee, Lemon, Saffron Strands, Kewra Water, Onion, Bay Leaf, Cinnamon Stick, Cloves, Whole Black Peppercorns, Cardamom, Star Anise, Black Cardamom, Nutmeg Powder, Mace, Ajwain",31,50,120,170,4,Awadhi,Lunch,Non Vegeterian
Chicken And Egg Slider Recipe With Cheesy Garlic Mayo,"Whole Eggs, Boneless Chicken, Del Monte Cheesy Garlic Mayo, Spring Onion, Black Pepper Powder, Extra Virgin Olive Oil Butter, Slider Bun, Salt",8,15,60,75,4,Continental,Dinner,Non Vegeterian
Kela Methi Bhajiya Recipe,"Ripe Bananas, Methi Leaves, Gram Flour, Whole Wheat Flour, Cooking Soda, Cumin Seeds, Red Chilli Powder, Black Pepper Powder, Turmeric Powder, Asafoetida, Salt, Sugar, Water, Sunflower Oil",14,15,15,30,5,Gujarati Recipesï»¿,Appetizer,Vegetarian
Fluffy Corn Muffins Recipe,"Whole Eggs, Vivatta Maida, Baking Powder, Salt, Makki Ka Atta, Sugar, Milk, Extra Virgin Olive Oil, Butter",9,20,10,30,6,Continental,Snack,Vegetarian
Rajma Galouti Kebab Recipe,"Rajma, Potato, Paneer, Mint Leaves, Cashew Nuts, Ginger, Garlic, Green Chilli, Rose Water, Saffron Strands, Garam Masala Powder, Chaat Masala Powder, Onion, Gram Flour, Salt, Sunflower Oil",16,20,45,65,4,Awadhi,Appetizer,Vegetarian
Suran Moongphali Curry Recipe (Yam/Jimikand Curry with Peanuts),"Elephant Yam, Roasted Peanuts, Green Chilli, Cumin Seeds, Black Salt, Turmeric Powder, Sugar",7,15,30,45,4,Indian,Lunch,Vegetarian
Calcutta Style Chicken Biryani Recipe,"Boneless Chicken, Basmati Rice, Potato, Curd, Red Chilli Powder, Turmeric Powder, Onion, Ginger, Garlic, Green Chilli, Black Cardamom, Bay Leaves, Cardamom, Cinnamon Stick, Cloves, Whole Black Peppercorns, Kewra Water, Salt, Ghee",19,60,40,100,4,Indian,Lunch,Non Vegeterian
Sprouted Methi & Kachha Aam Salad Recipe,"Methi Seeds, Mango, Cranberries, Walnuts, Lemon Juice, Honey, Paprika Powder, Salt",8,20,5,25,4,Indian,Appetizer,High Protein Vegetarian
Assamese Boror Tenga Recipe (Vegetarian Sour Curry With Masoor Dal Fritters),"Masoor Dal, Green Chilli, Asafoetida, Salt, Sunflower Oil Deep Fried, Onion, Tomato, Potato, Bottle Gourd, Turmeric Powder, Red Chilli Powder, Coriander Powder, Salt, Mustard Oil, Panch Phoran Masala, Bay Leaves, Dry Red Chilli, Coriander",18,30,30,60,4,Assamese,Side Dish,High Protein Vegetarian
Quick Prawn Tikka Masala Recipe,"Prawns, Lemon Juice, Red Chilli Powder, Salt, Ginger Garlic Paste, Hung Curd, Fresh Cream, Onion, Tomato, Kashmiri Red Chilli Powder, Salt, Turmeric Powder, Cumin Seeds, Garam Masala Powder, Ginger Garlic Paste, Butter, Sunflower Oil, Tandoori Masala",18,15,15,30,2,North Indian Recipes,Dinner,Non Vegeterian
Golden Turmeric Almond Saffron Milk Shot Recipe,"Whole Turmeric, Ginger, Brown Sugar, Honey, Cinnamon Stick, Cardamom, Saffron Strands, Almond Meal, Milk, Raisins",10,5,20,25,4,Indian,Vegetarian,Vegetarian
Amritsari Dal Recipe,"Black Urad Dal, Chana Dal, Onion, Tomato, Green Chilli, Ginger, Garlic, Ajwain, Red Chilli Powder, Garam Masala Powder, Cinnamon Stick, Salt, Sunflower Oil",13,10,30,40,4,Punjabi,Lunch,High Protein Vegetarian
Khatti Meethi Tinda Masala Recipe,"Tinda, Ajwain, Tomato, Ginger, Green Chilli, Turmeric Powder, Red Chilli Powder, Amchur, Jaggery, Salt, Sunflower Oil, Kasuri Methi",12,10,30,40,4,North Indian Recipes,Side Dish,Vegetarian
Mustard Prawns In Coconut Recipe,"Prawns, Kasundi Mustard Sauce, Green Chilli, Mustard Oil, Kalonji, Turmeric Powder, Red Chilli Powder, Salt, Coriander, Coriander",10,8,30,38,4,Bengali Recipes,Lunch,Non Vegeterian
Beetroot Greens Rice Recipe,"Cooked Rice, Beetroot Greens, Onion, Ginger, Garlic, Red Chilli Powder, Coriander Powder, Sunflower Oil, Mustard Seeds, Cumin Seeds, Curry Leaves, Salt",12,20,15,35,4,Indian,Dinner,Vegetarian
Masoor Moong Phali Ki Dal Recipe (Masoor Dal With Peanuts Recipe),"Masoor Dal, Raw Peanuts, Ginger, Green Chilli, Onion, Tomato, Bay Leaf, Turmeric Powder, Garam Masala Powder, Salt, Ghee, Cumin Seeds, Cinnamon Stick, Coriander, Lemon Juice",15,10,35,45,4,North Indian Recipes,Lunch,High Protein Vegetarian
Quinoa Veg Soup (Bolivian Style Stew) Recipe,"Quinoa, Kala Chana, Vegetable Stock, Onion, Bay Leaf, Water, Carrots, Green Bell Pepper, Ginger, Sunflower Oil, Homemade Tomato Puree Pasta Sauce, Kashmiri Red Chilli Powder, Cumin Seeds, Coriander Powder, Coriander",15,20,40,60,4,Continental,Dinner,Vegetarian
Mixed Vegetable Jalfrezi Recipe,"Carrot, Green Beans, Green Bell Pepper, Sweet Corn, Green Peas, Onion, Tomato, Ginger Garlic Paste, Turmeric Powder, Red Chilli Powder, Coriander Powder, Garam Masala Powder, Kasuri Methi, Coriander, Salt, Sugar, Cumin Seeds, Sunflower Oil",18,10,20,30,4,North Indian Recipes,Side Dish,Vegetarian
Herbed Potato And Green Olive Salad Recipe - A Delicious Summertime Salad,"Baby Potato, Extra Virgin Olive Oil, Red Onion, Garlic, Lemon Juice, Coconut Milk, Salt, Whole Black Peppercorns, Basil Leaves, Green Olives",10,10,30,40,4,Italian Recipes,Dinner,Vegetarian
Peanut Cucumber Salad Recipe,"Roasted Peanuts, Tomato, Cucumber, Onion, Green Chilli, Salt, Chaat Masala Powder, Lemon Juice",8,15,0,15,4,Indian,Appetizer,Vegetarian
Tomato Upma Recipe,"Sooji, Tomato, Onion, Green Chilli, Mustard Seeds, Dry Red Chilli, Curry Leaves, Asafoetida, Salt, Hot Water, Red Chilli Powder, Turmeric Powder, Lemon Juice, Coriander",14,10,30,40,4,South Indian Recipes,South Indian Breakfast,Vegetarian
Eggless Pumpkin Cheesecake Recipe,"Kaddu, Britannia Cream Cheese, Brown Sugar, Dark Chocolate, Dry Ginger Powder, Cinnamon Powder, Butter, Salt, Oreo Biscuits, Butter, Caster Sugar",11,20,50,70,6,European,Dessert,Vegetarian
Chicken Galauti Kebab Recipe,"Boneless Chicken, Raw Papaya, Onion, Ginger, Garlic, Cardamom Powder, Red Chilli Powder, Gram Flour, Garam Masala Powder, Mace Powder, Coriander Powder, Salt, Sunflower Oil",13,20,10,30,4,Awadhi,Appetizer,High Protein Non Vegetarian
Green Chutney Recipe,"Green Coriander, Mint, Curry Leaves, Peanuts Almonds, Ginger, Green Chilies, Sugar, Large Spoon Lemon Juice, Salt",9,10,20,30,4,North Indian Recipes,Side Dish,Vegetarian
Andhra Style Karivepaku Pachadi Recipe (Curry Leaf Chutney Recipe),"S Curry Leaves, Chana Dal, Dry Red Chilli, Ginger, Tamarind Water, Mustard Seeds, Dry Red Chilli",7,0,20,20,4,Andhra,South Indian Breakfast,Diabetic Friendly
Aloo Konir Dom Recipe (Assamese Egg & Potato Curry),"Whole Eggs, Potato, Onion, Ginger Garlic Paste, Tomato, Green Chilli, Salt, Sunflower Oil, Coriander, Bay Leaf, Dry Red Chilli, Cumin Seeds, Cardamom, Cloves, Cinnamon Stick, Turmeric Powder, Cumin Powder, Coriander Powder",18,15,30,45,4,Assamese,Lunch,Eggetarian
Sukhi Urad Dal Sabzi Recipe,"White Urad Dal, Water, Onion, Ginger, Green Chili, Cumin, Asafoetida, Spoon Turmeric Powder, Coriander Powder, Garam Masala Powder, Salt, Ghee, Lemon, Coriander",14,10,30,40,2,North Indian Recipes,Lunch,High Protein Vegetarian
Classic Apple Pie Recipe (Stars in the Galaxy),"Vivatta Maida, Butter, Sugar, Water, Apples, Cinnamon Powder, Nutmeg Powder, Lemon, Brown Sugar, Sugar, Mint Leaves",11,25,15,40,4,Continental,Dessert,Vegetarian
Raw Mango Cucumber Salad Recipe with Roasted Peanuts,"Mango, Cucumber, Roasted Peanuts, Coriander, Mint Leaves, Sweet Chutney, Paprika Powder, Salt",8,20,0,20,4,Indian,Side Dish,Vegetarian
Creamed Spinach Recipe,"Spinach Leaves, Onion, Garlic, Butter, All Purpose Flour, Milk, Mustard Powder, Nutmeg, Whole Black Peppercorns, Cheddar Cheese Cream Cheese, Salt",11,10,15,25,4,Italian Recipes,Side Dish,Vegetarian
8 Ingredient Sugar Free Granola Parfait Recipe,"Instant Oats, Walnuts, Badam, Apricots, Dates, Honey, Extra Virgin Olive Oil, Cinnamon Powder, Salt, Curd, Kiwi, Anardana Powder",12,5,40,45,4,Continental,Snack,Sugar Free Diet
Parsi Style Lagan Sara Istew Recipe ,"Carrot, Small Potato, Of Suran, Green Peas, Raisins, , Horse, Onion, Tomato, Pieces Garlic, Ginger, Green Chilli, Turmeric Powder, Red Chili Powder, Dhansak Masala, Salt, Oil Cook",17,15,45,60,4,Parsi Recipes,Dinner,Vegetarian
Instant Carrot Pickle Recipe,"Carrot, Mustard Oil, Asafoetida, Kalonji, Fennel Seeds, Methi Seeds, Mustard Seeds, Red Chilli Powder, Salt",9,20,10,30,10,Indian,Side Dish,Vegetarian
Tangy Corn Tamatar Bharta Recipe,"Sweet Corn, Tomato, Onion, Coriander, Green Chilli, Ginger Garlic Paste, Cumin Seeds, Turmeric Powder, Coriander Powder, Red Chilli Powder, Garam Masala Powder, Butter, Sunflower Oil, Lemon Juice, Salt",15,15,15,30,4,North Indian Recipes,Dinner,Vegetarian
Puli Keerai ,"Tamarind, Spinach, Sugar, Green Chilli, Salt, Oil, Mustard, Lentils, Curry Leaves, Dry Red Chilli",10,10,20,30,2,South Indian Recipes,Lunch,Vegetarian
Palak Kadhi Recipe,"Curd, Flour, Turmeric Powder, Salt, Spinach, Green Chili, Ginger, Cumin, Cumin, Rye, Asafoetida, Curry Leaves, Red Chilli, Oil",14,5,25,30,4,Rajasthani,Lunch,Vegetarian
Wheat Grass Rasam Recipe,"Wheat Grass, Cherry Tomato, Tamarind, Rasam Powder, Turmeric Powder, Mustard Seeds, Garlic, Cumin Seeds, Dry Red Chilli, Curry Leaves, Coriander, Salt, Asafoetida, Water",14,10,25,35,2,South Indian Recipes,Lunch,Vegetarian
Apple And Ginger Cocktail Recipe,"Apple Vodka, Orange Liquor, Apple Cider Vinegar, Sugar, Ginger Juice, Mint Leaves, Ice Cubes, Apple",8,10,15,25,2,Continental,Vegetarian,Vegetarian
Spicy Moong Dal Ki Goli Recipe,"Green Moong Dal, Salt, Ginger Garlic Paste, Asafoetida, Red Chili Powder, Turmeric Powder, Small Tablespoon Coriander Powder, Onion, Tomato, Lemon Juice, Garam Masala Powder, Mango Powder, Cumin Seeds, Oil, Coriander",15,20,35,55,4,Uttar Pradesh,Snack,Diabetic Friendly
Matki Kala Chana Salad Recipe,"Moth Sprouts, Kala Chana, Extra Virgin Olive Oil, Cumin Seeds, Turmeric Powder, Kashmiri Red Chilli Powder, Salt, Chaat Masala Powder, Onion, Tomato, Lemon Juice, Green Chilli, Coriander",13,5,10,15,4,Indian,Appetizer,Vegetarian
Blueberry and Lemon Iced Tea Recipe,"Blueberries Any Locally Available Berries, Tea Bags, Water, Sugar, Lemon Juice, Ice Cubes, Lemon",7,0,20,20,1,Continental,Vegetarian,High Protein Vegetarian
Thai Chicken Noodle Soup With Veggies Recipe,"Rice Vermicelli Noodles, Garlic, Ginger, Fresh Red Chilli, Stalks Celery, Stalks Lemon Grass, Chicken Stock, Turmeric Powder, Sriracha Sauce, Lemon Juice, Chicken, Baby Corn, Green Beans, Red Bell Pepper, Coriander, Salt",16,10,40,50,4,Thai,Appetizer,Non Vegeterian
Goan Mackerel Curry (Bangdyache Hooman) Recipe,"Mackerel Fish, Fresh Coconut, Kashmiri Dry Red Chilli, Tamarind, Green Chilli, Ginger, Kokum, Sichuan Peppercorns, Turmeric Powder, Sunflower Oil, Red Chilli Powder, Turmeric Powder, Salt",13,10,20,30,4,Goan Recipes,Lunch,High Protein Non Vegetarian
Delicious Dal Makhani Recipe Without Onion and Garlic (Jain),"Black Urad Dal, Rajma, Cumin Seeds, Homemade Tomato Puree, Kashmiri Red Chilli Powder, Fresh Cream, Butter, Milk, Garam Masala Powder, Cardamom Powder, Kasuri Methi",11,10,45,55,4,North Indian Recipes,Lunch,High Protein Vegetarian
Dahi Suran Ki Kadhi Recipe,"Suran, Flour, Curd, Mustard, Fenugreek Seeds, Turmeric Powder, Red Chilli Powder, Coriander Powder, Whole Pepper, Cinnamon, Bay Leaf, Salt, Oil",13,15,30,45,4,North Indian Recipes,Dinner,Vegetarian
Garlic Kheer ,"Garlic, Sugar, Milk, Vinegar, Rose Water, Cardamom Powder",6,15,20,35,4,Indian,Dessert,Vegetarian
Atukula Ladoo Recipe - Sweetened Poha Energy Balls,"Poha, Jaggery, Dessicated Coconut, Cashew Nuts, Ghee",5,20,15,35,2,Indian,Snack,Vegetarian
Apple Tea Latte Recipe,"Chamomile Tea, Apple, Cinnamon Powder, Almond Milk, Honey",5,2,10,12,2,Indian,Snack,Vegetarian
Delicious One Pot Butter Chicken Khichdi Recipe,"Butter, Bay Leaf, Whole Black Peppercorns, Cumin Seeds, Cardamom, Star Anise, Cloves, Cinnamon Stick, Ginger, Green Chilli, Garlic, Onion, Tomato, Â¼ Homemade Tomato Puree, Â¼ Curd, Chicken Breasts, Kasuri Methi, Salt, Red Chilli Powder, Tandoori Chicken Masala, Cumin Powder, Garam Masala Powder, Rice, Water, Coriander, Mint Leaves",26,15,20,35,2,North Indian Recipes,One Pot Dish,Non Vegeterian
"Raw Papaya, Apple & Carrot Salad Recipe","Raw Papaya, Carrot, Apple, Raw Peanuts, Green Chilli, Mint Leaves, Lemon Juice, Black Pepper Powder, Salt",9,25,0,25,4,Indian,Side Dish,Diabetic Friendly
Khatti Meethi Ragi Masala Roti Recipe With Carrots,"Ragi Flour, Whole Wheat Flour, Carrot, Tamarind Paste, Jaggery, Onion, Green Chilli, Red Chilli Powder, Coriander, Salt, Water, Ghee",12,10,10,20,4,South Indian Recipes,Lunch,Vegetarian
Nutty Chocolate High Fibre Biscuit Cake Recipe,"Butter, Cocoa Powder, Honey, Water, Vanilla Extract, Multigrain Digestive Oat Biscuits, Walnuts, Sunflower Seeds",8,20,10,30,12,Continental,Snack,Vegetarian
Dahi Gujiya Recipe,"White Urad Dal, Hung Curd, Cumin Powder, Black Pepper Powder, Salt, Sunflower Oil, Water, Enos Fruit Salt Cooking Soda, Sugar, Green Chutney, Sweet Chutney, Red Chilli Powder, Black Salt, Sugar",14,20,30,50,4,North Indian Recipes,Snack,Vegetarian
Andhra Style Paruppu Podi Recipe - Dal Podi,"Chana Dal, Black Urad Dal, Arhar Dal, Yellow Moong Dal, Horse Gram Dal, Dry Red Chilli, Asafoetida, Salt, Jaggery, Sesame",10,20,15,35,4,Andhra,Side Dish,Vegetarian
No Onion No Garlic Rajasthani Gatte Ki Kadhi Recipe,"Gram Flour, Ajwain, Red Chilli Powder, Curd, Sunflower Oil, Salt, Gram Flour, Curd, Asafoetida, Turmeric Powder, Red Chilli Powder, Bay Leaf, Cinnamon Stick, Salt, Coriander, Ghee, Mustard Seeds, Cumin Seeds, Curry Leaves",19,10,60,70,4,Rajasthani,Lunch,Vegetarian
Jhure-Jhure Aloo Bhaja Recipe,"Potato, Curry Leaves, Red Chilli Powder, Sunflower Oil, Salt",5,10,20,30,3,Bengali Recipes,Snack,Vegetarian
Thengai Poornam Kozhukattai & Uppu Kozhukattai Recipe,"Fresh Coconut  Grated, Jaggery, Cardamom Powder, Water, White Urad Dal, Green Chilli, Ginger, Asafoetida, Salt, Sesame, Mustard Seeds, Rice, Hot Water, Milk, Salt, Sesame",16,10,90,100,4,Tamil Nadu,Dessert,Vegetarian
Andhra Style Kandi Pachadi ,"Tur Dal, White Urad Dal, Dry Red Chilli, Roasted Chana Dal, Cumin Seeds, Tamarind, Bud Garlic, Salt, White Urad Dal, Dry Red Chilli, Curry Leaves, Asafetida, Oil",13,0,20,20,4,Andhra,South Indian Breakfast,Vegetarian
Val Papdi Bhaji Recipe - Goan Style Flat Beans Dry Sabzi,"Flat Green Beans, Mustard Seeds, Cumin Seeds, Dry Red Chilli, Curry Leaves, Turmeric Powder, Sunflower Oil, Salt, Fresh Coconut, Garlic, Tamarind Paste",11,10,20,30,4,Goan Recipes,Side Dish,Vegetarian
Knol Khol Flavored With Asafoetida ,"Knoll Knoll, Knoll Knoll Leaves, Asafoetida, Dry Red Chilli, Cooking Soda, Kashmiri Masala Powder, Mustard Oil, Salt",8,20,30,50,6,Kashmiri,Lunch,Vegetarian
Malvani Anda Curry Recipe,"Eggs, Onion, Tomato Puree, Green Chili, Ginger Garlic Paste, Cashews, Coconut, Red Chilli Powder, Coriander Powder, Malwani Masala, Turmeric Powder, Cumin Seeds, Kokum, Curry Leaves, Spoon Oil, Salt",16,10,20,30,4,Malvani,Side Dish,Eggetarian
Chargrilled Eggplant Tabbouleh Recipe,"Broken Wheat, Parsley Leaves, Mint Leaves, Brinjal, Tomato, Cucumbers, Spring Onion, Lemon Juice, Extra Virgin Olive Oil, Paprika Powder, Sumac, Lime Wedges, Salt, Extra Virgin Olive Oil",14,10,40,50,2,Middle Eastern,Side Dish,Vegetarian
Bengali Aloo Dum Recipe,"Ginger, Green Chilli, Onion, Garlic, Baby Potato, Mustard Oil, Salt, Mustard Oil, Cardamom, Cinnamon Stick, Cloves, Bay Leaf, Turmeric Powder, Red Chilli Powder, Garam Masala Powder, Coriander Powder, Homemade Tomato Puree, Curd, Honey, Salt, Coriander",21,20,50,70,4,Bengali Recipes,Main Course,Vegetarian
Coriander Egg Curry ,"Eggs, Onion, Lentil Sugar, Bay Leaf, , Oil, Coriander Powder, Garam Masala Powder, Green Coriander, Onion, Garlic, Ginger, Green Chilies",13,15,20,35,4,Indian,Lunch,Eggetarian
Zucchini And Feta Cheese Bruschetta Recipe,"Feta Cheese, Green Zucchini, Tomato, Clove Garlic, Raisins, Extra Virgin Olive Oil, Parsley Leaves, Salt And Pepper, French Bread, Extra Virgin Olive Oil",10,10,15,25,4,Italian Recipes,Appetizer,Vegetarian
Masala Chai Kulfi Recipe With Bourbon Chocolate Syrup,"Water, Milk, Assam Tea Leaves, Ginger, Cardamom, Cinnamon Stick, Whole Black Peppercorns, Dried Rose Petals, Cloves, Milk, Custard Powder, Condensed Milk, Pistachios, Marie Biscuit, Butter, Almond Meal, Dark Chocolate, Fresh Cream, Bourbon, Salt",20,500,45,545,4,Indian,Dessert,Vegetarian
Hummus Flavoured With Garlic Recipe,"Kabuli Chana, Lemon Juice, Tahini, Dark Soy Sauce, Water, Parsley Leaves, Salt, Garlic",8,15,50,65,6,Mediterranean,Snack,High Protein Vegetarian
"Bengali Style Tomato Khejur Er Chaatni (Tomato, Cranberry and Dates Chutney )Recipe","Tomato, Cranberries, Dates, Mustard Seeds, Ginger, Sugar, Panch Phoran Masala, Salt",8,10,15,25,4,Bengali Recipes,Side Dish,No Onion No Garlic (Sattvic)
Sindhi Style Doda Recipe (Spring Onion Rice Flour Flat Bread Recipe),"Rice Flour, Onion, Stalks Spring Onion Greens, Coriander, Methi Leaves, Green Chilli, Garlic, Cumin Seeds, Ghee, Salt, Sunflower Oil",11,15,25,40,4,Sindhi,North Indian Breakfast,Vegetarian
Pineapple Kesari Bhath Recipe - Sweet Semolina Pudding,"Sooji, Ghee, Pineapple, Saffron Strands, Milk, Sugar, Cardamom Powder, Edible Camphor, Ghee, Cashew Nuts, Raisins",11,10,30,40,4,Karnataka,Dessert,Vegetarian
Masala Couscous Pulao Recipe,"Couscous, Onion, Ginger Garlic Paste, Carrots, Green Peas, Red Chilli Powder, Coriander Powder, Garam Masala Powder, Mint Leaves, Bay Leaf, Cloves, Cinnamon Stick, Sunflower Oil, Salt, Coriander",15,15,30,45,4,Indian,Dinner,Vegetarian
Karnataka Style Mixed Vegetable Pulao Recipe,"Basmati Rice, Bay Leaves, Paneer, Fried Bread Cubes, Carrots, Green Beans, Green Peas, Potato, Cauliflower, Fresh Coconut, Pearl Onion, Garlic, Ginger, Coriander, Cumin Seeds, Fennel Seeds, Coriander, Tomato, Cinnamon Stick, Cloves, Cardamom, Green Chilli",22,30,30,60,4,Indian,Lunch,Vegetarian
Baked Chinese Potato Recipe,"G Potato, Turmeric Powder, Small Onion, Garlic, Red Chilli Flax, Salt, As Per, Coconut Oil, Coconut",9,10,20,30,4,Kerala Recipes,Lunch,Vegetarian
Pan Roasted Zucchini & Mushroom Recipe,"Green Zucchini, Button Mushrooms, Extra Virgin Olive Oil, Garlic, Whole Black Peppercorns, Mixed Herbs",6,10,10,20,2,Continental,Side Dish,Vegetarian
Kerala Style Chakkakuru Mezhukkupuratti Recipe-Jackfruit Seed Poriyal,"Jackfruit Seeds, Pearl Onion, Garlic, Kashmiri Red Chilli Powder, Black Pepper Powder, Curry Leaves, Fresh Coconut, Sunflower Oil, Salt, Salt",10,10,45,55,4,Kerala Recipes,Side Dish,Vegetarian
Pepper Mushroom Stir Fry ,"Button Mushroom, Green Chilli, Capsicum, Ginger, Black Pepper Powder, Turmeric Powder, Garam Masala Powder, Salt, Whole Pepper, Coriander, Oil",11,15,20,35,4,South Indian Recipes,Lunch,Vegetarian
Oats Apple Phirni Recipe,"Instant Oats, Apple, Milk, Sugar, Cardamom, Pistachios",6,5,10,15,4,North Indian Recipes,Dessert,Vegetarian
Green Beans Poriyal Recipe With Peanuts & Sesame Recipe,"Green Beans, Salt, Red Chilli Powder, Sunflower Oil, Water, Mustard Seeds, Cumin Seeds, Dry Red Chilli, Sesame Seeds, Raw Peanuts",10,5,20,25,2,South Indian Recipes,Lunch,Diabetic Friendly
Jaggery Coffee Without Milk Recipe,"Water, Coffee Decoction, Dry Ginger Powder, Whole Black Peppercorns, Jaggery  Powdered",5,2,10,12,2,South Indian Recipes,Snack,Vegetarian
Grain Free Chocolate Porridge Recipe,"Cauliflower, Coconut Milk, Coconut Milk, Date Syrup, Cocoa Powder, Vanilla Extract, Salt, Cinnamon Powder, Strawberries, Pistachios, Dried Figs, Walnuts",12,10,15,25,4,Indian,Indian Breakfast,High Protein Vegetarian
Corn Meal and Zucchini Muffin Recipe,"Makki Ka Atta, All Purpose Flour, Baking Powder, Green Zucchini, Sweet Corn, Sugar, Whole Egg, Milk, Salt",9,5,30,35,4,Continental,Snack,Eggetarian
Karwar Style Karatya Kismore Recipe - Sweet Tangy Bitter Gourd Sabzi,"Karela, Onion, Fresh Coconut, Red Chilli Powder, Tamarind Water, Jaggery, Ghee, Salt",8,10,30,40,4,Karnataka,Side Dish,Vegetarian
Fusion Spinach Parathas With Onion Tomato Salsa Recipe,"Whole Wheat Flour, Spinach Leaves, Salt, Ginger Garlic Paste, Green Chilli Paste, Mixed Herbs, Dried Oregano, Cumin Powder, Milk, Parsley Leaves, Extra Virgin Olive Oil, Cheddar Cheese, Onion, Tomato, Green Chilli, Coriander, Lemon Juice, Cumin Powder, Salt",19,20,30,50,4,North Indian Recipes,Dinner,Vegetarian
Cheesy Potatoes Recipe,"Potato, Onion, Sweet Corn, Mozzarella Cheese, Coriander, Red Chilli Flakes, Oregano, Of Lemon Juice, Butter, Salt",10,20,30,50,4,Indian,Appetizer,Vegetarian
Avarekalu Masala Vada Recipe,"Chana Dal, Avarekalu  Lilva Beans, Gram Flour, Red Chilli Powder, Fennel Seeds, Onion, Dry Red Chilli, Garlic, Curry Leaves, Asafoetida, Salt, Sunflower Oil",12,60,30,90,6,South Indian Recipes,Snack,Vegetarian
Healthy Oats Waffles Recipe,"Instant Oats, Chia Seeds, Soy Milk, Baking Powder, Coconut Sugar, Salt, Coconut Oil, Soy Milk, Vanilla Extract, Cinnamon Powder, Maple Syrup Honey As Needed, Fresh Fruits Serve As Needed",12,0,15,15,4,Continental,World Breakfast,Sugar Free Diet
Onion Raita Recipe - Pyaz Ka Raita Recipe,"Curd, Water, Onion, Green Chilli, Coriander, Mint Leaves, Cumin Powder, Salt",8,10,0,10,3,Indian,Side Dish,Vegetarian
Capsicum Curry Recipe,"Red Yellowgreen Bell Pepper, Onion, Tomato, Green Chilli, Garlic, Bay Leaf, Coriander, Whole Black Peppercorns, Cashew Nuts, Peanut Butter, Red Chilli Powder, Garam Masala Powder, Kasuri Methi",13,15,45,60,4,North Indian Recipes,Dinner,Vegetarian
Beetroot Carrot Tomato & Ginger Juice Recipe,"Beetroots, Tomato, Ginger, Carrots",4,20,0,20,4,Continental,World Breakfast,Vegetarian
Burnt Garlic Chicken Fried Rice Recipe - Indo Chinese Fried Rice,"Boneless Chicken, Garlic, Cooked Rice, Extra Virgin Olive Oil, Whole Black Peppercorns, Green Chilli, Soy Sauce, Vinegar, Garlic, Extra Virgin Olive Oil",10,20,20,40,4,Indo Chinese,Lunch,Non Vegeterian
Onion Tomato Podi Masala Dosa Recipe,"Idli Dosa Batter, Onion, Tomato, Idli Dosa Podi, Potato Masala, Potato, Onion, Ginger, Green Chilli, Mustard Seeds, Cumin Seeds, Curry Leaves, Sunflower Oil, Salt, Turmeric Powder",15,0,30,30,4,South Indian Recipes,South Indian Breakfast,Vegetarian
Falahari Rajgira Aloo Tikki Recipe (Gluten Free Amaranth Potato Patty),"Potato, Rajgira Flour, Green Chilli, Ginger, Coriander, Rock Salt, Cumin Seeds, Red Chilli Powder, Coriander Powder, Garam Masala Powder, Sunflower Oil",11,20,30,50,4,North Indian Recipes,Appetizer,No Onion No Garlic (Sattvic)
Kesar Elaichi Lassi Recipe,"Curd, Saffron Strands, Honey, Cardamom, Badam, Pistachios",6,10,10,20,1,Indian,Snack,Vegetarian
Paneer Makhani ,"G Paneer, Tomato Puree, Cream, Onion, Ginger, Curry Garlic, Turmeric Powder, Cumin Powder, Garam Masala Powder, Red Chilli Powder, Kasuri Methi, Honey, Salt, Oil Cook",14,20,25,45,4,North Indian Recipes,Dinner,Vegetarian
Ras El Hanout Recipe (Moroccan Spice Powder),"Cinnamon Stick, Cloves, Cardamom, Coriander, Cumin Seeds, Paprika Powder, Whole Black Peppercorns, Turmeric Powder, Mace Powder, Red Chilli Flakes, Nutmeg Powder, Fennel Seeds, Dry Ginger Powder, Star Anise, Dried Rose Petals",15,15,20,35,150,African,Vegetarian,Vegetarian
Vazha Thandu Poriyal Recipe - Tamil Nadu Style Dry Banana Stem Fry,"Banana Stem, Pearl Onion, Green Chilli, Curry Leaves, Turmeric Powder, Mustard Seeds, Fresh Coconut, Sunflower Oil, Salt",9,10,30,40,4,Tamil Nadu,Side Dish,Diabetic Friendly
Sutlac Recipe - Rose Infused Turkish Rice Pudding,"Rice, Water, Milk, Sugar, Rose Water, Rice Flour, Cinnamon Powder",7,5,45,50,4,Middle Eastern,Dessert,Vegetarian
Coriander Tamarind Millet Rice Recipe,"Foxtail Millet, Green Chilli, Dry Red Chilli, Curry Leaves, Garlic, Coriander, Cumin Powder, Mustard Seeds, White Urad Dal, Chana Dal, Raw Peanuts, Asafoetida, Turmeric Powder, Tamarind, Sunflower Oil, Salt",16,10,20,30,4,Indian,Lunch,Vegetarian
Potato Spinach Roulade Recipe With Parmesan Cheese & Herbed Butter Sauce,"Potato, All Purpose Flour, Parmesan Cheese, Salt, Whole Eggs, Spinach Leaves, Basil Leaves, Feta Cheese, Salt, Red Chilli Powder",10,10,90,100,4,Continental,Main Course,Vegetarian
Choco Berry Chia Parfait Recipe,"Chia Seeds    Teaspoon, Milk, Hung Curd, Rolled Oats, Honey, Vanilla Extract, Chocolate Chips, Strawberries Any Berries, Cocoa Powder, Chocolate Sauce, Peanut Butter, Salt, Mixed Fruits, Mixed Nuts",14,10,20,30,2,Continental,World Breakfast,Vegetarian
North Indian Style Green Raw Papaya Curry Recipe,"Raw Papaya, Onion, Tomato, Ginger, Garlic, Fennel Seeds, Red Chilli Powder, Coriander Powder, Turmeric Powder, Coriander, Salt, Sunflower Oil",12,10,25,35,4,North Indian Recipes,Side Dish,Vegetarian
Uppu Mani Kozhukattai Recipe - Kara Pidi Kozhukattai,"Rice Flour, Water, Salt, Gingelly Oil, Gingelly Oil, Mustard Seeds, White Urad Dal, Dry Red Chilli, Asafoetida, Curry Leaves",10,10,40,50,3,South Indian Recipes,Snack,Vegetarian
Cinnamon Spiced Black Lemon Tea Recipe,"Water, Lemon, Cinnamon Stick, Assam Tea Leaves, Lemon Wedges Slicesgarnish, Honey",6,2,5,7,2,Indian,Dinner,Vegetarian
Masala Pohe Recipe,"Poha, Onion, Coconut, Sugar, Red Chilli Powder, , Cumin Powder, Salt, Oil, Mustard, Asafoetida, Turmeric Powder, Charcoal",13,25,5,30,4,Karnataka,South Indian Breakfast,Vegetarian
Sindhi Karela Bhaji Recipe,"Bitter Gourd, Onion, Tomato, Curd, Green Chilli, Ginger, Garlic, Cumin, Kashmiri Red Chilli Powder, Coriander Powder, Cardamom Powder, Turmeric Powder, Pomegranate Powder, Coriander Powder  Finely  Take Salt    Oil, As Per",15,10,30,40,4,Sindhi,Lunch,Diabetic Friendly
Creamy Phirni Recipe - North Indian Rice Pudding,"Milk, Rice, Cardamom, Sugar, Badam",5,0,90,90,4,North Indian Recipes,Dessert,Vegetarian
Sprouted Moong And Methi Pulao Recipe,"Rice, Green Moong Sprouts, Methi Leaves, Onion, Garlic, Ginger, Bay Leaves, Star Anise, Whole Black Peppercorns, Sunflower Oil, Mustard Seeds, Cumin Seeds, Green Chilli, Turmeric Powder, Asafoetida, Salt",16,10,20,30,4,Indian,Lunch,Vegetarian
Moroccan Roast Chicken with Apricots Recipe,"Chicken, Butter, Extra Virgin Olive Oil, Cinnamon Powder, Coriander Powder, Cumin Powder, Paprika Powder, Red Chilli Powder, Sumac, Harissa Paste, Salt, Black Pepper Powder, Mixed Vegetables, Apricots, Honey",15,20,120,140,2,African,Dinner,High Protein Non Vegetarian
Cheesy Kulcha Sandwich Recipe With Ghee Roast Mushrooms,"Button Mushrooms, Dry Red Chilli, Whole Black Peppercorns, Cloves, Methi Seeds, Coriander, Cumin Seeds, Garlic, Tamarind Paste, Ghee, Curry Leaves, Jaggery, Salt, Whole Wheat Flour, All Purpose Flour, Green Chilli, Garlic, Salt, Active Dry Yeast, Ghee, Sugar, Coriander, Curd, Water, Britannia Cheese Block, Butter Grease",26,20,45,65,4,Fusion,Appetizer,Vegetarian
Multigrain Paneer Dahi Vada Recipe,"Paneer, Curd, Brown Sugar, Whole Wheat Flour Maida, Water, Whole Wheat Brown Bread, Extra Virgin Olive Oil, Curd, Brown Sugar, Mustard Seeds, Curry Leaves, Saffron Strands, Sesame Seeds",13,10,30,40,3,South Indian Recipes,Snack,Vegetarian
Bhindi Masala Gravy Recipe,"Okra, Onion, Ginger, Garlic, Green Chilli, , Cardamom, Cinnamon, Mace, Tomato, Curd, Kasoori Methi, Bay Leaf, Turmeric Powder, Red Chilli Powder, Coriander Powder, Oil, Salt",18,20,30,50,3,North Indian Recipes,Side Dish,Vegetarian
Savory Shrimps On Skillet Recipe,"Shrimps, Tablespoon Butter Oil, Orange Color, Soy Sauce, Lemon Juice, Honey, Tabasco Original, Black Pepper Powder, Garlic, Ginger, Fresh Thyme Leaves Dry",11,20,8,28,4,Indian,Appetizer,Non Vegeterian
Spiced Mulled Apple Juice Recipe,"Apple Juice, Cinnamon Stick, Nutmeg, Cloves, Black Pepper Powder, Ginger, Orange Peel",7,5,10,15,4,Indian,Snack,Vegetarian
Herbed Cheesy Bun Recipe,"All Purpose Flour, Milk, Sugar, Sunflower Oil, Active Dry Yeast, Salt, Lukewarm Water Make Soft Dough, All Purpose Flour, Sunflower Oil, Carrot, Green Bell Pepper, Cabbage, Sunflower Oil, Butter, Roasted Tomato Pasta Sauce, Red Chilli Sauce, Dried Oregano, Dried Thyme Leaves, Red Chilli Flakes, Black Pepper Powder, Cheese, Sunflower Oil Grease Foil",22,80,20,100,4,Continental,Snack,Vegetarian
Mexican Corn and Bell Pepper Tostadas Recipe,"Makki Ka Atta, All Purpose Flour, Lukewarm Water Knead, Black Eyed Beans, Onion, Coconut Milk, Salt, Sunflower Oil, Red Bell Pepper, Sweet Corn, Red Chilli Powder, Cumin Powder, Salt",13,15,45,60,4,Mexican,Appetizer,Vegetarian
Mangalore Fish Curry Recipe,"King Fish, Onion, Green Chilli, Coconut Milk, Sunflower Oil, Coriander Powder, Red Chilli Powder, Tamarind, Turmeric Powder, Curry Leaves, Salt",11,10,30,40,4,Mangalorean,Lunch,Non Vegeterian
Banana Date Chocolate Chip Cake Recipe,"Nutralite Classic Spread, Brown Sugar, Whole Eggs, Whole Wheat Flour, Jowar Flour, Bajra Flour, Baking Powder, Salt, Ripe Bananas  Mashed, Dates, Chocolate Chips, Vanilla Extract",12,10,45,55,4,Continental,Dessert,Eggetarian
"Lettuce, Apple And Carrot Salad With Chilli Dressing Recipe ","Iceberg Lettuce, Carrot, Apple, Cucumber, Lemon Juice, Honey, Red Chilli Powder, Salt",8,15,0,15,4,Continental,Side Dish,Vegetarian
Thai Style Vegetables & Raw Papaya Rice Recipe,"Cooked Rice, Raw Papaya, Yellow Bell Pepper, Red Bell Pepper, Cabbage, Onion, Ginger, Garlic, Thai Yellow Curry Paste, Roasted Peanuts, Salt",11,15,35,50,4,Thai,Lunch,Diabetic Friendly
Singhara Pulao Recipe - Water Chestnut Mixed Rice,"Singhade, Cooked Rice, Bay Leaf, Star Anise, Cloves, Cumin Seeds, Turmeric Powder, Salt, Black Pepper Powder, Sunflower Oil, Coriander",11,0,30,30,4,North Indian Recipes,Lunch,No Onion No Garlic (Sattvic)
Hyderabadi Shahi Mixed Vegetable Curry Recipe,"Baby Potato, Green Peas, Carrots, Green Beans, Red Bell Pepper, Yellow Bell Pepper, Raisins, Tomato, Onion, Garlic, Ginger, Red Chilli Powder, Turmeric Powder, Garam Masala Powder, Coriander Powder, Cumin Powder, Bay Leaves, Cashew Nuts, Fresh Cream, Coriander, Salt, Sunflower Oil",22,30,40,70,4,Hyderabadi,Lunch,Vegetarian
Red Rice Dosa Recipe,"Red Matta Rice, White Urad Dal, Methi Seeds, Salt, Water, Sunflower Oil",6,10,120,130,3,South Indian Recipes,South Indian Breakfast,Vegetarian
Buttered Green Beans Recipe - Finger Food for Toddlers,"Green Beans, Butter, Salt",3,2,10,12,2,Continental,Snack,High Protein Vegetarian
Chaal Kopi Recipe - Bengali Style Cauliflower Stir Fry,"Cashew Nuts, Raisins, Cauliflower, Basmati Rice Govind Bhog Rice, Cumin Seeds, Bay Leaf, Cardamom, Cloves, Cinnamon Stick, Ginger, Garam Masala Powder, Turmeric Powder, Tomato, Green Chilli, Cumin Powder, Coriander Powder, Green Peas, Sugar, Salt, Water",20,15,30,45,3,Bengali Recipes,Side Dish,Vegetarian
Mochiko Dango Recipe - Sweet Japanese Dumplings,"Rice Flour, Icing Sugar, Ghee, Hot Water",4,20,30,50,6,Japanese,Dessert,Gluten Free
Lehsuni Pudina Chutney Recipe,"Peppermint, Garlic, Ginger, Green Chili, Peanuts, Salt, Sugar, Lemon Juice",8,10,35,45,4,North Indian Recipes,Side Dish,Vegetarian
Palak And Moong Dal Pakoda,"Green Moong Dal, Spinach, Onion, Green Chili, Celery, Coriander Seeds, Red Chilli Powder, Garam Masala Powder, Turmeric Powder, Cumin Powder, Lemon Juice, Salt, Oil",13,10,25,35,4,North Indian Recipes,Snack,High Protein Vegetarian
Baked Corn & Flour Tortilla Chips Flavored With Paprika Recipe,"Makki Ka Atta, Whole Wheat Flour, Turmeric Powder, Sunflower Oil, Ajwain, Dried Oregano, Salt, Water Knead, Paprika Powder",9,10,15,25,4,Mexican,Appetizer,Vegetarian
Jharkhand Dal Peethi Recipe,"Yellow Moong Dal, Masoor Dal, Chana Dal, Turmeric Powder, Red Chilli Powder, Garlic, Onion, Garam Masala Powder, Ghee, Cumin Seeds, Asafoetida, Dry Red Chilli, Salt, Whole Wheat Flour, Water, Salt",16,20,20,40,4,Bihari,Lunch,Vegetarian
Mysore Bonda Recipe (Healthy Pan Fried Recipe),"White Urad Dal, Green Chilli, Whole Black Peppercorns, Fresh Coconut, Asafoetida, Salt, Coriander, Sunflower Oil",8,20,30,50,4,Karnataka,Snack,Vegetarian
Khamang Kakdi Recipe,"Cucumber, Coconut, Coriander, Peanuts, Curd, Salt, Oil, Mustard, Green Chili, Asafoetida, Curry Leaves",11,10,2,12,4,Maharashtrian Recipes,Side Dish,Vegetarian
Apple Carrot Sweet Potato Soup With Garam Masala Roasted Chickpeas Recipe,"Onion, Carrots, Sweet Potato, Apple, Curry Powder, Coconut Cream, Vegetable Stock Water, Extra Virgin Olive Oil, Maple Syrup Honey, Coriander, Kabuli Chana, Lemon Juice, Garam Masala Powder, Red Chilli Powder, Extra Virgin Olive Oil, Salt",16,10,90,100,4,Continental,Dinner,Vegetarian
Greek Style Kolokithokeftedes Recipe -Zucchini Fritters Recipe,"Yellow Zucchini, Paneer, Nutmeg, Spring Onion, Mint Leaves, Instant Oats, Flax Seed Powder, Whole Wheat Bread Crumbs, Salt And Pepper, Extra Virgin Olive Oil",10,20,15,35,4,Greek,Snack,Vegetarian
Poppetjes Recipe - Sweet Puffy Wheat Dumpling Recipe,"Whole Wheat Flour, Sooji, Coconut Milk Toddy, Vanilla Extract, Raisins, Badam, Cardamom, Nutmeg Powder, Cinnamon Powder, Sugar, Water, Salt, Sunflower Oil",13,60,30,90,18,Parsi Recipes,Snack,Vegetarian
Masala Roti Recipe-Soft and Spicy Indian Flat Bread,"Whole Wheat Flour, Corn Flour, Oats Flour, Bajra Flour, Ragi Flour, Red Chilli Powder, Coriander Powder, Turmeric Powder, Flax Seed Powder, Ajwain, Kasuri Methi, Lukewarm Water Knead The Dough, Ghee Oilcook, Salt",14,20,30,50,18,Karnataka,Dinner,Vegetarian
Mutton Keema Soup Recipe,"Mutton, Onion, Tomato, Green Chilli, Bay Leaves, Green Coriander, Of Thyme Leaves, Small Spoon Black Pepper Powder, Ginger, Turmeric Powder, Chicken Stock Vegetable Stockwater, Oil, Salt",13,10,25,35,4,Middle Eastern,Appetizer,Non Vegeterian
"Tortilla Pizza With Tomato, Onion And Capsicum Recipe","Corn Flour Tortilla, Homemade Pizza And Pasta Sauce, Mozzarella Cheese, Tomato, Onion, Green Bell Pepper, Dried Oregano, Red Chilli Flakes",8,5,20,25,2,Mexican,Appetizer,Vegetarian
Vegetarian Kabuli Pulao Recipe,"Rice, Of Chickpea Chanachickpeas, Onion, Mint, Bay Leaf, Lentil Sugar, , Cardamom Crush, Large Cardamom, Ghee, Salt, Onion, Tomato, Ginger Garlic Paste, Paprika Powder, Coriander Powder, Cinnamon Powder, Cumin Powder, Garam Masala Powder, Ghee, Salt",21,30,30,60,4,Indian,Main Course,High Protein Vegetarian
Idli Upma ,"Idli, Small Onion, Green Chilli, Ginger, Turmeric Powder, Mustard, White Urad Lentils, Curry Leaves, Olive Oil, Green Coriander, Salt",11,15,20,35,4,South Indian Recipes,South Indian Breakfast,Gluten Free
Cabbage And Carrot Poriyal Recipe - No Onion And Garlic,"Carrot, Cabbage, Curry Leaves, Green Chilli, Turmeric Powder, Black Pepper Powder, Mustard Seeds, Cumin Seeds, White Urad Dal, Chana Dal, Asafoetida, Coconut Oil, Salt",13,10,35,45,4,South Indian Recipes,Side Dish,No Onion No Garlic (Sattvic)
Sarson Ka Saag ,"Mustard, Spinach, Of Batua, Ginger, Garlic, Onion, Green Chili, Turmeric Powder, Cinnamon Powder, Cumin Powder, Salt, Oil, Cheese",13,25,30,55,4,Punjabi,Side Dish,High Protein Vegetarian
Turkish Baklava Recipe From Scratch,"Vivatta Maida, Salt, Lemon Juice, Extra Virgin Olive Oil, Lukewarm Water, Corn Flour, Vivatta Maida, Pistachios, Badam, Cashew Nuts, Cinnamon Powder, Butter, Sugar, Water, Honey, Cinnamon Stick, Cloves, Cinnamon Powder, Nutmeg Powder, Lemon Juice, Lemon Zest",21,50,60,110,14,Middle Eastern,Dessert,Vegetarian
Spinach Foxtail Millet Dhokla Recipe,"Foxtail Millet, Gram Flour, Curd, Enos Fruit Salt, Sunflower Oil, Sunflower Oil, Curry Leaves, Mustard Seeds, Sesame Seeds, Coriander, Salt, Spinach, Green Chilli, Ginger, Cumin Seeds",15,20,45,65,4,North Indian Recipes,North Indian Breakfast,Vegetarian
Maharastrian Bhadang Recipe (Puffed Rice Snack Mix),"Puffed Rice, Kolhapuri Khanda Lasun Masala, Raw Peanuts, Curry Leaves, Asafoetida, Turmeric Powder, Garlic, Sugar, Salt, Sunflower Oil",10,0,25,25,4,Maharashtrian Recipes,Snack,Vegetarian
Double Beans Sundal Recipe,"Double Beans, Sunflower Oil, Asafoetida, Mustard Seeds, White Urad Dal, Dry Red Chilli, Curry Leaves, Red Chilli Powder, Fresh Coconut, Salt",10,10,15,25,4,South Indian Recipes,Lunch,High Protein Vegetarian
"Avocado, Grapefruit And Walnut Salad Recipe","Avocado, Grapefruit, Cherry Tomato Grapes, Walnuts, Mixed Greens, Lemon Juice, Extra Virgin Olive Oil, White Vinegar, Soy Sauce, Honey, Shallots, Dijon Mustard, Salt, Black Pepper Powder",14,10,15,25,3,Continental,Appetizer,Vegetarian
Green Chilli Chicken Fry Recipe,"Chicken, Green Chilli, Garlic, Ginger, Coriander, Onion, Tomato, Cloves, Cinnamon Stick, Coriander Powder, Salt, Water, Lemon, Sunflower Oil",14,15,25,40,4,Indian,Appetizer,High Protein Non Vegetarian
Methi Aur Kache Kele Ki Sabzi Recipe-Fenugreek Greens & Raw Banana Stir Fry,"Raw Banana, Methi Leaves, Onion, Tomato, Ginger Garlic Paste, Green Chilli, Cumin Seeds, Red Chilli Powder, Turmeric Powder, Coriander Powder, Sunflower Oil, Salt",12,10,15,25,4,Indian,Side Dish,Vegetarian
Apple Enchilada Recipe,"Tortillas, Apples, Butter, Cinnamon Powder, Lemon Juice, Brown Sugar, Brown Sugar, Sugar, Butter, Water, Salt, Vanilla Ice Cream, Walnuts",13,25,45,70,3,Mexican,Dessert,Vegetarian
Peanut Hummus Recipe,"Raw Peanuts, Mango, Sesame Seeds, Lemon Juice, Garlic, Cumin Powder, A  Kashmiri Red Chilli Powder, Extra Virgin Olive Oil, Sesame, Water, Salt",11,15,10,25,1,Mediterranean,Appetizer,High Protein Vegetarian
Ragi And Dill Nippattu Recipe,"Ragi Flour, Rice Flour, Gram Flour, Raw Peanuts, Dry Red Chilli, Dessicated Coconut, Cumin Seeds, Sesame Seeds, Dill Leaves, Asafoetida, Butter, Water, Salt, Sunflower Oil",14,10,20,30,4,South Indian Recipes,Snack,Vegetarian
Karnataka Style Set Dosa Recipe,"Idli Rice, White Urad Dal, Methi Seeds, Poha, Salt",5,360,30,390,8,Karnataka,South Indian Breakfast,Vegetarian
Gehun Ka Halwa ,"Wheat Flour, Sugar, Ghee, Water, Of Cardamom Powder, Cashews",6,10,45,55,4,Gujarati Recipesï»¿,Dessert,Vegetarian
Indian Style Masala Omelette Grilled Sandwich Recipe,"Whole Eggs, Green Chilli, Tomato, Onion, Black Pepper Powder, Garam Masala Powder, Salt, Tablespoon Mustard Oil, Whole Wheat Brown Bread, Butter",10,15,15,30,2,Fusion,World Breakfast,Eggetarian
Hara Chana Masala Recipe,"Hara Chana, Onion, Tomato, Cinnamon Stick, Coriander Powder, Red Chilli Powder, Garam Masala Powder, Ghee, Coriander, Salt, Ginger, Garlic, Green Chilli, Cinnamon Stick, Cloves",15,20,30,50,4,North Indian Recipes,Lunch,Vegetarian
Raw Papaya Thoran Recipe,"Raw Papaya, Mustard Seeds, White Urad Dal, Curry Leaves, Asafoetida, Green Chilli, Fresh Coconut, Salt, Sunflower Oil",9,10,30,40,4,Kerala Recipes,Side Dish,Vegetarian
Besan Ke Laddu Recipe,"Gram Flour, Sugar, Badam, Pistachios, Chironji, Melon Seeds, Fox Nuts, Fresh Coconut, Ghee, Cardamom, Cashew Nuts",11,10,40,50,4,North Indian Recipes,Dessert,Vegetarian
Mango Lemonade Recipe,"Mango Pulp, Sugar, Water, Lemon Juice, Mint Leaves",5,10,20,30,3,Continental,Snack,Vegetarian
Coconut Peanut Chutney Recipe,"Coconut, Green Chilli, S Of Green Coriander, , Peanuts, Salt",6,20,20,40,4,South Indian Recipes,Side Dish,No Onion No Garlic (Sattvic)
Chinese Chicken Sweet Corn Soup Recipe,"Chicken Breasts, Garlic, Ginger, Coriander, Whole Black Peppercorns, Corn Flour, Whole Egg, Sweet Corn, Spring Onion Greens, Salt",10,20,60,80,4,Chinese,Appetizer,High Protein Non Vegetarian
"Pita Topped With Oven Roasted Cauliflower, Basil Avocado Sauce Recipe","Mini Pita Breads, Del Monte Cheesy Garlic Mayo, Cauliflower, Cumin Seeds, Coriander, Fennel Seeds, Badam, Sunflower Oil, Salt, Avocado, Basil Leaves, Garlic, Lemon Juice, Milk Coconut Milk, Salt, Green Chilli",16,10,45,55,4,Fusion,Lunch,Vegetarian
Khatti Meethi Mooli Ki Sabzi Recipe-Sweet and Tangy Radish Dry Recipe,"Mooli Mullangi, Curry Leaves, Ajwain, Fennel Seeds, Onion, Garlic, Dry Red Chilli, Jaggery, Coriander Powder, Red Chilli Powder, Amchur, Salt",12,10,35,45,4,North Indian Recipes,Lunch,Vegetarian
Oats and Besan Cheela Recipe (High Protein Spiced Crepes),"Gram Flour, Rolled Oats Or Instant Oats, Onion, Green Chilli, Garlic, Fennel Seeds, Coriander, Salt, Red Chilli Powder, Sunflower Oil",10,20,30,50,4,Indian,North Indian Breakfast,High Protein Vegetarian
Ragi Oatmeal Kanji Recipe - Healthy Diabetic Porridge Recipe,"Ragi Flour, Instant Oats, Water, Milk, Honey",5,10,20,30,2,Indian,Indian Breakfast,Diabetic Friendly
Black Rice Porridge Recipe,"Black Rice, Salt, Jaggery, Coconut Milk, Mango, Goji Berries Any Other Dried Fruit, Mixed Nuts",7,10,60,70,4,Continental,World Breakfast,Diabetic Friendly
Lemony Pasta Recipe With Roasted Shrimps,"Spaghetti Pasta, Butter, Lemon Zest, Black Pepper Powder, Lemon Juice, Basil Leaves, Extra Virgin Olive Oil, Salt, Black Pepper Powder, Shrimps, Extra Virgin Olive Oil, Salt, Parmesan Cheese Garnish",13,10,30,40,4,Italian Recipes,Dinner,High Protein Non Vegetarian
Manipuri Style Chak Angouba Recipe - Vegetable Pulao Recipe,"Cooked Rice, Carrots, Green Beans, Onion, Cumin Seeds, Green Chilli, Turmeric Powder, Coriander Powder, Salt, Chives Spring Onion, Mustard Oil",11,10,25,35,4,North East India Recipes,Lunch,Vegetarian
Malida Recipe (Healthy Whole Wheat Afghan Sweet),"Leftover Roti, Jaggery, Cardamom Powder, Badam, Dates, Ghee",6,20,20,40,4,Afghan,Snack,Vegetarian
Quinoa Chocolate Cookies Recipe,"Quinoa, All Purpose Flour, Instant Oats, Dessicated Coconut, Coconut Sugar, Vanilla Extract, Salt, Baking Powder, Coconut Oil, Ripe Bananas, Whole Eggs, Chia Seeds, Dark Chocolate Chips",13,20,25,45,6,Continental,Snack,Vegetarian
Muesli Olive Oil Rusk Recipe,"Muesli, Whole Wheat Flour, Jaggery, Extra Virgin Olive Oil, Vanilla Extract, Milk, Salt",7,20,60,80,4,Continental,Snack,Vegetarian
Malvani Kurkuri Bhindi Recipe - Moongphali Bhindi Sabzi,"Bhindi, Roasted Peanuts, Sunflower Oil, Coriander, Dry Red Chilli, Cumin Seeds, Fennel Seeds, Mustard Seeds, Ajwain, Whole Black Peppercorns, Nutmeg Powder, Nagkesarcassia Buds, Asafoetida, Cinnamon Stick, Cloves, Star Anise, Stone Flower, Black Cardamom",18,10,20,30,4,Malvani,Dinner,Vegetarian
Healthy Ragi & Rice Breakfast Porridge Recipe,"Ragi Flour, Cocoa Powder, Almond Meal, Flax Seed Powder, Cooked Rice, Palm Sugar, Milk",7,15,20,35,2,Indian,World Breakfast,Vegetarian
Vegan Chickpeas And Broccoli Curry Recipe,"Sunflower Oil, Cinnamon Stick, Cloves, Kabuli Chana, Broccoli, Onion, Tomato, Ginger Garlic Paste, Cumin Powder, Red Chilli Powder, Salt, Water, Coriander",13,30,35,65,2,North Indian Recipes,Lunch,Vegan
Chettinadu Nandu Varuval Recipe (Crab Fry Dry With Baby Onions),"Crab, Shallots, Tomato, Green Chilli, Dry Red Chilli, Ginger Garlic Paste, Curry Leaves, Coriander Powder, Red Chilli Powder, Black Pepper Powder, Turmeric Powder, Fennel Powder, Salt, Sunflower Oil, Coriander",15,10,40,50,4,Chettinad,Lunch,Non Vegeterian
Paneer Kofta Curry Recipe -Non Fried,"Paneer, All Purpose Flour, Salt, Coriander, Cumin Powder, Ginger, Honey, Homemade Tomato Puree, Coriander Powder, Garam Masala Powder, Turmeric Powder, Hung Curd, Kasuri Methi, Salt, Sunflower Oil",15,20,40,60,4,North Indian Recipes,Side Dish,Vegetarian
Upvaas Thalipeeth Recipe,"Barnyard Millet, Rajgira Flour, Tapioca Flour, Singoda Flour, Potato, Cumin Seeds, Green Chilli, Coriander, Groundnut Powder, Salt, Ghee",11,20,30,50,4,Maharashtrian Recipes,North Indian Breakfast,Vegetarian
Whole Wheat Crepe With Eggs And Roasted Peppers Recipe,"Whole Wheat Flour, Whole Egg, Milk, Fresh Cream, Salt, Butter, Green Bell Pepper, Red Bell Pepper, Yellow Bell Pepper, Onion, Black Pepper Powder, Salt, Whole Eggs, Extra Virgin Olive Oil",14,10,40,50,4,Continental,World Breakfast,Eggetarian
Ginger Chutney Recipe,"Ginger, Jaggery, Tamarind, White Urad Dal, Black Cumin, Teaspoon Fenugreek Seeds, , Rye, , Sesame, Asafoetida, Curry Leaves, Salt, Oil",14,15,15,30,6,South Indian Recipes,Side Dish,Vegan
Nagli/Ragi Laddu Recipe,"Ragi Flour, Whole Wheat Flour, Dates, Jaggery, Ghee, Roasted Peanuts, Sesame Seeds, Dry Coconut, Mixed Dry Fruits, Mixed Nuts, Milk",11,10,45,55,4,South Indian Recipes,Dessert,Vegetarian
Tamil Nadu Style Vengaya Sambar Recipe - Pearl Onion Sambar,"Arhar Dal, Pearl Onion, Tomato, Tamarind Water, Sambar Powder, Turmeric Powder, Salt, Mustard Seeds, Methi Seeds, Dry Red Chilli, Asafoetida, Curry Leaves",12,10,30,40,4,Tamil Nadu,South Indian Breakfast,Vegetarian
Flourless Chilli Chocolate Cake Recipe,"Whole Eggs, Butter, Dark Chocolate, Sugar, Paprika Powder, Vanilla Extract, Salt, Fresh Cream, Dark Chocolate",9,10,30,40,4,Continental,Dessert,Eggetarian
Poricha Kuzhambu Tamil Nadu Style Mixed Vegetables and Lentil Stew ,"Tur Dal, Carrots, Green Peas, Green Beans, Gobi, Coconut, Cumin Seeds, Dry Red Chilies, Rice, Turmeric, Mustard, White Urad Dal, Dal Curry Leaves, Salt",14,10,20,30,4,Tamil Nadu,Dinner,Vegetarian
Lauki Badi Ki Sabzi Recipe,"Bottle Gourd, Badi, Sunflower Oil, Curry Leaves, Cumin Seeds, Mustard Seeds, Asafoetida, Green Chilli, Ginger, Garlic, Red Chilli Powder, Turmeric Powder, Coriander Powder, Garam Masala Powder, Milk More If Required",15,10,20,30,3,Rajasthani,Main Course,Vegetarian
Muli Paratha (Radish Paratha) Recipe,"Mooli Mullangi, Whole Wheat Flour, Red Chilli Powder, Turmeric Powder, Cumin Seeds, Asafoetida, Sunflower Oil, Salt",8,15,20,35,4,Indian,Indian Breakfast,Diabetic Friendly
Gujarati Batata Pulao Recipe - Sweet And Spicy Pulao With Lentils And Potatoes,"Basmati Rice, Yellow Moong Dal, Potato, Onion, Green Peas, Fresh Coconut, Sugar, Cloves, Cinnamon Stick, Bay Leaf, Cardamom, Cumin Seeds, Turmeric Powder, Green Chilli, Garlic, Ginger, Ghee, Sunflower Oil, Mint Leaves, Salt",20,20,30,50,4,Gujarati Recipesï»¿,Lunch,Vegetarian
Konkani Style Vali Bendi Recipe-Malabar Spinach Curry,"Spinach Leaves, Garlic, Salt, Fresh Coconut, Dry Red Chilli, Tamarind",6,10,20,30,4,Konkan,Side Dish,Vegetarian
Khira Gaintha Recipe (Kheer Puli),"Rice Flour, Water, Sugar, Milk, Salt, Cardamom Powder, Fresh Coconut, Milk, Cashew Nuts, Badam",10,15,35,50,4,Oriya Recipes,Dessert,Vegetarian
Dill Leaves Toor Dal Recipe - Shepu/ Suva Dal recipe,"Arhar Dal, Dill Leaves, Ghee, Mustard Seeds, Cumin Seeds, Bay Leaf, Onion, Garlic, Ginger, Tomato, Green Chilli, Red Chilli Powder, Turmeric Powder, Salt, Lemon",15,10,25,35,4,North Indian Recipes,Lunch,Vegetarian
Karnataka Style Bele Saaru Recipe,"Arhar Dal, Tamarind Water, Tomato, Fresh Coconut, Jaggery, Turmeric Powder, Salt, Coriander, Dry Red Chilli, Byadagi Dried Chilli, Cumin Seeds, Whole Black Peppercorns, Mustard Seeds, Methi Seeds, Curry Leaves, Mustard Seeds, Curry Leaves, Ghee",18,10,30,40,4,Karnataka,Lunch,Vegetarian
One Pot Creamy Spinach Lentils Recipe,"Masoor Dal, Spinach, Rocket Leaves, Butter, Onion, Tomato, Fresh Cream, Milk, Dry White Wine, Basil Leaves, Salt, Red Chilli Flakes",12,10,90,100,4,Continental,Lunch,Vegetarian
Jain Style Corn Palak ,"Spinach, Sweet Corn, Salt, Sugar, Kasoori Methi, Lemon Juice, Garam Masala Powder, Small Tablespoon Red Chili Powder, Oil, Cumin Seeds, Tomato, Green Chilli, Cashews, Oil, Cumin Seeds, Asafoetida, Red Chilli Powder",17,20,25,45,4,North Indian Recipes,Lunch,Vegetarian
Chettinad Mushroom And Green Peas Stir Fry Recipe,"Onion, Ginger, Garlic, Button Mushrooms, Green Peas, Fennel Seeds, Methi Seeds, Poppy Seeds, Whole Black Peppercorns, Coriander, Cinnamon Stick, Cardamom, Dry Red Chilli",13,10,10,20,4,Chettinad,Lunch,Diabetic Friendly
Zhejiang  Style Crispy Five Spice Powder Spring Roll Recipe,"Button Mushrooms, Sweet Corn, Spring Onion, Cloves, Ginger, Chinese  Spice Powder, Homemade Hoisin Sauce, All Purpose Flour, Butter, Salt",10,15,45,60,4,Chinese,Appetizer,Vegetarian
Sauteed Spicy Prawns Recipe,"Prawns, Garlic, Onion, Spring Onion Greens, Coriander, Red Chilli Powder, Turmeric Powder, Nando'S Peri Peri Chicken Sauce, Tablespoons Extra Virgin Olive Oil, Salt",10,15,20,35,2,Indian,Side Dish,Non Vegeterian
Sweet Potato And Carrot Sabzi Recipe,"Carrots, Sweet Potato, Onion, Tomato, Ginger, Garlic, Green Chilli, Fennel Seeds, Red Chilli Powder, Turmeric Powder, Garam Masala Powder, Coriander, Salt, Sunflower Oil",14,10,30,40,4,North Indian Recipes,Lunch,Vegetarian
Vegetable Sandwich Recipe With Mashed Avocado And Cottage Cheese,"Whole Wheat Brown Bread, Avocado, Potato, Paneer, Cucumber, Onion, Tomato, Cabbage, Salt, Black Pepper Powder, Green Chutney",11,15,15,30,2,Continental,World Breakfast,Vegan
Layered Thai Basil & Tofu Rice Recipe,"Tofu, Onion, Garlic, Thai Red Chilli, Thai Basil Leaves, Salt, Light Soy Sauce, Dark Soy Sauce, Shiitake Mushrooms, Sugar, Sesame, Sunflower Oil, Jasmine Rice, Water, Roasted Peanuts",15,10,30,40,2,Thai,Dinner,High Protein Vegetarian
Blueberry Muffin Cake Recipe,"All Purpose Flour, Sugar, Butter, Milk, Whole Egg, Baking Powder, Salt, Blueberries, All Purpose Flour, Cinnamon Powder, Sugar, Butter, Icing Sugar, Vanilla Extract, Milk",15,20,40,60,6,Continental,Dessert,Eggetarian
Quick Pulao With Onions And Tomatoes Recipe,"Rice, Onion, Tomato, Cumin Seeds, Curry Leaves, Green Chilli, Salt, Ghee, Turmeric Powder, Red Chilli Powder, Lemon, Few  Coriander",12,15,30,45,4,Indian,Lunch,Vegetarian
Greek Style ÎÎ±ÏÏÎ¿Î¼Î¬ÏÎ¹ÎºÎ± Recipe ,"Black Eyed Beans, Onion, Cloves, Celery, Homemade Tomato Puree, Whole Black Peppercorns, Fresh Thyme Leaves, Dried Oregano, Salt",9,500,45,545,4,Greek,Main Course,High Protein Vegetarian
Schezwan Chicken Sizzler Recipe,"Chicken Breasts, Tablespoon Dark Soy Sauce, Tablespoon Corn Flour, Tablespoon Whole Wheat Flour, Tablespoon Ginger Garlic Paste, Whole Egg, Ginger, Tablespoon Sweet And Spicy Red Chilli Sauce, Tablespoon White Vinegar, Tablespoon Roasted Tomato Pasta Sauce, Tablespoon Red Chilli Sauce, Green Chilli, Black Pepper Powder, Spring Onion, Onion, Tablespoon Dark Soy Sauce, Salt, Yellow Bell Pepper, Red Bell Pepper, Carrot, Broccoli, Green Beans, Extra Virgin Olive Oil Cook, Black Pepper Powder, Salt, Hakka Noodles, Tablespoon Dark Soy Sauce, Tablespoon Light Soy Sauce, Spring Onion Greens, Tablespoon White Vinegar, Green Chilli, Black Pepper Powder, Salt, Sunflower Oil, Spring Onion Greens, Sesame Seeds",36,15,20,35,2,Fusion,Main Course,High Protein Non Vegetarian
Mixed Vegetable Corn Pakora Recipe - Made In Kuzhi Paniyaram Pan,"Gram Flour, Rice Flour, Green Bell Pepper, Onion, Carrot, Ajwain, Salt, Enos Fruit Salt, Red Chilli Powder, Sunflower Oil, Chaat Masala Powder",11,10,20,30,4,North Indian Recipes,Snack,Vegetarian
Spicy Gram Flour Sabzi ,"Flour, Onion, Garlic, Green Chili, Green Coriander, Mustard, Cumin Seeds, Red Chilli Powder, Oil, Salt, Of Water",11,10,25,35,2,Maharashtrian Recipes,Dinner,Vegetarian
Pasta In Pudina Chutney Sauce Recipe,"Pasta, Mint, Coriander, Green Chilli, Garlic, Olive Oil, Lemon Juice, Salt, Black Pepper Powder  Wise, Parseley, Green Onion",11,10,30,40,2,Fusion,Dinner,Vegetarian
Healthy Lemon Cupcakes Recipe (Eggless),"Whole Wheat Flour, Water, Caster Sugar, Lemon Juice, Sunflower Oil, Turmeric Powder, Baking Powder, Baking Soda, Raisins",9,10,20,30,2,Continental,Dessert,Vegetarian
Mogre Ka Sharbat Recipe - Fresh Jasmine Drink,"Sugar, Water, Saffron Strands, Cardamom Powder, Fresh Jasmine Buds, Milk",6,480,15,495,1,Indian,Appetizer,Vegetarian
Sukhi Suran Masala Sabzi Recipe,"Suran, Onion, Green Chilli, Ginger, Garlic, Curry Leaves, Cumin Seeds, Turmeric Powder, Coriander Powder, Cumin Powder, Red Chilli Powder, Garam Masala Powder, Salt, Oil, Black Pepper Powder",15,15,20,35,4,North Indian Recipes,Side Dish,Vegetarian
Bihari Dal Pitha Recipe (Traditional Bihari Delicacy),"Rice, Sunflower Oil, Salt, Water Cook, Chana Dal, Green Chilli, Ginger, Garlic, Cumin Seeds, Whole Black Peppercorns, Ajwain, Sunflower Oil, Salt, Coriander, Sunflower Oil",15,10,60,70,3,Bihari,Snack,Vegetarian
Ginger Teriyaki Rice Recipe,"Cooked Rice, Sesame, Garlic, Ginger, Spring Onion, Salt, Black Pepper Powder, Sprig Ginger Teriyaki Sauce, Lemon Juice",9,10,30,40,4,Asian,Lunch,Vegetarian
Sweet And Sour Lemon Pickle Recipe,"Lemons, Sugar, Salt, Red Chilli Powder",4,30,15,45,4,Indian,Side Dish,Vegetarian
Akhrot Burfi Recipe - Walnut Burfi,"Walnuts, Condensed Milk, Cardamom Powder",3,10,25,35,8,Indian,Snack,Vegetarian
Urulai Kizhangu Roast Recipe - Spicy Potato Roast Recipe,"Potato, Asafoetida, Mustard Seeds, Cumin Seeds, Turmeric Powder, Red Chilli Powder, Curry Leaves, Sesame, Salt",9,15,30,45,4,Chettinad,Lunch,Vegetarian
Carrot Poriyal ,"Carrots, Mustard, White Urad Dal, Red Chili, Curry Leaves, Turmeric Powder, Asafoetida, Coconut, Oil, Salt",10,10,30,40,2,Tamil Nadu,Side Dish,Vegetarian
Achari Aloo Parwal Sabzi ,"Parwal, Potato, Onion, Tomato, Mustard Oil, Kalonji Seeds, Turmeric Powder, Dry Mango Powder, Salt, Coriander Seeds, Cumin Seeds, Mustard, Fennel Seeds, Kalonji Seeds, Fenugreek Seeds, Dry Red Chilli",16,10,40,50,4,North Indian Recipes,Lunch,Vegetarian
Amla Methi Sukhi Sabzi Recipe,"Gm Amla, Water, Cumin Seeds, Fennel Seeds, Celery, Asafoetida, Green Chilli  Finely   Ginger  Finely, Garlic, Onion, Tomato, Salt, Turmeric Powder, Fenugreek, Garam Masala Powder, Coriander Powder, Cumin Powder, Of Green Coriander",17,15,30,45,4,North Indian Recipes,Side Dish,Diabetic Friendly
Classic Greek Salad Recipe,"Olive Oil, Lemon Juice, Salt, Black Pepper Powder, Lettuce, Tomato, Cucumber, Red Onion, Olive, Of Feta Cheese, Parcels, Salt, Pepper Powder, Parcels, Salt, Black Pepper Powder",16,30,0,30,4,Greek,Appetizer,Vegetarian
Cauliflower Moong Dal Recipe,"Yellow Moong Dal, Cabbage, Turmeric Powder, Green Chilli, Cumin Powder, Onion, Salt, Tomato, Oil, Ginger, Coriander, Garam Masala Powder",12,10,60,70,6,Indian,Side Dish,High Protein Vegetarian
Health Benefits of Rasna (Alpinia Galanga) - Ayurvedic Medicinal Plant,"Stalks Rasna, Black Pepper Powder, Cumin Powder, Honey, Water",5,5,20,25,2,Indian,Vegan,High Protein Vegetarian
Eggless Chocolate Pistachio Biscotti Recipe,"All Purpose Flour, Cocoa Powder, Baking Powder, Caster Sugar, Milk, Sunflower Oil, Vanilla Extract, Pistachios, Chocolate Chips",9,10,60,70,4,Continental,Snack,Vegetarian
Dal Chingri (Bengali Style Channa Dal And Prawns) Recipe,"Prawns, Chana Dal, Carrot, Cauliflower, Tomato, Fresh Coconut, Coconut Milk, Garam Masala Powder, Turmeric Powder, Red Chilli Powder, Sugar, Mustard Oil, Ghee, Salt, Bay Leaves, Cinnamon Stick, Cloves, Cardamom, Dry Red Chilli, Cumin Seeds, Asafoetida",21,10,45,55,3,Bengali Recipes,Lunch,Non Vegeterian
Schezwan Masala Dosa Recipe Using Classic Idli Dosa Batter,"White Urad Dal, Methi Seeds, Idli Rice, Salt, Hakka Noodles, Onion, Garlic, Ginger, Green Chilli, Green Bell Pepper, Carrot, Cabbage, Schezwan Sauce, Soy Sauce, Tomato Ketchup, Red Chilli Sauce, Sesame, Salt, Stalk Spring Onion Greens, Ghee",20,10,60,70,4,Fusion,Snack,Vegetarian
"Kidney Beans, Crumbled Feta, Basil Salad with Lemon Vinaigrette Recipe","Feta Cheese, Basil Leaves, Rajma, Lemon Juice, Extra Virgin Olive Oil, Rosemary, Dried Oregano, Salt And Pepper",8,10,25,35,4,Continental,Appetizer,High Protein Vegetarian
Maharashtrian Style Patichya Kandyachi Zunka Recipe -Spring Onions and Besan Sabzi,"Spring Onion, Gram Flour, Green Chilli, Turmeric Powder, Red Chilli Powder, Mustard Seeds, Asafoetida, Sunflower Oil, Salt",9,5,15,20,4,Maharashtrian Recipes,Side Dish,Vegetarian
Mangalorean Style Ambe Upkari Recipe - Ripe Mango Curry,"Mango, Jaggery, Green Chilli, Ghee Coconut Oil, Dry Red Chilli, White Urad Dal, Mustard Seeds, Asafoetida",8,20,20,40,3,Mangalorean,Side Dish,Vegetarian
Vegetable Paella Recipe (Spanish Style Vegetable Rice),"Rice, Onion, Garlic, Red Bell Pepper, Green Bell Pepper, Yellow Bell Pepper, Button Mushrooms, Extra Virgin Olive Oil, Turmeric Powder, Homemade Tomato Puree, Vegetable Stock, Saffron Strands, Paprika Powder, Whole Black Peppercorns, Salt, Black Olives  Pitted, Parsley Leaves, Lemon Wedges Serve",18,15,30,45,4,Middle Eastern,Dinner,Vegetarian
Spiced Rice Breakfast Porridge Recipe,"Cooked Rice, Milk, Cinnamon Powder, Dry Ginger Powder, Nutmeg Powder, Salt, Honey, Mixed Fruits, Mixed Nuts",9,10,10,20,2,Continental,World Breakfast,Vegetarian
Butter Chicken Recipe - The Classic Indian Chicken Gravy,"Boneless Chicken, Curd, Ginger Garlic Paste, Turmeric Powder, Garam Masala Powder, Kashmiri Red Chilli Powder, Salt, Butter, Red Chilli Powder, Coriander Powder, Garam Masala Powder, Homemade Tomato Puree, Honey, Fresh Cream, Kasuri Methi, Salt, Fresh Cream, Kasuri Methi, Salt",19,10,35,45,4,North Indian Recipes,Dinner,High Protein Non Vegetarian
Baingan Musallam Recipe (Mughlai Style Eggplant Simmered In Rich Tomato Curry),"Brinjal, Homemade Tomato Puree, Turmeric Powder, Coriander Powder, Garam Masala Powder, Bay Leaf, Red Chilli Powder, Fresh Cream, Raisins, Coriander, Salt, Sunflower Oil, Onion, Garlic, Ginger",15,20,30,50,4,Hyderabadi,Lunch,Vegetarian
Rajasthani Kachri Ki Chutney Recipe (Wild Cucumber Chutney),"Kachri, Garlic, Dry Red Chilli, Cumin Seeds, Salt, Curd, Ghee",7,10,8,18,4,Rajasthani,Side Dish,Vegetarian
Mangalorean Style Kuvalyacho Pollav Recipe (Yellow Pumpkin Curry Recipe),"Kaddu, Onion, Turmeric Powder, Coriander Powder, Salt, Water, Onion, Fresh Coconut, Ajwain, Mustard Seeds, Coriander, Tamarind, Dry Red Chilli",13,10,30,40,4,Mangalorean,Lunch,Vegetarian
Carrot Pistachio Coconut Cake Recipe,"Carrots, Whole Eggs, Canola Oil Any Flavorless Oil, Sugar, Vanilla Extract, Vivatta Maida, Baking Soda, Baking Powder, Salt, Pistachios, Cinnamon Powder, Fresh Coconut",12,20,30,50,6,Indian,Dessert,Vegetarian
Guava Jam Recipe,"Guava, Sugar, Lemon Juice, Salt",4,15,30,45,4,Indian,Side Dish,Vegetarian
Homemade Tahini Sauce Recipe,"Sesame Seeds, Extra Virgin Olive Oil",2,5,15,20,10,Mediterranean,Dinner,Vegetarian
Cabbage Tomato Sabzi ,"Cabbage, Tomato, Turmeric Powder, Coriander Powder, Salt, Red Chili Powder, Oil, Rye, Cumin Seeds, Coriander",10,10,15,25,4,North Indian Recipes,Lunch,Vegetarian
Vegan Black Beans Stuffed Paratha Recipe,"Whole Wheat Flour, All Purpose Flour, Salt, Black Eyed Beans, Red Chilli Powder, Garam Masala Powder, Cumin Seeds, Salt, Sunflower Oil",9,40,20,60,4,North Indian Recipes,Lunch,High Protein Vegetarian
Chicken Pad Thai Noodles Recipe,"Rice Noodles, Chicken Breasts, Onion, Carrot, Red Bell Pepper, Yellow Bell Pepper, Green Bell Pepper, Garlic, Ginger, Soy Sauce, Fish Sauce, Sweet And Spicy Red Chilli Sauce, Brown Sugar, Peanut Butter, Lemon Juice, Roasted Peanuts, Red Chilli Flakes, Salt",18,15,20,35,4,Thai,Dinner,Non Vegeterian
Green Beans Paruppu Usili Recipe - Iyengar Style,"Green Beans, Gingelly Oil, Mustard Seeds, White Urad Dal, Curry Leaves, Asafoetida, Arhar Dal, Dry Red Chilli, Salt, Turmeric Powder",10,30,20,50,4,Tamil Nadu,Lunch,Vegetarian
Vendakkai Podi Curry Recipe - Vendakkai Poriyal,"Gingelly Oil, Mustard Seeds, Curry Leaves, Bhindiokravendaikkai, Idli Dosa Podi, Turmeric Powder, Sambar Powder, Salt, Fresh Coconut",9,10,20,30,4,South Indian Recipes,Lunch,Vegetarian
Spicy Schezwan Indo-Chinese Egg Fried Rice Recipe,"Basmati Rice, Garlic, Ginger, Whole Eggs, Green Beans, Carrot, Spring Onion, Vinegar, Soy Sauce, Salt",10,10,45,55,2,Indo Chinese,Lunch,Eggetarian
 Mullangi Thogayal Recipe,"Radish, Sesame Oil, Black Urad Dal, Rye, Curry Leaves",5,20,34,54,4,South Indian Recipes,Side Dish,Diabetic Friendly
Sukha Kala Chana Masala Recipe - Ashtami Prasad,"Kala Chana, Salt, Ghee, Cumin Seeds, Amchur, Chaat Masala Powder, Red Chilli Powder, Cumin Powder",8,400,25,425,4,North Indian Recipes,Main Course,High Protein Vegetarian
Chana Methi Dal Recipe,"Chana Dal, Fenugreek, Asafoetida, Onion, Tomato, Green Coriander, Turmeric Powder, Red Chili Powder, Salt, Ghee, Cumin Seeds, Dry Red Chilli",12,15,30,45,4,North Indian Recipes,Lunch,High Protein Vegetarian
Mexican Chicken Burger Recipe With Sour Cream & Salsa,"Burger Buns, Butter Spread, Onion, Sour Cream, Tomato Salsa, Chicken Breasts, Garlic, Onion, Cheese, Coriander, Pickled Jalapenos, Salt, Tomato Salsa, Cumin Powder, Salt, Whole Egg, Black Pepper Powder",17,20,10,30,2,Mexican,Main Course,Non Vegeterian
Motiya Chilman Pulao Recipe - Vegetable Rice Topped With Paneer Balls,"Basmati Rice, Green Peas, Cauliflower, Cardamom, Cloves, Garam Masala Powder, Red Chilli Powder, Hung Curd, Coriander, Paneer, Potato, Garam Masala Powder, Salt, Sunflower Oil",14,5,35,40,4,Awadhi,Lunch,Vegetarian
Dal Ghiya with Punjabi Wadiyan Recipe - Lentils with Bottle Gourd & Sundried Lentil Dumplings,"Badi, Bottle Gourd, Chana Dal, Onion, Tomato, Ginger, Green Chilli, Cumin, Coriander Seeds, Asafoetida, Red Chilli Powder, Turmeric Powder, Garam Masala Powder, Salt, Water, Coriander",16,5,35,40,4,Awadhi,Lunch,Vegetarian
Peshawari Chole Recipe,"Kabuli Chana, Onion, Tomato, Green Chilli, Ginger, Garlic, Salt, Tea Bags, Cardamom, Cinnamon Stick, Anardana Powder, Coriander Powder, Red Chilli Powder, Garam Masala Powder, Lemon Juice, Sunflower Oil",16,10,40,50,3,Lucknowi,Dinner,High Protein Vegetarian
Dal Makhani Without Onion And Garlic ,"Black Urad Dal, Rajma, Cumin Seeds, Kashmiri Red Chilli Powder, , Cream, Butter, Milk, Small Spoon Garam Masala Powder, Cardamom Powder, Kasuri Methi",11,10,45,55,4,North Indian Recipes,Lunch,High Protein Vegetarian
Ujju Rotti Recipe (Indian Rice Flat Bread),"Rice Flour, Water, Salt, Sunflower Oil",4,20,30,50,2,Indian,Indian Breakfast,Gluten Free
Kala Chana Chaat Recipe-Chatpata Healthy Street food,"Kala Chana, Fresh Pomegranate Fruit Kernels, Potato, Tomato, Onion, Green Chilli, Red Chilli Powder, Cumin Powder, Chaat Masala Powder, Amchur, Black Salt, Lemon Juice, Sev Garnish, Dates, Tamarind Paste, Jaggery, Red Chilli Powder, Cumin Powder, Dry Ginger Powder, Black Salt, Salt, Coriander, Mint Leaves, Ginger, Green Chilli, Sugar, Lemon Juice, Salt",28,480,25,505,2,North Indian Recipes,Appetizer,High Protein Vegetarian
Rajasthani Bajre Ki Khatti Raabdi Recipe,"Bajra Flour, Buttermilk, Cumin Seeds, Salt",4,120,30,150,4,Rajasthani,Side Dish,Vegetarian
Sri Lankan Muttai Appam Recipe,"Rice, Cooked Rice, Fresh Coconut, Active Dry Yeast, Sugar, Salt, Whole Eggs",7,200,20,220,6,Sri Lankan,South Indian Breakfast,Eggetarian
Pistachio & Cranberry Broken Wheat Pilaf Recipe,"Broken Wheat, Extra Virgin Olive Oil, Salt, Cranberries, Whole Black Pepper Corns, Pistachios, Lemon Juice, Mint Leaves",8,10,20,30,4,Continental,Main Course,Vegetarian
Old Fashioned Bread Pudding Recipe,"Whole Wheat Brown Bread, Whole Eggs, Caster Sugar, Vanilla Extract, Cinnamon Powder, Butter, Milk, Rum Brandy, Walnuts, Apples, Dry Fruits",11,30,60,90,6,Continental,Dessert,Eggetarian
Khandeshi Dal Recipe,"Green Moong Dal, Pink Masoor Dal, Arhar Dal, White Urad Dal, Chana Dal, Turmeric Powder, Sunflower Oil, Mustard Seeds, Dry Red Chilli, Bay Leaf, Lemon Juice, Coriander, Salt, Dry Coconut, Onion, Coriander Powder, Cumin Powder, Kashmiri Dry Red Chilli, Cloves, Cardamom, Cinnamon Stick, Whole Black Peppercorns, Garlic",23,10,30,40,2,Maharashtrian Recipes,Lunch,High Protein Vegetarian
Baked Sweet Potato Boats Recipe,"Black Beans, Onion, Tomato, Green Bell Pepper, Red Bell Pepper, Coriander, Pickled Jalapenos, Sweet Corn, Sweet Potato, Extra Virgin Olive Oil, Red Chilli Sauce, Red Chilli Powder, Cumin Seeds, Dried Oregano, Sugar, Black Pepper Powder, Clove Garlic, Apple Cider Vinegar White Vinegar, Red Wine, Extra Virgin Olive Oil, Salt, Cashew Nuts, Apple Cider Vinegar White Vinegar, Lemon Juice, Lemon Zest, Water, Salt",27,10,60,70,3,Indian,Side Dish,Vegetarian
Pahari Style Phanu Recipe - Delicious Mixed Dal,"Arhar Dal, White Urad Dal, Tomato, Ginger, Garlic, Turmeric Powder, Asafoetida, Ginger, Garlic, Cumin Seeds, Green Chilli, Mustard Oil",12,120,35,155,4,Uttarakhand-North Kumaon,Lunch,High Protein Vegetarian
Jeera Rice ,"Rice, Cumin Seeds, Ghee, Salt",4,10,20,30,3,Indian,Lunch,Vegetarian
Khatta Meetha Pudla Recipe - Gujarati Style Sweet & Savoury Pancake,"Gram Flour, Tomato, Green Chilli, Turmeric Powder, Red Chilli Powder, Asafoetida, Amchur, Salt, Water, Sunflower Oil Drizzile While Cooking, Jaggery, Whole Wheat Flour, Water, Sunflower Oil Drizzle, Roasted Tomato Pasta Sauce, Green Chutney, Coriander",17,15,25,40,2,Gujarati Recipesï»¿,Snack,Vegetarian
Sweet & Spicy Soy Dipping Sauce Recipe,"Brown Sugar, Water, Soy Sauce, Chilli Vinegar, Paprika Powder, Spring Onion Greens, Sriracha Sauce, Salt",8,5,0,5,1,Asian,Side Dish,Vegetarian
Tangy Raw Beetroot & Tomato Chutney Recipe,"Beetroot, Coriander, Tomato, Green Chilli, Lemon Juice, Water, Salt",7,10,5,15,4,Indian,Side Dish,Vegetarian
Cauliflower Tortilla Recipe,"Cauliflower, Whole Egg, Salt, Black Pepper Powder",4,20,25,45,4,Mexican,Lunch,Diabetic Friendly
Vegetarian Thai Massaman Curry Recipe,"Roasted Peanuts, Spring Onion Greens, Garlic, Tamarind Paste, Dry Red Chilli, Galangal Ginger, Stalk Lemon Grass, Coriander, Cumin Seeds, Cloves, Bay Leaf, Cardamom, Cinnamon Stick, Coconut Milk, Tofu, Broccoli, Carrot, Palm Sugar Brown Sugar, Salt",19,15,40,55,3,Thai,Dinner,High Protein Vegetarian
Eggless Mango Mousse Recipe,"Mango Pulp, Fresh Cream, Caster Sugar, Gelatin Agar Agarchina Grass",4,400,0,400,4,Continental,Dessert,Vegetarian
Maharashtrian Style Sheng Sola Recipe (Vegetable Stew),"Carrot, Potato, Green Peas, Mustard Seeds, Cumin Seeds, Turmeric Powder, Jaggery, Salt, Sesame Seeds, Coriander, Garlic, Ginger",12,10,30,40,4,Maharashtrian Recipes,Lunch,Vegetarian
Tamil Nadu Style Egg Fry Recipe,"Eggs, Oil, Bengal Lentils, Dry Red Chilli, Ginger, Garlic, Whole Black Pepper, Salt",8,5,30,35,4,Tamil Nadu,Appetizer,Eggetarian
Eggless Whole Wheat Cake with Chocolate Buttercream Frosting Recipe,"Whole Wheat Flour, Baking Powder, Baking Soda, Extra Virgin Olive Oil, Brown Sugar, Hung Curd, Water, Cinnamon Powder, Vanilla Extract, Walnuts, Cinnamon Powder, Icing Sugar, Cocoa Powder, Butter, Sugar, Milk",16,20,40,60,4,Continental,Dessert,Vegetarian
Yogurt Lamb Curry Recipe,"Lamb, Onion, Garlic, Dry Ginger Powder, Cardamom, Black Cardamom, Cinnamon Stick, Cloves, Cumin Seeds, Garam Masala Powder, Curd, Kashmiri Dry Red Chilli, Ghee, Salt, Water, Mint Leaves",16,10,60,70,4,Indian,Lunch,Non Vegeterian
Thayir Semiya Recipe (Curd Semiya),"Semiya, Curd, Mustard Seeds, White Urad Dal, Asafoetida, Curry Leaves, Sunflower Oil, Raw Peanuts, Curry Leaves, Sunflower Oil, Cashew Nuts",11,15,20,35,4,Indian,Lunch,Vegetarian
Karela Kadhi Recipe,"Curd, Gram Flour, Water, Salt, Karela, Cumin Seeds, Mustard Seeds, Curry Leaves, Onion, Green Chilli, Ginger",11,10,20,30,4,Rajasthani,Side Dish,Diabetic Friendly
Chicken Cooked in Banana Leaves Recipe,"Boneless Chicken, Lemon, Green Chilli, Coriander, Ginger Garlic Paste, Whole Black Peppercorns, Star Anise, Cloves, Red Chilli Powder, Salt, Turmeric Powder, Banana Leaf, Cotton Threads, Sunflower Oil",14,75,20,95,2,Indian,Appetizer,High Protein Non Vegetarian
Karathe Nonche Recipe - Bitter Gourd Pickle,"Coriander, Mustard Seeds, Methi Seeds, Asafoetida, Karela, Jaggery, Tamarind, Salt, Coconut Oil, Mustard Seeds, Curry Leaves",11,15,30,45,300,Indian,Side Dish,Vegetarian
Spicy Chilli Mango Virgin Mojito Recipe,"Mango, Ginger, Mint Leaves, Green Chilli, Lemon Juice, Lemon, Aerated Water, Salt, Ice Cubes",9,15,15,30,4,Continental,Appetizer,Vegetarian
Kadai Mushroom ,"Button Mushroom, Onion, Tomato, Capsicum, Green Chilli, Ginger, Garlic, Green Coriander, Fenugreek Seeds, Turmeric Powder, Red Chilli Powder, Coriander Powder, Coriander Powder, Bay Leaves, , Whole Black Peppers, Cinnamon, Oil, Salt, Water Make Puree",20,15,35,50,4,Indian,Lunch,Vegetarian
Steamed Lentil Crumbled With Fenugreek Leaves ,"Fenugreek, Salt, Tur Dal, Dry Red Chilli, Asafoetida, Turmeric Powder, Mustard, Curry Leaves, Sesame Seeds Oil",9,10,40,50,3,South Indian Recipes,Dessert,Vegetarian
Grilled Cheese Chocolate Sandwich Recipe,"Whole Wheat Brown Bread, Britannia Cheese Spread, Chocolate Bar, Britannia Cheese Block",4,10,15,25,2,Continental,World Breakfast,Vegetarian
Arbi Jhol Recipe -Uttar Pradesh Style Colocasia & Lotus Seeds Sabzi,"Colocasia Root, Phool Makhana, Tomato, Green Chilli, Ginger, Sunflower Oil Cook, Cumin Seeds, Asafoetida, Red Chilli Powder, Coriander Powder, Cumin Powder, Turmeric Powder, Garam Masala Powder, Kasuri Methi, Salt, Coriander",16,10,20,30,4,Uttar Pradesh,Side Dish,Vegetarian
Hirve Kaalvan Recipe (Fresh Coriander and Coconut Curry),"Coriander, Fresh Coconut, Green Chilli, Cumin Seeds, Coconut Milk, Turmeric Powder, Rice Flour, Salt, Sunflower Oil",9,10,35,45,2,South Indian Recipes,Dinner,Vegetarian
Grilled Vegetable Empanadas Recipe,"All Purpose Flour, Whole Wheat Flour, Sugar, Salt, Extra Virgin Olive Oil, Green Bell Pepper, Red Bell Pepper, Yellow Bell Pepper, Brinjal, Onion, Green Zucchini, Pickled Jalapenos, Button Mushrooms  Large Portobello Mushroom, Corn Cob, Extra Virgin Olive Oil, Salt And Pepper, Red Chilli Powder, Cumin Powder, Coriander Powder, Barbeque Sauce, Goat Cheese, Whole Egg, Coriander",23,15,60,75,6,European,Dinner,Vegetarian
Karnataka Style Tamarind Gojju Recipe,"Tamarind Water, Tomato, Green Chilli, Red Chilli Powder, Ginger, Salt, Mustard Seeds, Curry Leaves, Sunflower Oil",9,5,25,30,4,Karnataka,Side Dish,Vegetarian
Dhaba Style Spicy Ghee Rice Recipe Made From Whole Spices,"Rice, Ghee, Cumin Seeds, Cardamom, Cloves, Star Anise, Â½  Cinnamon Stick, Green Chilli, Curry Leaves, Whole Black Peppercorns, Salt, Bay Leaf, Water, Salt",14,5,15,20,2,Indian,Main Course,Vegetarian
Authentic Godumai Dosai Recipe - Whole Wheat Flour Crepes,"Whole Wheat Flour, Curd, Onion, Green Chilli, Coriander, Curry Leaves, Salt, Sesame",8,10,80,90,4,South Indian Recipes,South Indian Breakfast,Vegetarian
Masala Chai Recipe,"Water, Tea Leaf, Ginger, Cardamom Powder, Pepper Powder, Cinnamon Powder, Milk, Sugar",8,5,10,15,2,Indian,Side Dish,Vegetarian
Stuffed Dahi Vada Recipe,"Avarekai, White Urad Dal, Onion, Ginger, Green Chilli, Salt, Cashew Nuts, Raisins, Curd, Water, Red Chilli Powder, Cumin Powder, Green Chilli, Carrot, Coriander, Salt",16,30,30,60,4,Indian,Snack,Vegetarian
Dahi Wale Makhane Recipe - Lotus Seeds In Curd Gravy,"Onion, Garlic, Sunflower Oil, Turmeric Powder, Red Chilli Powder, Coriander Powder, Garam Masala Powder, Cardamom, Cloves, Curd, Water, Salt, Gram Flour, Ginger, Green Chilli, Phool Makhana, Ghee, Chaat Masala Powder, Cumin Powder, Tandoori Masala, Red Chilli Powder, Lemon Juice",22,10,20,30,2,North Indian Recipes,Lunch,Vegetarian
Carrot Soup Recipe,"Carrots, Onion, Potato, Celery, Ginger, Coriander Powder, Whole Black Peppercorns, Vegetable Stock, Extra Virgin Olive Oil, Lemon Wedges",10,10,15,25,2,Continental,Dinner,Vegetarian
Jolada Ganji Recipe (Jowar Savoury Porridge),"Jowar Flour, Water Buttermilk, Lemon Juice, Salt, Sunflower Oil, Mustard Seeds, Black Urad Dal, Green Chilli, Onion, Curry Leaves",10,5,15,20,2,North Karnataka,Lunch,Vegetarian
Kerala Avial ,"Ash Gourd, Drumsticks, Carrots, Green Beans, Raw Banana, Potato, Yam, Coconut  Grated, Green Chilli, Curry Leaves, Cumin Seeds, Coconut Oil, Salt",13,30,45,75,4,Kerala Recipes,Lunch,Vegetarian
Fried Poha Chivda Recipe,"Poha, Peanuts, Roasted Chana Dal, Boondi, Red Chili Powder, Curry Leaves, Dry Coconut, Salt",8,10,20,30,3,North Indian Recipes,Snack,Vegetarian
Healthy & Delicious Jamun Fruit Smoothie - Black Plum Smoothie Recipe,"Jamun, Curd, Milk, Honey, Crushed Ice",5,10,30,40,3,Indian,World Breakfast,Vegetarian
Khakra Chaat Recipe,"Homemade Whole Wheat Khakras, Green Chutney, Sweet Chutney, Sev, Green Moong Sprouts, Onion, Tomato, Cucumber, Chaat Masala Powder, Red Chilli Powder, Cumin Powder, Coriander",12,15,0,15,4,North Indian Recipes,Snack,Vegetarian
Sweet Potato Avocado Brownie Bites Recipe,"Sweet Potato, Avocado, Whole Eggs, Honey, Coconut Oil, Coconut Flour, Cocoa Powder, Baking Soda, Sea Salt, Chocolate Chips, Walnuts",11,10,30,40,4,Continental,Dessert,Vegetarian
Menthya Jolada Mudde Recipe - Methi & Jowar Balls Recipe,"Jowar Flour, Methi Leaves, Salt, Sunflower Oil, Water, Ghee",6,15,15,30,4,North Karnataka,Main Course,Diabetic Friendly
Big Farm Fresh Pizza Recipe Loaded With Crisp Veggies,"Pizza Base  Homemadestorebought, Fresh Cream, Homemade Pizza And Pasta Sauce, Mozzarella Cheese, Milk, Cabbage, Onion, Baby Corn, Del Monte Black Olives, Carrot, Green Bell Pepper, Sweet Corn, Pickled Jalapenos, Tomato, Salt, Black Pepper Powder, Dried Oregano, Red Chilli Flakes, Extra Virgin Olive Oil",19,15,45,60,4,Italian Recipes,Lunch,Vegetarian
Fennel Pesto Pull-Apart Bread Recipe,"All Purpose Flour, Whole Wheat Flour, Milk Powder, Extra Virgin Olive Oil, Potato, Honey, Salt, Active Dry Yeast, Lukewarm Water, Sesame Seeds, Walnuts Pine Nuts, Fennel Leaves, Cheddar Cheese, Extra Virgin Olive Oil, , Lemon Juice, Lemon Zest, Salt And Pepper",18,20,55,75,8,Continental,Dinner,Vegetarian
Masala Omelette Sliders Recipe - High Protein Breakfast,"Whole Eggs, Onion, Tomato, Cheese, Green Chilli, Coriander, Salt, Sunflower Oil, Pav Buns, Green Chutney, Tomato Ketchup, Butter",12,10,10,20,2,Continental,World Breakfast,Eggetarian
Paatolyo Recipe (Goan Sweet Dish),"Turmeric Leaves, Fresh Coconut, Jaggery, Cardamom Powder, Instant Oats, Ragi Flour, Salt, Dry Fruits, Rice Flour, Jowar Flour, Salt",11,30,15,45,4,Goan Recipes,Dessert,Vegetarian
Mexican Style Pumpkin and Spinach Quesadillas Recipe,"Kaddu, Spinach Leaves, Whole Wheat Flour Tortilla, Extra Virgin Olive Oil, Black Pepper Powder, Paprika Powder, Mozzarella Cheese, Salt",8,5,30,35,4,Mexican,Lunch,Vegetarian
Farm Fresh Vegetarian Pasta Salad Recipe,"Conchiglie Pasta, English Cucumber, Cherry Tomato  Halved, Red Onion, Few  Basil Leaves, Few  Purple Basil, Salt And Pepper, Extra Virgin Olive Oil, Apple Cider Vinegar, Lemon Zest, Lemon Juice, Sugar, Few  Parsley Leaves, Garlic",14,15,15,30,4,Italian Recipes,Appetizer,Vegetarian
Struffoli Recipe,"All Purpose Flour, Lemon Zest, Orange Zest, Curd, Sugar, Vanilla Extract, Salt, Sunflower Oil, Sugar, Honey, Lemon Juice, Hazelnut, Icing Sugar",13,45,30,75,4,Italian Recipes,Dessert,Vegetarian
Grilled Pesto Paneer Recipe,"Paneer, Hung Curd, Extra Virgin Olive Oil Grill, Basil Leaves, Walnuts, Garlic, Parmesan Cheese, Extra Virgin Olive Oil, Salt And Pepper",9,10,20,30,4,Fusion,Appetizer,Vegetarian
Beet Latte Recipe,"Almond Milk, Coconut Milk, Cinnamon Powder, Vanilla Extract, Cocoa Powder, Beetroot Juice, Coconut Sugar",7,10,15,25,2,Continental,Snack,Vegetarian
Assamese Style Mohura Pitha Recipe - Sweet Rice Dumplings Recipe,"Rice Flour, Water, Salt, Fresh Coconut, Jaggery, Raw Peanuts, Cinnamon Powder, Black Pepper Powder",8,5,30,35,6,Assamese,Side Dish,Vegetarian
Chocolate Buckwheat Pancake Skewers Recipe,"Buckwheat Flour, Almond Milk, Baking Powder, Ripe Bananas, Cocoa Powder, Coconut Sugar Raw Sugarpowdered Jaggery, Vanilla Extract, Coconut Oil, Cocoa Powder, Coconut Oil, Maple Syrup Honey, Mixed Fruits",12,10,30,40,2,Continental,World Breakfast,Vegetarian
Andhra Style Peanut Chutney Recipe With Tomatoes,"Roasted Peanuts, Garlic, Tomato, Dry Red Chilli, Sunflower Oil, Mustard Seeds, White Urad Dal, Curry Leaves, Salt",9,15,15,30,6,Andhra,Side Dish,High Protein Vegetarian
Drumstick Dal Recipe,"Arhar Dal, Drumstick, Onion, Tomato, Green Chilli, Kashmiri Red Chilli Powder, Turmeric Powder, Salt, Ghee, Asafoetida, Mustard Seeds, Curry Leaves, Dry Red Chilli",13,15,30,45,4,South Indian Recipes,Lunch,Vegetarian
Kabuli Chana Chaat - High Protein Snack of Chickpea Chaat,"Kabuli Chana, Tomato, Onion, Cucumber, Potato, Green Chilli, Coriander, Chaat Masala Powder, Amchur, Aloo Bhujia, Lemon Juice, Salt",12,0,20,20,4,North Indian Recipes,Snack,High Protein Vegetarian
Dhaba Style Tomato Chutney Recipe,"Tomato, Garlic, Green Chilli, Coriander, Mustard Oil, Salt",6,5,10,15,4,North Indian Recipes,Side Dish,Vegetarian
Moong Dal Idli & Dosa Batter Recipe,"Yellow Moong Dal, Methi Seeds, Idli Rice, Salt",4,480,0,480,700,South Indian Recipes,South Indian Breakfast,High Protein Vegetarian
Bharwa Pyaz Ki Sabzi Recipe,"Pearl Onion, Red Chilli Powder, Turmeric Powder, Amchur, Coriander Powder, Salt, Garlic, Ginger, Tamarind Water, Coriander",10,10,15,25,4,North Indian Recipes,Side Dish,Vegetarian
Grilled Eggplant Roll Recipe With Spicy Herbed Carrots,"Brinjal, Carrots, Homemade Basil Pesto, Parsley Leaves, Parmesan Cheese More, Salt And Pepper, Extra Virgin Olive Oil, Tzatziki Serve",8,20,40,60,4,Continental,Appetizer,Vegetarian
"Dahi Chivda Recipe (Fruit,Yogurt & Flattened Rice Breakfast Parfait)","Poha, Curd, Mango, Strawberries, Mixed Nuts, Honey Palm Sugarsweeten The Yogurt",6,5,10,15,2,Fusion,World Breakfast,Vegetarian
Paan Matka Kulfi Recipe,"Milk, Cardamom Powder, Saffron Strands, Sugar, Sweet Paan Mix, Dried Rose Petals Garnish, Pistachios",7,10,30,40,4,North Indian Recipes,Dessert,Vegetarian
Classic Caesar Salad Recipe,"Green Romaine Lettuce, Cucumber, Cherry Tomato, Fried Bread Cubes, Classic Mayonnaise, Mustard Sauce, Salt, Lemon Juice, Black Pepper Corns, Extra Virgin Olive Oil, Garlic, Sugar, Parmesan Cheese",13,15,0,15,4,Italian Recipes,Appetizer,Vegetarian
Shahi Bhindi Recipe In Cashew Nut Gravy Recipe,"Okra, Red Chilli Powder, Turmeric Powder, Garam Masala Powder, Cream, Kasoori Methi, Oil, Ghee, Onion, Cashew Nuts, Tomato, Garlic, Ginger, Cardamom, , Cinnamon, Green Chili, Cumin Seeds",18,10,40,50,4,North Indian Recipes,Lunch,Vegetarian
Summer Fruit Tart Recipe,"Whole Wheat Oatmeal Cookies, Butter, Butterscotch Ice Cream, Mango Coulis Strawberryblueberry Coulis, Mango, Lychee, Chikoo, Plums, Green Seedless Grapes, Icing Sugar",10,300,30,330,6,Continental,Dessert,Vegetarian
Ayam Goreng Kremes Recipe - Indonesian Style Crunchy Fried Chicken,"Cashew Nuts, Garlic, Onion, Lemon Juice, Kaffir Lime Leaves, Coriander, Tender Coconut Water, Salt, Chicken Breasts, Whole Egg, Rice Flour, Salt, Sunflower Oil, Garlic, Dry Red Chilli, Sunflower Oil Deep Fry",16,10,20,30,4,Indonesian,Appetizer,High Protein Non Vegetarian
Mangalore Buns Recipe - Puffed Banana Puris,"Whole Wheat Flour, Nendra Pazham Banana, Sugar, Baking Soda, Curd, Cumin Seeds, Ghee, Salt, Sunflower Oil Deep Fry",9,20,40,60,4,Mangalorean,South Indian Breakfast,Vegetarian
Spinach And Millet Pulav Recipe,"Foxtail Millet Broken Wheat, Ginger, Tomato, Green Chilli, Bay Leaves, Cardamom, Turmeric Powder, Cumin Powder, Spinach Leaves, Salt, Sunflower Oil, Ghee",12,10,30,40,4,Indian,Dinner,High Protein Vegetarian
Mangalorean Style Lobia Gassi Recipe - Black Eyed Peas In Coconut Curry,"Shallots, Cloves, Fresh Coconut, Dry Red Chilli, Coriander, Cumin Seeds, Methi Seeds, Whole Black Peppercorns, Curry Leaves, Tamarind, Black Eyed Beans, Coconut Milk, Turmeric Powder, Cinnamon Stick, Mustard Seeds, Garlic, Dry Red Chilli, Asafoetida, Sunflower Oil, Salt",20,150,45,195,4,Mangalorean,Lunch,Vegetarian
"Roasted Vegetable Quesadilla Recipe With Zucchini, Carrots & Red Cabbage","Whole Wheat Flour, Salt, Stalks Spring Onion, Carrots, Yellow Zucchini, Red Bell Pepper, Red Cabbage, Tabasco Original, Cumin Powder, Processed Cheese, Extra Virgin Olive Oil",11,20,30,50,6,Mexican,Dinner,High Protein Vegetarian
Traditional Rasmalai Recipe,"Chenna, Sooji, Water, Sugar, Rose Water, Rabdi, Saffron Strands, Slivered Almonds, Cashew Nuts",9,20,40,60,12,Indian,Dessert,Vegetarian
Fusion Style Paneer Malai Makhani Recipe,"Paneer, Onion, Tomato, Ginger Garlic Paste, Coconut Milk, Water, Coriander Powder, Black Pepper Powder, Red Chilli Powder, Turmeric Powder, Kokum, Coconut Oil, Cumin Seeds, Curry Leaves, Whole Black Peppercorns, Methi Seeds, Coriander",17,10,15,25,4,Indian,Side Dish,Vegetarian
Whole Wheat Flour Puttu Recipe,"Whole Wheat Flour, Basmati Rice, Fresh Coconut, Salt, Sugar",5,10,25,35,3,Kerala Recipes,Side Dish,Vegetarian
Zucchini Paratha Recipe,"Green Zucchini, Ajwain, Red Chilli Powder, Amchur, Cumin Powder, Turmeric Powder, Whole Wheat Flour, Water, Ghee, Salt",10,30,15,45,2,Indian,Indian Breakfast,Diabetic Friendly
Indonesian Potato And Chicken Croquette Recipe,"Potato, Whole Egg, Black Pepper Powder, Onion, Cup Chicken, Garlic, Nutmeg Powder, Black Pepper Powder, Soy Sauce, Red Chilli Flakes, Whole Eggs, All Purpose Flour, Whole Wheat Bread Crumbs, Sunflower Oil",14,15,40,55,4,Indonesian,Appetizer,Non Vegeterian
Maavina Hannina Gojju (Karnataka Style Ripe Mango Curry Recipe),"Mango, Green Chilli, Jaggery, Salt, Coconut Oil, Mustard Seeds, Dry Red Chilli, Asafoetida, Curry Leaves",9,15,30,45,4,South Indian Recipes,Lunch,Vegetarian
Chana Dal Aloo Cutlet Recipe - Gram Dal Potato Cutlet Recipe,"Chana Dal, Potato, Green Chilli, Coriander, Mint Leaves, Gram Flour, Chaat Masala Powder, Red Chilli Powder, Ginger, Asafoetida, Cumin Seeds, Fresh Coconut, Cardamom Powder, Sunflower Oil",14,120,40,160,10,Indian,Snack,High Protein Vegetarian
Masala Vadai Kuzhambu Recipe (Mudaliar Style Curried Fritters In Spicy Tamarind Gravy),"Chana Dal, Onion, Green Chilli, Ginger, Salt, Sunflower Oil, Tamarind Paste, Turmeric Powder, Coriander Powder, Red Chilli Powder, Shallots, Garlic, Curry Leaves, Tomato, Salt, Sesame, Mustard Seeds, White Urad Dal, Methi Seeds, Fennel Seeds, Fresh Coconut, Poppy Seeds, Water",23,15,80,95,2,South Indian Recipes,Lunch,Vegetarian
Mexican Corn Salsa Recipe,"Sweet Corn, Onion, Tomato, Green Bell Pepper, Yellow Bell Pepper, Red Bell Pepper, Carrot, Lemon Juice, Extra Virgin Olive Oil, Green Chilli, Tabasco Original, Coriander, Salt",13,10,15,25,4,Mexican,Snack,Vegetarian
Mango And Yogurt Coconut Fool Recipe - Healthy Mango Yogurt Pudding,"Mango, Coconut Milk, Dessicated Coconut, Fresh Cream, Curd, Caster Sugar, Lemon Juice, Mango, Dessicated Coconut",9,20,15,35,2,British,Dessert,Vegetarian
Kerala Style Mutton Pepper Fry Recipe,"Mutton, Cumin Powder, Red Chilli Powder, Coriander Powder, Turmeric Powder, Salt, Lemon Juice, Onion, Garlic, Ginger, Curry Leaves, Black Pepper Powder, Fresh Coconut, Salt, Water, Coconut Oil",16,10,60,70,3,Kerala Recipes,Appetizer,Non Vegeterian
"Stuffed Pita Recipe With Tandoori Mayo Chickpeas, Pickled Onions and Vegetables","Garlic, Kabuli Chana, Parsley Leaves, Red Chilli Powder, Del Monte Tandoori Mayo, Red Bell Pepper, Green Bell Pepper, Onion, Mini Pita Breads, Onion, Vinegar, Salt, Black Pepper Powder, Iceberg Lettuce, Parsley Leaves, Extra Virgin Olive Oil, Butter",17,30,45,75,4,Continental,One Pot Dish,Vegetarian
Cabbage Foogath Recipe - Goan Style Cabbage Stir Fry,"Cabbage, Jaggery, Fresh Red Chilli, Curry Leaves, Mustard Seeds, Asafoetida, Sunflower Oil, Fresh Coconut, Salt",9,10,10,20,4,Goan Recipes,Side Dish,Vegetarian
Lehsun ki Chutney - Spicy Garlic Chutney,"Garlic, Dry Red Chilli, Cumin Seeds, Lemon, Water, Salt",6,15,5,20,4,North Indian Recipes,Side Dish,Vegetarian
Caramelized Onion & Roasted Garlic Pasta Recipe,"Spirali Pasta, Onion, Garlic, Salt, Whole Black Peppercorns, Extra Virgin Olive Oil, Fresh Cream, Mozzarella Cheese, Cheddar Cheese, Basil Leaves",10,10,25,35,2,Italian Recipes,Dinner,Vegetarian
Raw Mango And Spring Onion Chutney Recipe,"Spring Onion Greens, Mango, Dry Red Chilli, Cumin Seeds, Sunflower Oil, Sugar, Salt",7,20,20,40,4,Indian,Side Dish,Vegetarian
Bengali Style Chori Recipe-Mixed Vegetable Sabzi,"Ridge Gourd, Kaddu, Brinjal, Potato, Drumstick, Pointed Gourd, Runner Beans, Mooli Mullangi, Mustard Oil, Sunflower Oil, Dijon Mustard, Green Chilli, Turmeric Powder, Salt, Asafoetida, Panch Phoran Masala, Sugar",17,10,40,50,4,Bengali Recipes,Lunch,Vegetarian
Pumpkin Sabzi Recipe with Panch Phoron Masala,"Kaddu, Curry Leaves, Dry Red Chilli, Panch Phoran Masala, Turmeric Powder, Salt, Mustard Oil",7,10,15,25,4,South Indian Recipes,Lunch,Vegetarian
Jaipuri Aloo Pyaz Ki Sabzi Recipe Using Preethi Electric Pressure Cooker,"Baby Potato, Pearl Onion, Garlic, Ginger, Green Chilli, Bay Leaf, Homemade Tomato Puree, Curd, Turmeric Powder, Kashmiri Red Chilli Powder, Coriander Powder, Garam Masala Powder, Salt, Coriander, Mustard Oil  For Cooking",15,10,45,55,6,Rajasthani,Lunch,Vegetarian
Til Ke Ladoo Recipe - Sesame Ladoo Recipe,"Sesame Seeds, Jaggery, Ghee, Cardamom Powder, Water",5,10,30,40,4,Indian,Dessert,Vegetarian
Hing Pani Puri Recipe-Asafoetida Pani Puri,"Pani Puris, Coriander, Mint Leaves, Green Chilli, Tamarind Water, Jaggery, Black Salt, Cumin Powder, Red Chilli Powder, Ssp Asafoetida, Potato, Green Moong Sprouts, Chaat Masala Powder, Cumin Powder, Red Chilli Powder, Salt",16,15,2,17,4,North Indian Recipes,Appetizer,Vegetarian
Fajeto Recipe - Gujarati Ripe Mango Curry Recipe,"Mango, Curd, Gram Flour, Red Chilli Powder, Turmeric Powder, Jaggery, Asafoetida, Salt, Ghee, Mustard Seeds, Cumin Seeds, Cinnamon Stick, Dry Red Chilli, Ginger, Green Chilli, Curry Leaves, Coriander",17,10,40,50,2,Gujarati Recipesï»¿,Lunch,Vegetarian
Manda Pitha Recipe-Orissa Style Steamed Rice Flour Dumplings,"Rice Flour, Corn Flour, Water, Milk, Salt, Cardamom Powder, Fresh Coconut, Paneer, Sugar",9,20,60,80,4,Oriya Recipes,Dessert,Vegetarian
Red Kidney Beans Tortilla Wraps Recipe,"Rajma, Tortillas, Onion, Tomato, Green Chilli, Coriander Powder, Red Chilli Powder, Garam Masala Powder, Rajma, Lemon Juice, Sunflower Oil, Onion, Lemon Juice, Salt",14,10,20,30,4,Fusion,Lunch,Vegetarian
Satvik Carrot Sprouts Salad Recipe - No Onion No Garlic,"Carrots, Green Moong Sprouts, Green Bell Pepper, Fresh Coconut, Raw Peanuts, Lemon Juice, Black Pepper Powder, Salt, Salt",9,10,5,15,4,Indian,Side Dish,Vegetarian
Rajma Aloo Cutlet Recipe (Tikki/Patty),"Rajma, Potato, Green Chilli, Coriander, Red Chilli Powder, Coriander Powder, Cumin Powder, Garam Masala Powder, Amchur, Gram Flour, Salt, Sunflower Oil",12,20,40,60,4,Indian,Snack,High Protein Vegetarian
Savory Oatmeal Bowl with SautÃ©ed Carrot and Green Bean Recipe,"Rolled Oats Or Instant Oats, Water, Green Beans, Carrot, Ginger, Cloves, Cumin Seeds, Red Chilli Powder, Black Pepper Powder, Coriander Powder, Salt",11,10,15,25,4,World Breakfast,Vegetarian,High Protein Vegetarian
South Indian Bajji Recipe - Onion Bajji | Raw Banana Bajji | Potato Bajji,"Raw Banana, Potato, Onion, Sunflower Oil, Gram Flour, Turmeric Powder, Red Chilli Powder, Cumin Powder, Fennel Seeds, Salt",10,15,25,40,14,South Indian Recipes,Snack,Vegetarian
Vegetable Clear Soup Recipe,"Spring Onion Bulbs, Carrot, Garlic, Carrot, Green Beans, Button Mushrooms, Stalk Spring Onion Greens, Salt, Whole Black Pepper Corns, Water, Lemon",11,10,45,55,4,Continental,Appetizer,Vegetarian
Goan Bimbla Uddamethi Recipe,"Bimbla, Cup Fresh Coconut, Red Chilli Powder, Turmeric Powder, Jaggery, Tablespoon Sunflower Oil, Methi Seeds, White Urad Dal, Mustard Seeds, Curry Leaves, Asafoetida, Salt",12,10,10,20,4,Konkan,Lunch,Vegetarian
Masalewari Koki Recipe (Spiced Sindhi Roti),"Whole Wheat Flour, Onion, Ginger, Green Chilli, Coriander, Mint Leaves, Turmeric Powder, Asafoetida, Cumin Seeds, Ajwain, Red Chilli Powder, Anardana Powder, Ghee, Salt",14,25,15,40,4,Sindhi,Indian Breakfast,Vegetarian
Spicy Kiwifruit Salsa & Feta Toasties Recipe,"Whole Wheat Brown Bread, Feta Cheese, Extra Virgin Olive Oil Butter For Toasting, Kiwi, Onion, Parsley Leaves, Tabasco Original, Honey, Lemon Juice, Salt",10,10,25,35,10,Continental,Snack,Vegetarian
Cheese and Spinach Tart Recipe,"All Purpose Pie Crust, Spinach Leaves, Britannia Cream Cheese, Cheddar Cheese, Garlic, Salt And Pepper, Extra Virgin Olive Oil",7,60,25,85,6,French,Appetizer,Vegetarian
Kayi Saasive Chitranna Recipe,"Fresh Coconut, Mustard Seeds, Dry Red Chilli, Jaggery, Turmeric Powder, Salt, Tamarind Paste Gooseberry Sized Tamarind, Sunflower Oil, Mustard Seeds, Black Urad Dal, Chana Dal, Raw Peanuts, Curry Leaves, Dry Red Chilli, Asafoetida, Rice",16,15,40,55,6,South Indian Recipes,Lunch,Vegetarian
Malvani Kala Chana Masala Recipe - Spicy Kala Chana Curry,"Dry Red Chilli, Coriander, Fennel Seeds, Cumin Seeds, Poppy Seeds, Cloves, Cinnamon Stick, Star Anise, Cardamom, Black Cardamom, Kala Chana, Mustard Seeds, Cumin Seeds, Garlic, Jaggery, Tamarind Water, Fresh Cream, Salt, Coriander, Sunflower Oil",20,10,30,40,4,Maharashtrian Recipes,Lunch,Vegetarian
Kakrar Jhal Recipe - Bengali Style Crab Curry,"Crabs, Potato, Onion, Garlic, Ginger  Paste, Turmeric Powder, Red Chilli Powder, Cumin Powder, Coriander Powder, Salt, Sugar, Homemade Tomato Puree, Green Chilli, Cardamom, Cloves, Cinnamon Stick, Garam Masala Powder, Mustard Oil",18,20,40,60,2,Bengali Recipes,Main Course,Non Vegeterian
Instant Nimbe Avalakki Recipe - Instant Poha Snack,"Poha, Mustard Seeds, Cumin Seeds, Turmeric Powder, Peanut Oil, White Urad Dal, Roasted Gram Dal, Asafoetida, Raw Peanuts, Curry Leaves, Green Chilli, Citric Acid Crystals  Finely Powdered, Salt",13,30,25,55,1,South Indian Recipes,Snack,Vegetarian
Kuvale Sasam Recipe - Konkani Ash Gourd Curry,"Fresh Coconut, Dry Red Chilli, Mustard Seeds, Turmeric Powder, Tamarind, Salt, Water, Vellai Poosanikai, Water, Turmeric Powder, Salt, Sunflower Oil, Mustard Seeds, Dry Red Chilli, Curry Leaves",15,15,20,35,4,Konkan,Main Course,Vegetarian
Chicken Meatball Tacos Recipe,"Chicken, Green Chilli, Salt, Black Pepper Powder, Coriander, Ginger Garlic Paste, Sunflower Oil, Hard Taco Shells, Cheddar Cheese, Refried Beans, Sour Cream, Guacamole, Iceberg Lettuce, Spring Onion Greens, Coriander",15,10,35,45,4,Mexican,Appetizer,Non Vegeterian
Soya Keema Matar Masala Recipe,"Soy Chunks, Onion, Green Chilli, Green Peas, Sunflower Oil, Ginger, Garlic, Coriander Powder, Red Chilli Powder, Turmeric Powder, Garam Masala Powder, Coriander, Salt, Sugar",14,30,25,55,4,Indian,Dinner,High Protein Vegetarian
Baked Yogurt Tart Recipe with Figs & Blueberries Recipe(With Eggless Recipe Option),"Brown Sugar, Instant Oats, All Purpose Flour, Baking Powder, Salt, Butter, Whole Egg, Icing Sugar, Hung Curd, Vanilla Extract, Lemon Zest, Fresh Figs, All Purpose Flour, Blueberries, Nutmeg Powder",15,120,90,210,4,Continental,Dessert,Vegetarian
Spinach and Basil Pasta Sauce Recipe,"Spinach, Basil Leaves, Garlic, Milk, Salt",5,5,10,15,4,Italian Recipes,Vegetarian,Vegetarian
Bengali Style Kanch kolar Kofta Curry Recipe (Green Plantain Kofta Curry Recipe),"Raw Banana, Potato, Turmeric Powder, Panch Phoran Masala, Red Chilli Powder, Tomato, Ginger, Green Chilli, Cumin Seeds, Sugar, Turmeric Powder, Cumin Powder, Garam Masala Powder, Red Chilli Powder, Bay Leaf, Coriander",16,10,30,40,4,Bengali Recipes,Main Course,Vegetarian
Murgh Aloo Tikki Recipe - Chicken & Potato Tikki,"Chicken, Potato, Onion, Green Chilli, Ginger Garlic Paste, Whole Egg, Coriander, Mint Leaves, Salt, Black Pepper Powder, Sunflower Oil",11,10,25,35,4,Indian,Appetizer,Non Vegeterian
Sabudana Thalipeeth Recipe - Tapioca Pearl Spicy Flat Bread,"Sabudana, Potato, Green Chilli  Finely, Ginger, Turmeric Powder, Roasted Peanuts, Coriander, Cumin Seeds, Salt, Ghee Oil For Cooking",10,0,40,40,8,Maharashtrian Recipes,North Indian Breakfast,Vegetarian
Spiced Watermelon Curry Recipe With Carrots & Peppers,"Watermelon, Carrot, Green Bell Pepper, Homemade Tomato Puree, Ajwain, Turmeric Powder, Cumin Powder, Red Chilli Powder, Dry Red Chilli, Coriander, Salt",11,15,30,45,4,Indian,Dinner,Vegetarian
Vegetable Handi Biryani Recipe,"Rice, Cardamom, Bay Leaf, Cinnamon Stick, Cloves, Ghee, Milk, Kala Chana, Carrot, Green Beans, Onion, Garlic, Ginger, Tomato, Green Chilli, Red Chilli Powder, Turmeric Powder, Cumin Powder, Coriander Powder, Garam Masala Powder, Curd, Salt, Sunflower Oil, Coriander, Milk, Saffron Strands, Wheat Berries Whole Wheat",27,20,45,65,4,North Indian Recipes,Lunch,Vegetarian
Hari Dhania Ki Sabzi ( Fresh Coriander leaves Dry Curry) Recipe,"Coriander, Gram Flour, Potato, Turmeric Powder, Salt, Sesame, Mustard Seeds, Green Chilli  Finely, Cumin Seeds, Asafoetida",10,10,15,25,2,Indian,Lunch,Vegetarian
Creamy Polenta With Mushrooms Recipe,"Corn Meal, Milk, Water, Whole Black Peppercorns, Bay Leaf, Butter, Salt, Button Mushrooms, Onion, Garlic, Parsley Leaves, Whole Black Peppercorns, All Purpose Flour, Vegetable Stock, Extra Virgin Olive Oil Butter, Salt, Parmesan Cheese",17,10,60,70,2,Italian Recipes,Side Dish,Vegetarian
Apple and Bok Choy Salad Recipe,"Bok Choy, Apple, Carrot, Onion, Sesame Seeds, Peanut Butter, Dijon Mustard, Red Chilli Sauce, Vinegar, Extra Virgin Olive Oil, Salt, Whole Black Peppercorns",12,15,10,25,4,Asian,Side Dish,Vegetarian
Andhra Style Potato Korma Recipe,"Potato, Stone Flower, Star Anise, Cinnamon Stick, Cardamom, Fennel Seeds, Onion, Tomato, Garlic, Ginger, Coriander, Mint Leaves, Green Chilli, Red Chilli Powder, Coriander Powder, Turmeric Powder, Garam Masala Powder, Salt, Fresh Coconut, Poppy Seeds",20,10,30,40,4,Andhra,Lunch,Vegetarian
Broccoli And Tofu Green Curry Recipe,"Broccoli, Tofu, Sunflower Oil, Soy Sauce Thai Fish Sauce, Coconut Milk, Vegetable Stock, Salt, Lemon Wedges Serve, Lemongrass, Thai Basil Leaves, Galangal, Kaffir Lime Leaves, Shallots, Coriander, Garlic",15,15,20,35,3,Indian,Dinner,Vegetarian
Roasted Tomato And Basil Bruschetta Recipe,"Baguette   Into Thick Slices, Cherry Tomato, Garlic, Extra Virgin Olive Oil, Fresh Thyme Leaves, Ricotta Cheese, Whole Black Peppercorns, Sea Salt, Chilli Oil Drizzle, Basil Leaves",10,10,20,30,8,Italian Recipes,Dinner,Vegetarian
Nepalese Vegetable Pulao Recipe,"Basmati Rice, Cumin Seeds, Turmeric Powder, Bay Leaf, Cloves, Black Cardamom, Cinnamon Stick, Tablespoon Ginger Garlic Paste, Green Chilli, Onion, Tomato, Cup Green Peas, Salt, Sunflower Oil, Tablespoon Lemon Juice",15,15,20,35,2,Nepalese,Main Course,Vegetarian
Mutton Rezala Recipe,"Mutton, Curd, Onion, Ginger, Garlic, Salt, Bay Leaves, Dry Red Chilli, Whole Black Peppercorns, Cinnamon Stick, Cloves, Cardamom, Ghee, Onion, Poppy Seeds, Cashew Nuts, Melon Seeds, Nutmeg Powder, Mace, Sugar, Salt, Ghee",22,60,60,120,4,Bengali Recipes,Dinner,Non Vegeterian
Kondakadalai Puli Vengaya Kuzhambu Recipe (South Indian Style Spicy And Tangy Kala Chana),"Kala Chana, Pearl Onion, Sambar Powder, Turmeric Powder, Jaggery, Tamarind Water, Homemade Tomato Puree, Mustard Seeds, Methi Seeds, Curry Leaves, Salt, Sesame",12,10,30,40,4,Chettinad,Lunch,High Protein Vegetarian
Jowar Bajra Garlic Roti Recipe,"Jowar Flour, Bajra Flour, Garlic, Black Pepper Powder, Salt, Water",6,10,15,25,4,Indian,Lunch,Diabetic Friendly
Bitter Gourd Chips Recipe,"Karela, Rice Flour, Gram Flour, Corn Flour, Coriander Powder, Cumin Powder, Fennel Seeds, Mango, Red Chilli Powder, Turmeric Powder, Salt, Sunflower Oil Deep Fry",12,10,10,20,4,Indian,Snack,Vegetarian
South Indian Coconut Chutney Recipe With Coconut Water,"Dry Coconut, Green Chilli, Roasted Gram Dal, Tender Coconut Water, Rock Salt, Coconut Oil, Mustard Seeds, White Urad Dal, Curry Leaves, Kashmiri Dry Red Chilli",10,10,10,20,2,South Indian Recipes,Side Dish,Vegetarian
Orange Cranberry Cupcakes Recipe,"All Purpose Flour, Orange Zest, Tutti Frutti, Cranberries, Fresh Orange Juice, Butter, Whole Eggs, Caster Sugar, Vanilla Extract, Baking Powder, Salt",11,20,40,60,6,Continental,World Breakfast,Eggetarian
Fizzy Pomegranate Mint Mocktail Recipe,"Fresh Pomegranate Fruit Kernels, Lemon Juice, Mint Leaves, Black Salt, Aerated Water, Sugar, Ice Cubes",7,8,2,10,2,Continental,Appetizer,Vegetarian
Steamed Vegetables With Chilli Lime Butter Recipe,"Carrot, Green Beans, Baby Corn, Button Mushrooms, Butter, Dried Oregano, Red Chilli Flakes, Salt And Pepper, Lemon Juice",9,10,15,25,4,Continental,Side Dish,Vegetarian
Balsamic Glazed Eggplant Feta Rollatini Recipe,"Brinjal, Feta Cheese, Homemade Marinara Sauce, Dried Oregano, Garlic, Basil Leaves, Tomato, Red Radish, Extra Virgin Olive Oil, Balsamic Vinegar, Black Olives, Sea Salt",12,40,15,55,4,Italian Recipes,Appetizer,Vegetarian
Mughlai Dum Arbi Recipe,"Colocasia Root, Cardamom, Cloves, Coriander Powder, Red Chilli Powder, Garam Masala Powder, Turmeric Powder, Fresh Cream, Curd, Salt, Ghee, Onion, Poppy Seeds, Cashew Nuts, Ginger, Garlic",16,10,45,55,4,North Indian Recipes,Side Dish,Vegetarian
Chicken Bharta Recipe - Dhaba Style Chicken Masala,"Chicken Breasts, Onion, Ginger Garlic Paste, Tomato, Green Chilli, Sunflower Oil, Cardamom, Cloves, Bay Leaf, Cinnamon Stick, Black Cardamom, Cumin Powder, Coriander Powder, Kashmiri Red Chilli Powder, Turmeric Powder, Garam Masala Powder, Salt, Sugar, Cashew Nuts, Curd, Fresh Cream, Butter, Kasuri Methi, Kewra Essence, Coriander, Whole Egg",26,20,30,50,4,Indian,Dinner,High Protein Non Vegetarian
Spaghetti Pomodoro Recipe (Pasta in Tomato Basil Sauce),"Homemade Tomato Puree, Garlic, Extra Virgin Olive Oil, Basil Leaves, Spaghetti Pasta Bucatini, Red Chilli Flakes, Salt, Whole Black Peppercorns, Parmesan Cheese",9,10,25,35,2,European,Main Course,Vegetarian
Dal And Vegetable Kebab Recipe,"Kabuli Chana, Black Eyed Beans, Kala Chana, Carrot, Green Bell Pepper, Potato, Onion, Whole Wheat Brown Bread, Mint Leaves, Garlic, Lemon, Salt, Turmeric Powder, Cumin Powder, Chaat Masala Powder, Red Chilli Powder, Sunflower Oil",17,30,45,75,4,Indian,Appetizer,Vegetarian
Sundaikkai Godumai Rava Upma Recipe,"Turkey Berry, Broken Wheat, Water, Onion, Turmeric Powder, Dry Red Chilli, Ginger, Asafoetida, Mustard Seeds, Cumin Seeds, Chana Dal, Raw Peanuts, Methi Seeds, Curry Leaves, Coriander, Salt, Sunflower Oil",17,10,25,35,3,South Indian Recipes,South Indian Breakfast,Vegetarian
Karnataka Style Avarekalu Kosambari Recipe,"Avarekalu  Lilva Beans, Carrot, Sweet Corn, Yellow Moong Dal, Green Chilli, Lemon, Fresh Coconut, Coriander, Salt, Sunflower Oil, Asafoetida, Mustard Seeds, Curry Leaves",13,30,5,35,4,Karnataka,Side Dish,Vegetarian
Chicken Pizza With Caramelised Red Onion Recipe,"Whole Wheat Flour, All Purpose Flour, Extra Virgin Olive Oil, Active Dry Yeast, Honey, Salt, Lukewarm Water, Homemade Tomato Puree, Onion, Garlic, Dried Thyme Leaves, Red Chilli Flakes, Tabasco Original, Sugar, Salt, Basil Leaves, Onion, Sugar, Vinegar, Extra Virgin Olive Oil, Chicken Breasts, Dried Thyme Leaves, Black Pepper Powder, Salt, Extra Virgin Olive Oil, Mozzarella Cheese",26,120,60,180,4,Italian Recipes,Lunch,Non Vegeterian
Kung Pao Chicken With Vegetable Fried Rice Recipe,"Boneless Chicken, Ginger, Salt, Whole Black Peppercorns, Roasted Peanuts, Green Bell Pepper, Spring Onion, Dry Red Chilli  Soaked In Water And, Soy Sauce, Vinegar, Garlic, Green Chilli, Tomato Ketchup, Extra Virgin Olive Oil Sesame Oil",14,25,20,45,4,Asian,Lunch,Non Vegeterian
Shahi Bhindi Recipe in Cashew Nut Gravy - Okras in Cashew Nut Curry,"Bhindi, Red Chilli Powder, Turmeric Powder, Garam Masala Powder, Fresh Cream, Kasuri Methi, Sunflower Oil, Ghee, Onion, Cashew Nuts, Tomato, Garlic, Ginger, Cardamom, Cloves, Cinnamon Stick, Green Chilli, Cumin",18,10,40,50,4,North Indian Recipes,Lunch,Vegetarian
Kashmiri Style Nadru Yakhni Recipe-Lotus Stem in Yogurt Sauce,"Lotus Stem, Curd, Gram Flour, Dry Ginger Powder, Fennel Seeds, Ajwain, Cinnamon Stick, Black Cardamom, Cardamom, Cloves, Bay Leaf, Asafoetida, Garam Masala Powder, Ghee, Salt",15,20,40,60,4,Kashmiri,Lunch,Vegetarian
Mughlai Bhindi Recipe - Spicy Okra Curry,"Bhindi, Onion, Tomato, Ginger Garlic Paste, Turmeric Powder, Garam Masala Powder, Salt, Sunflower Oil, Coriander, Cumin Seeds, Red Chilli Flakes, Fennel Seeds, Whole Black Peppercorns, Badam",14,15,30,45,2,Mughlai,Lunch,Vegetarian
Kesar Badam Cupcakes With Shrikhand Recipe,"Badam, Saffron Strands, All Purpose Flour, Baking Powder, Butter, Sunflower Oil, Condensed Milk, Curd, Almond Essence, Hung Curd, Condensed Milk, Cardamom, Saffron Strands, Badam, Saffron Strands",15,30,15,45,4,Fusion,Snack,Vegetarian
Muttai Parotta Recipe ( Ande Ka Paratha / Egg Filled Flat Bread),"All Purpose Flour, Salt, Water Knead, Whole Eggs, Onion, Tomato, Coriander, Green Chilli, Salt, Sunflower Oil",10,5,40,45,4,Tamil Nadu,Main Course,Eggetarian
Asian Shrimp Rice Burger Recipe,"Thai Jasmine Rice, Water, Sunflower Oil, Shrimps, Shrimps, Salt, Black Pepper Powder, Soy Sauce, Whole Wheat Bread Crumbs, Whole Egg, Classic Mayonnaise, Black Pepper Powder, Sriracha Sauce, Salt, Soy Sauce, Sesame, Black Sesame Seeds Sprinkle, Onion Rings, Iceberg Lettuce",19,20,20,40,4,Asian,Main Course,Non Vegeterian
Homemade Herb Butter Recipe,"Salted Butter, Parsley Leaves, Basil Leaves, Chives, Lemon Zest",5,10,20,30,100,Continental,Side Dish,Vegetarian
Braised Pork Belly Recipe,"Pork Belly   Into  Cm Thick Pieces, Chinese Rice Wine, Soy Sauce, Dark Soy Sauce, Ginger, Sugar, Star Anise",7,10,120,130,4,Chinese,Dinner,Non Vegeterian
Maharashtrian Style Namkeen Shankarpali (Savory Flaky Pastry Diamonds Recipe),"Whole Wheat Flour, Sooji, Cumin Seeds, Red Chilli Powder, Ghee, Salt",6,30,25,55,4,Maharashtrian Recipes,Snack,Vegetarian
Semolina Gujiya Recipe,"All Purpose Flour, Ghee, Milk, Sooji, Fresh Coconut, Sugar, Khuskhus, Cardamom Powder, Nutmeg Powder, Raisins, Badam, Ghee",12,10,45,55,4,Gujarati Recipesï»¿,Dessert,Vegetarian
Crispy and Spicy Chilli Chicken Recipe - Indian Style,"Chicken, Salt, Turmeric Powder, Coriander, Green Chilli, Cinnamon Stick, Cloves, Cumin Seeds, Garlic, Ginger  Grated, Onion, Curry Leaves, Curd, Corn Flour, All Purpose Flour, Egg White, Sunflower Oil Deep Fry",17,10,15,25,5,Indian,Side Dish,Non Vegeterian
Lehsuni Methi Paneer Recipe - Garlic Methi Paneer Curry,"Paneer, Kasuri Methi, Curd, Fresh Cream, Garam Masala Powder, Cardamom Powder, Salt, Ghee, Whole Cashews, Garlic, Green Chilli, Ginger",12,10,15,25,4,North Indian Recipes,Dinner,High Protein Vegetarian
Spinach Tomato Soup Italian Style Recipe,"Onion, Carrots, Cups Spinach, Tomato, Garlic, Vegetable Stock, Red Chilli Flakes, Paprika Powder, Dried Oregano, Black Pepper Powder, Salt, Extra Virgin Olive Oil, Penne Pasta, White Vinegar",14,15,30,45,4,Italian Recipes,Dinner,Vegetarian
Chettinad Thakkali Vengaya Kuzhambu Recipe,"Tamarind Water, Pearl Onion, Tomato, Sambar Powder, Whole Black Peppercorns, Salt, Jaggery, Sesame, Mustard Seeds, Methi Seeds, Curry Leaves",11,10,30,40,4,Chettinad,Lunch,Vegetarian
Samai Arisi Pidi Kozhukattai (Tamil Nadu Breakfast Recipe),"Mixed Millets, Yellow Moong Dal, Sesame, Mustard Seeds, Cumin Seeds, Chana Dal, White Urad Dal, Ginger, Whole Black Peppercorns  Coarsely Powdered, Green Chilli  Roughly, Curry Leaves",11,40,20,60,4,Tamil Nadu,South Indian Breakfast,Diabetic Friendly
Mushroom Stroganoff Recipe,"Onion, Garlic, Button Mushrooms, Carrot, Green Beans, Baby Corn, Dried Oregano, Dried Thyme Leaves, Fresh Cream, Salt And Pepper, Sunflower Oil, Cooked Rice, Onion, Garlic, Green Peas, Sugar, Fresh Oregano, Butter, Salt",19,10,30,40,4,Continental,Main Course,Vegetarian
Delicious Skillet Roasted Fondant Potatoes Recipe,"Butter, Potato, Garlic, Fresh Thyme Leaves, Salt",5,0,30,30,4,French,Appetizer,Vegetarian
Parsi Mutton Cutlets Recipe,"Mutton, Ginger, Garlic, Onion, Coriander, Mint Leaves, Green Chilli, Red Chilli Powder, Turmeric Powder, Potato, Salt, Cloves, Cinnamon Stick, Sunflower Oil, Whole Wheat Bread Crumbs",15,10,40,50,4,Parsi Recipes,Appetizer,Non Vegeterian
Foxtail Millet Khichdi Recipe with Batata Aloo Nu Shaak,"Foxtail Millet, Yellow Moong Dal, Ginger, Turmeric Powder, Cinnamon Stick, Ghee, Asafoetida, Whole Black Peppercorns, Cumin Seeds",9,10,45,55,4,Indian,Dinner,Vegetarian
Konkani Tendli Sukke Recipe - Ivy Gourd/Tindora Stir Fry,"Tindora, Sunflower Oil, Mustard Seeds, Curry Leaves, Salt, Fresh Coconut, Coriander, White Urad Dal, Dry Red Chilli, Jaggery, Tamarind",11,10,20,30,4,Konkan,Side Dish,Vegetarian
Cheese And Corn Tostadas Recipe,"Tortillas, Sweet Corn, Avocado, Cheddar Cheese, Salt, Black Pepper Powder, Sunflower Oil, Lemon",8,10,20,30,3,Mexican,Dinner,Vegetarian
Oats Unni Appam/ Nei Appam Recipe,"Instant Oats, Whole Wheat Flour, Rice Flour, Jaggery, Ripe Bananas, Water, Baking Soda, Ghee",8,20,20,40,4,Kerala Recipes,Snack,Vegetarian
Kavuni Arisi Payasam Recipe - Black Rice Kheer,"Black Rice, Water, Milk, Sugar, Cardamom, Ghee, Cashew Nuts, Raisins",8,20,20,40,5,Chettinad,Dessert,Vegetarian
Pumpkin Dal with Garlic Tadka Recipe,"Arhar Dal, Yellow Moong Dal, Masoor Dal, Ginger, Green Chilli, Cinnamon Stick, Bay Leaves, Tomato, Kaddu, Salt, Sunflower Oil, Turmeric Powder, Ghee, Cumin Seeds, Garlic, Dry Red Chilli",16,15,30,45,4,North Indian Recipes,Dinner,Diabetic Friendly
Chicken Mie Goreng Recipe - Noodles Tossed In Sriracha Sauce,"Wheat Noodles, Chicken Breasts, Onion, Garlic, Red Bell Pepper, Broccoli, Button Mushrooms, Spring Onion Greens, Soy Sauce, Sriracha Sauce, Whole Egg, Salt And Pepper, Sunflower Oil",13,10,30,40,4,Indonesian,Lunch,Non Vegeterian
Muttai Kuzhambu Recipe - South Indian Egg Curry,"Whole Eggs, Onion, Garlic, Tomato, Coriander Powder, Red Chilli Powder, Turmeric Powder, Garam Masala Powder, Salt, Coriander, Mustard Seeds, Cumin Seeds, Sunflower Oil",13,5,20,25,4,South Indian Recipes,Dinner,Eggetarian
Bhindi Huli Recipe - South Indian Style Tangy Okra,"Bhindi, Onion, Tamarind Paste, Turmeric Powder, Red Chilli Powder, Sambar Powder, Coconut Oil, Mustard Seeds, Salt",9,10,10,20,4,South Indian Recipes,Lunch,Vegetarian
Ukad Recipe (Maharashtrian Rice Flour Porridge),"Rice Flour, Curd, Water As Required, Salt, Mustard Seeds, Turmeric Powder, Asafoetida, Garlic, Green Chilli, Curry Leaves",10,5,5,10,1,Maharashtrian Recipes,Dinner,Vegetarian
Coconut Kewra Drink Recipe,"Fresh Coconut, Kewra Essence, Crushed Ice, Tender Coconut Water",4,5,5,10,1,Indian,Snack,Vegetarian
Cheese Broccoli Fritter Recipe - Pan Fried Broccoli Pakora,"Broccoli, Corn Flour, All Purpose Flour, Salt, Baking Powder, Red Chilli Powder Smoked Paprika, Parmesan Cheese, Clove Garlic, Sunflower Oil",9,0,40,40,4,Indian,Snack,Vegetarian
Paneer Pancake Recipe,"Paneer, Whole Eggs Flax Meal Egg Replacer, Sugar, Baking Powder, Whole Wheat Flour, Salt, Milk, Butter",8,10,30,40,4,Continental,World Breakfast,Eggetarian
Corn Toast Recipe With Moong Sprouts & Vegetables,"Whole Wheat Brown Bread, Butter, Sweet Corn, Green Moong Sprouts, Carrots, Tomato, Salt And Pepper, Red Chilli Flakes, Milk, Corn Flour",10,10,10,20,4,Continental,Snack,Vegetarian
Rajasthani Dal Baaple Churma Recipe,"Whole Wheat Flour, Sooji, Ghee, Caster Sugar, Badam, Pistachios, Chana Dal, Arhar Dal, Green Moong Dal, Black Urad Dal, Pink Masoor Dal, Tomato, Turmeric Powder, Red Chilli Powder, Coriander Powder, Garam Masala Powder, Coriander, Ghee, Mustard Seeds, Cumin Seeds, Cloves, Cinnamon Stick, Asafoetida, Curry Leaves, Kashmiri Red Chilli Powder, Bay Leaf, Whole Wheat Flour, Sooji, Gram Flour, Ghee, Salt, Milk, Water, Lemon Wedges, Green Chilli, Papad, Ghee",37,25,35,60,2,Rajasthani,Lunch,Vegetarian
Kathirikkai Thogayal Recipe - Thuvaiyal (Spicy Brinjal Chutney Recipe),"Brinjal, Dry Red Chilli, Whole Black Peppercorns, Chana Dal, White Urad Dal, Mustard Seeds, Turmeric Powder, Red Chilli Powder, S Curry Leaves, Tamarind, Salt, Sunflower Oil",12,20,30,50,4,South Indian Recipes,Side Dish,Vegetarian
Vegetarian Potato Hash Recipe,"Button Mushrooms, Green Bell Pepper, Sweet Corn, Onion, Potato, Tomato Ketchup, Soy Sauce, Italian Seasoning, Fresh Thyme Leaves, Water, Salt And Pepper, Extra Virgin Olive Oil",12,15,40,55,4,Continental,World Breakfast,Vegetarian
Thai Yellow Chicken Curry Recipe,"Ginger, Yellow Bell Pepper, Garlic, Dry Red Chilli, Lemongrass, Coriander, Coriander, Salt, Black Pepper Powder, Kaffir Lime Leaves, Turmeric Powder, Onion, Ginger, Garlic, Potato, Chicken Thighs, Coconut Milk, Sugar, Sunflower Oil, Salt, Salt",21,15,25,40,4,Thai,Dinner,Non Vegeterian
Okra Bamia Recipe,"Bhindi, Tomato, Onion, Garlic, Coriander Powder, Red Chilli Powder, Lemon Juice, Extra Virgin Olive Oil, Salt",9,20,25,45,4,Middle Eastern,Lunch,Vegetarian
Fruit Pachadi Recipe,"Mixed Fruits, Curd, Turmeric Powder, Jaggery, Salt, Water, Fresh Coconut, Green Chilli, Mustard Seeds, Mustard Seeds, Dry Red Chilli, Sunflower Oil, Curry Leaves",13,5,15,20,4,South Indian Recipes,Side Dish,Vegetarian
Italian Home Style Ravioli in Lemon Recipe-Garlic White Sauce Recipe,"All Purpose Flour, Whole Eggs, Del Monte Black Olives, Salt, Paneer, Red Amaranth Leaves Spinach Leaves, Nutmeg Powder, Black Pepper Powder, Salt, Butter, Onion, Garlic, Cherry Tomato  Halved, Del Monte Green Olives, Del Monte Black Olives, Lemon Zest, Fresh Cream, Milk, Sichuan Peppercorns  Freshly Crushed With Mortar And Pestle, Red Chilli Flakes, Cheddar Cheese, Salt, Lemon Zest, Parsley Leaves  Finely, Mint Leaves, Garlic",26,10,150,160,4,Italian Recipes,Lunch,Vegetarian
Uppu Seedai Recipe - Krishna Janmashtami | Gokulashtami,"Rice, White Urad Dal, Chana Dal, Fresh Coconut, Sesame Seeds, Asafoetida, Ghee, Salt, Sunflower Oil",9,720,20,740,40,South Indian Recipes,Snack,Vegetarian
Grilled Rajma Masala Sandwich Recipe,"Whole Wheat Brown Bread, Onion, Potato, Rajma, Ginger, Clove Garlic, Turmeric Powder, Red Chilli Powder, Garam Masala Powder, Chaat Masala Powder, Salt, Sunflower Oil",12,10,30,40,3,Indian,Indian Breakfast,High Protein Vegetarian
Karnataka Style Avarekalu Akki Rotti Recipe,"Rice Flour, Avarekalu  Lilva Beans, Onion, Fresh Coconut, Green Chilli, Curd, Cumin Powder, Coriander, Asafoetida, Salt, Water Knead Dough",11,15,30,45,4,Karnataka,South Indian Breakfast,Vegetarian
Goan Style Caldinho de Abobora Branca Recipe (Mild Curry of white Pumpkin),"Vellai Poosanikai, Onion, Salt, Lemon Juice, Coriander, Sunflower Oil, Fresh Coconut, Cumin Seeds, Ginger, Garlic, Turmeric Powder",11,10,25,35,4,Goan Recipes,Lunch,Vegetarian
Beans Karam Recipe (Beans Curry),"Green Beans, Onion, Coriander, Cumin Seeds, Dry Red Chilli, Byadagi Dried Chilli, Fresh Coconut, Dessicated Coconut, Poppy Seeds, Tamarind, Jaggery, Turmeric Powder, Salt, Mustard Seeds, Curry Leaves, Asafoetida",16,10,35,45,4,North Indian Recipes,Lunch,Vegetarian
Indo Chinese Soya Stir Fry Recipe With Cashew Nuts,"Soy Chunks, Garlic, Carrots, Red Bell Pepper, Spring Onion Greens, Green Beans, Soy Sauce, Sweet And Spicy Red Chilli Sauce, Rice Vinegar Regular Vinegar, Sesame, Cashew Nuts, Sesame Seeds",12,10,20,30,4,Indo Chinese,Lunch,Vegetarian
Calicut Payyoli Chicken Fry Recipe,"Chicken, Garlic, Ginger, Kashmiri Red Chilli Powder, Turmeric Powder, Vinegar, Green Chilli, Meat Masala, Fresh Coconut, Salt, Curry Leaves, Coconut Oil, Water",13,15,20,35,4,Kerala Recipes,Appetizer,High Protein Non Vegetarian
Mango Musk Melon Chia Seeds Pudding Recipe,"Musk Melon, Mango, Milk Coconut Milk, Honey Agave Nectar, Chia Seeds, Pistachios, Ripe Bananas, Mango, Pistachios",9,10,15,25,2,Continental,World Breakfast,Vegetarian
Kacche Aam Aur Lehsun Ki Dal Recipe -Curried Lentils With Mango & Garlic,"Arhar Dal, Mango, Tomato, Green Chilli, Turmeric Powder, Salt, Water, Ghee, Garlic, Cumin Seeds, Ssp Asafoetida, Kashmiri Red Chilli Powder, Dry Red Chilli, Coriander",14,20,30,50,4,Indian,Side Dish,High Protein Vegetarian
Coconut Peanut Chutney Recipe (No Onion No Garlic Recipe),"Fresh Coconut, Green Chilli, S Coriander, Curry Leaves, Roasted Peanuts, Salt Rock Salt",6,20,20,40,4,South Indian Recipes,Side Dish,No Onion No Garlic (Sattvic)
Muesli Chia Seeds Kaiser Roll Recipe - Hard Roll Recipe,"All Purpose Flour, Instant Oats, Muesli, Chia Seeds, Active Dry Yeast, Salt, Sugar, Whole Egg, Butter, Milk, Sesame Seeds",11,60,45,105,6,Continental,Appetizer,Vegan
Cheesy Masala Omelette Recipe With Roasted Vegetables,"Whole Eggs, Coriander, Green Chilli, Salt, Garlic, Onion, Baby Corn, Red Bell Pepper, Veeba Sweet Chilli Sauce, Stalks Spring Onion Greens, Salt, Sunflower Oil, Britannia Cheezza",13,10,15,25,2,Continental,World Breakfast,Eggetarian
Aava Pettina Majjiga Pulusu Recipe - Andhra Style Mor Kuzhambu,"Curd, Water, Baby Potato, Carrot, Bottle Gourd, Tomato, Salt, Green Chilli, Turmeric Powder, Asafoetida, Curry Leaves, Chana Dal, Sesame Seeds, Rice, Mustard Seeds, Fresh Coconut, Hot Water, Sunflower Oil, Mustard Seeds, Methi Seeds, Asafoetida",21,20,15,35,2,Andhra,Lunch,Vegetarian
Szechwan Hakka Noodle Momo Recipe,"Carrot, Green Bell Pepper, Onion, Hakka Noodles, Stalks Spring Onion, Schezwan Sauce, Black Pepper Powder, Salt, All Purpose Flour, Water Knead",10,25,30,55,4,Indo Chinese,Appetizer,Vegetarian
Penne With Creamy Pumpkin Sauce Recipe With Broccoli,"Broccoli, Penne Pasta, Pumpkin Pasta Sauce, Basil Leaves, Salt And Pepper, Extra Virgin Olive Oil, Italian Seasoning",7,20,40,60,4,Italian Recipes,Main Course,Vegetarian
Gajar Shalgam Ka Paani Wala Achar Recipe - Carrot And Turnip Pickle,"Turnips, Carrots, Water, Vinegar, Mustard Seeds, Fennel Seeds, Cumin Seeds, Methi Seeds, Salt",9,10,15,25,4,North Indian Recipes,Side Dish,Vegetarian
Mangalorean Style Biscuit Roti Recipe,"Whole Wheat Flour, Baking Powder, Salt, Sunflower Oil, Turmeric Powder, Water, Sunflower Oil, Mustard Seeds, White Urad Dal, Cumin Powder, Coriander Powder, Sambar Powder, Red Chilli Powder, Salt, Turmeric Powder, Sugar, Sooji, Curry Leaves, Sunflower Oil",19,25,30,55,4,Mangalorean,Snack,Vegetarian
Spinach & Paneer Cornmeal Roll Recipe,"Corn Meal, Whole Wheat Flour, Oats Flour, Active Dry Yeast, Sugar, Extra Virgin Olive Oil, Milk, Buttermilk, Water Knead, Salt, Spinach, Paneer, Red Bell Pepper, Red Chilli Powder, Ajwain, Black Pepper Powder",16,60,45,105,4,Continental,Snack,Vegetarian
Homemade Trail Mix Recipe with Dry Fruits,"Walnuts, Badam, Pistachios, Raisins, Cranberries, Dates, Sunflower Seeds",7,10,30,40,2,Continental,Snack,Vegetarian
Sri Lankan Chicken Curry Recipe,"Chicken, Onion, Tomato, Garlic, Ginger  Finely, Curry Leaves, Coriander Powder, Red Chilli Powder, Turmeric Powder, Pandan Leaf, Lemongrass, Salt, Sunflower Oil, Water, Sunflower Oil, Water",16,15,40,55,4,Sri Lankan,Dinner,High Protein Non Vegetarian
Kobiche Vade Recipe - Cabbage And Multigrain Fritters,"Cabbage, Multigrain Flour, Gram Flour, Rice Flour, Sunflower Oil, Green Chilli, Ginger, Garlic, Cumin Seeds, Ajwain, Coriander, Lemon Juice, Salt",13,15,20,35,10,Indian,Snack,Vegetarian
Roasted Cauliflower Dill Soup Recipe,"Cauliflower, Milk, S Dill Leaves, Walnuts, Salt, Black Pepper Powder, Sunflower Oil",7,10,45,55,4,Continental,Appetizer,Vegetarian
Bihari Style Kadhi Badi Recipe,"Curd, Gram Flour, Turmeric Powder, Red Chilli Powder, Salt, Gram Flour, Ajwain, Kalonji, Turmeric Powder, Onion, Salt, Red Chilli Powder, Sunflower Oil Deep Fry, Water, Cumin Seeds, Dry Red Chilli, Curry Leaves, Ginger Garlic Paste, Sunflower Oil, Sunflower Oil",20,30,45,75,4,Bihari,Side Dish,High Protein Vegetarian
Apple Vanilla Whole Wheat Pancakes Recipe,"Whole Wheat Flour, Baking Powder, Salt, Whole Eggs, Vanilla Extract, Milk, Apple, Sunflower Oil, Honey, Mixed Fruits Apples For Serving",10,5,30,35,4,Continental,World Breakfast,Vegetarian
Ice-Apple And Plum Rose Juice Recipe,"Plum Rose Fruit, Ice Apple, Sugar, Lemon Juice",4,10,10,20,1,Continental,World Breakfast,Vegetarian
Kathirikai UrulaiKizhanghu Pachidi Recipe (Brinjals And Potatoes With Moong Dal),"Yellow Moong Dal, Turmeric Powder, Shallots, Tomato, Brinjal, Potato, Green Chilli, Salt, Coriander, Sunflower Oil, Curry Leaves, Dry Red Chilli, Mustard Seeds, White Urad Dal",14,10,35,45,2,South Indian Recipes,Lunch,Vegetarian
Masala Lachha Paratha Recipe,"Whole Wheat Flour, Coriander Powder, Red Chilli Powder, Garam Masala Powder, Turmeric Powder, Salt, Sunflower Oil, Water, Ghee Layer And Cooking Parathas",9,15,15,30,4,North Indian Recipes,Lunch,Vegetarian
Murungakkai Puli Kuzhambu Recipe -Spicy Drumstick Curry,"Mustard Seeds, Methi Seeds, Curry Leaves, Shallots, Tomato, Tamarind Water, Drumstick, Asafoetida, Turmeric Powder, Sambar Powder, Coriander Powder, Salt, Sunflower Oil",13,20,30,50,4,South Indian Recipes,Side Dish,Vegetarian
Mangalorean Padengi Gassi Recipe - Green Moong Dal Curry,"Green Moong Dal, Onion, Tomato, Turmeric Powder, Salt, Tamarind Water, Fresh Coconut, Dry Red Chilli, Coriander, Cumin Seeds, Mustard Seeds, White Urad Dal, Garlic, Dry Red Chilli, Curry Leaves",15,10,45,55,4,Mangalorean,Dinner,High Protein Vegetarian
Spicy & Masaledar Aloo Gobi & Beans Tawa Sabzi Recipe,"Potato, Cauliflower, Green Beans, Tomato, Ginger, Garlic, Green Chilli, Red Chilli Powder, Turmeric Powder, Coriander Powder, Cumin Powder, Garam Masala Powder, Amchur, Salt, Sunflower Oil, Coriander",16,10,30,40,4,North Indian Recipes,Lunch,Vegetarian
Konkani Style Sungta Ambat Aani Tallel Sungta Recipe- Fried Prawns & Curry,"Prawns, Fresh Coconut, Coriander, Whole Black Peppercorns, Byadagi Dried Chilli, Tamarind, Turmeric Powder, Red Chilli Powder, Onion, Potato, Sunflower Oil, Sunflower Oil, Salt, Prawns, Lemon Juice, Turmeric Powder, Red Chilli Powder, Coriander Powder, Rice Flour, Sooji, Salt, Sunflower Oil",22,25,30,55,4,Konkan,Lunch,Non Vegeterian
Avocado Egg Sandwich Recipe,"Avocados, Lemon Juice, Black Pepper Powder, Salt, Extra Virgin Olive Oil, Whole Wheat Brown Bread, Cucumber, Pickled Jalapenos, Boiled Egg, Iceberg Lettuce, Gherkins, Coriander",12,10,15,25,4,Continental,World Breakfast,Eggetarian
Grated Carrot Cucumber Tomato Raita Recipe,"Cucumber, Tomato, Carrot, Curd, Green Chilli, Cumin Seeds, Red Chilli Powder, Salt, Black Pepper Powder",9,15,0,15,2,Indian,Side Dish,Vegetarian
Lemon Ginger Spice Detox Tea Recipe,"Water, Ginger, Cinnamon Stick, Cardamom, Mint Leaves, Tulsi, Lemongrass, Black Tea, Sugar",9,5,5,10,2,Continental,Appetizer,Vegetarian
Basil Pesto Bombs Recipe,"Basil Leaves, Garlic, Walnuts, Extra Virgin Olive Oil, Parmesan Cheese, Black Pepper Powder, Lemon Juice, Salt, Sweet Potato, Chia Seeds, Dried Oregano, Apple Cider Vinegar, Garlic  Minced, Red Chilli Flakes, Oats Flour, Salt, Sunflower Oil Cook",17,5,40,45,4,Continental,Appetizer,Vegetarian
Maharashtrian Chavali Chi Usal Recipe - Black Eyed Peas Curry,"Black Eyed Beans, Onion, Tomato, Garam Masala Powder, Red Chilli Powder, Turmeric Powder, Onion, Fresh Coconut, Coriander, Fennel Seeds, Ginger, Garlic",12,130,30,160,4,Maharashtrian Recipes,Lunch,Vegetarian
Goan Style Empada De Camarao Recipe (Prawn Pie),"Prawns, Onion, Tomato, Dry Red Chilli, Garlic, Cinnamon Stick, Whole Black Peppercorns, Onion, Tamarind Paste, Whole Wheat Flour, Vivatta Maida, Red Chilli Powder, Salt, Sugar, Chilled Butter, Chilled Water",16,10,60,70,4,Goan Recipes,Lunch,Non Vegeterian
Coffee Raisin Cake With Sugar Glaze Recipe,"Butter, Cup Sugar, Cup Vivatta Maida, Baking Powder, Salt, Milk, Whole Eggs, Instant Coffee Powder, Butter, All Purpose Flour, Brown Sugar, Instant Coffee Powder, Raisins, Sugar, Water",15,15,45,60,12,Continental,Dessert,Vegetarian
Patta Gobi Matar Nu Shaak Recipe (Cabbage & Peas Sabzi Recipe),"Cabbage, Green Peas, Mustard Seeds, Bay Leaf, Curry Leaves, Tomato, Turmeric Powder, Red Chilli Powder, Garam Masala Powder, Salt, Sunflower Oil",11,10,15,25,4,North Indian Recipes,Lunch,Vegetarian
Spicy & Tangy Pakodi Chaat Recipe,"Dried Yellowwhite Peas, Turmeric Powder, Gram Flour, Onion, Baking Soda, Salt, Black Pepper Powder, Cumin Powder, Coriander Powder, Green Chutney, Sweet Chutney, Sugar, Curd, Green Chilli, Sunflower Oil, Black Salt, Onion, Raw Peanuts, Curry Leaves",19,30,10,40,2,North Indian Recipes,Snack,Gluten Free
Green Tea Recipe,"Green Tea Leaves, Water, Honey",3,2,5,7,2,Asian,Vegetarian,Gluten Free
Peanut Butter Chicken Recipe,"Chicken Breasts, Onion, Tomato, Chicken Stock, Peanut Butter, Chilli Oil, Salt, Black Pepper Powder, Sunflower Oil",9,10,15,25,3,Asian,Dinner,High Protein Non Vegetarian
Chilli Ginger Vegetable Tofu Stir Fry Recipe,"Tofu, Button Mushrooms, Red Bell Pepper, Yellow Bell Pepper, Green Bell Pepper, Baby Corn, Green Beans, Broccoli, Onion, Garlic, Ginger, Ginger, Fresh Red Chilli, Plum Sauce, Light Soy Sauce, Rice Wine Vinegar, Whole Black Peppercorns, Salt, Sunflower Oil, Sesame Seeds, Garlic, Coriander",22,10,45,55,4,Asian,Dinner,High Protein Vegetarian
Ragi Malpua With Rabri Recipe (Indian Pancakes With Creamy Pudding),"Rabri, Ragi Flour, Whole Wheat Flour, Fennel Seeds, Cardamom Powder, Baking Powder, Fresh Cream, Salt, Ghee, Sugar, Water, Saffron Strands",12,15,40,55,4,Indian,Dessert,Vegetarian
Naga Style Chicken With Bamboo Shoot Recipe,"Chicken, Tomato, Garlic, Ginger, Green Chilli, Bamboo Shoots, Cabbage, Spring Onion, Salt",9,10,30,40,4,North East India Recipes,Side Dish,High Protein Non Vegetarian
Beguni Recipe - Baingan/Eggplant Pakora,"Brinjal, Gram Flour, Water, Asafoetida, Turmeric Powder, Red Chilli Powder, Coriander Powder, Cumin Powder, Baking Soda, Salt, Sunflower Oil Deep Fry",11,30,60,90,4,Bengali Recipes,Snack,No Onion No Garlic (Sattvic)
Tawa Crispy Pomfret Fry Recipe,"Pomfret Fish, Turmeric Powder, Black Pepper Powder, Lemon Juice, Hung Curd, Curry Leaves, Coriander, Red Chilli Powder, Fennel Powder, Butter, Salt",11,100,20,120,2,Indian,Side Dish,High Protein Non Vegetarian
Homemade Italian Calzones Recipe,"Lukewarm Water, Active Dry Yeast, Sugar, Extra Virgin Olive Oil, Salt, All Purpose Flour, Green Bell Pepper, Onion, Button Mushrooms, Green Chilli, Del Monte Black Olives, Mozzarella Cheese, Tomato, Onion, Green Chilli, Garlic, Homemade Tomato Puree, Dried Oregano, Italian Seasoning, Salt",20,10,3,13,4,Italian Recipes,Snack,Vegetarian
The Oat and Green Moong Dal Pesarattu-Savory Lentil Crepe Recipe,"Instant Oats, Rice, Green Moong Dal, Asafoetida, Green Chilli, Ginger, Cabbage, Coriander, Salt, Sunflower Oil",10,20,40,60,4,South Indian Recipes,South Indian Breakfast,High Protein Vegetarian
Masoor Dal With Scrambled Eggs Recipe - Lentil Curry With Eggs,"Whole Eggs, Masoor Dal, Coconut Milk, Onion, Tomato, Green Chilli, Mint Leaves, Ginger Garlic Paste, Turmeric Powder, Garam Masala Powder, Cumin Powder, Asafoetida, Salt, Mustard Seeds, Curry Leaves, Sunflower Oil",16,10,35,45,2,North Indian Recipes,Dinner,Eggetarian
Chettinad Cauliflower Pepper Fry Recipe (Milagu Pirattal Poriyal),"Cauliflower, Pearl Onion, Garlic, Turmeric Powder, Black Pepper Powder, Cinnamon Powder, Coriander Powder, Salt, Mustard Seeds, Cumin Seeds, Curry Leaves, Sunflower Oil",12,15,40,55,4,Tamil Nadu,Lunch,Vegetarian
Pasi Paruppu Masiyal Recipe-Green Moong Dal Curry Recipe,"Green Moong Dal, Green Chilli, Tamarind Water, Turmeric Powder, Water, Salt, Coriander, Ghee, Mustard Seeds, Dry Red Chilli, Asafoetida, Curry Leaves",12,10,30,40,4,South Indian Recipes,Lunch,High Protein Vegetarian
Horsegram Idli Recipe - Kulith or Kollu Idli,"Horse Gram Dal, Idli Rice, White Urad Dal, Methi Seeds, Salt",5,360,20,380,5,Konkan,Indian Breakfast,Vegetarian
Tomato Rice With Basil Recipe,"Rice Brown Rice, Tomato, Green Chilli, Basil Leaves, Garlic, Extra Virgin Olive Oil, Whole Black Peppercorns, Salt, Water, Coriander",10,20,30,50,5,Indian,Lunch,Vegetarian
"Aglio E Olio Pasta Recipe with Roasted Cauliflower, Peppers & Cashew Nuts","Spaghetti Pasta, Garlic, Extra Virgin Olive Oil, Red Chilli Flakes, Mixed Herbs, Salt, Tabasco Original, Black Pepper Powder, Red Bell Pepper, Cauliflower, Cashew Nuts",11,15,20,35,4,Italian Recipes,Main Course,Vegetarian
Udupi Style Alsande Kayi Saaru Recipe (Long Beans Gravy Recipe),"Long String Bean, Tamarind Water, Salt, Rice, Dry Red Chilli, Coriander, Methi Seeds, Mustard Seeds, Garlic, Mustard Seeds, Curry Leaves, Mustard Seeds, Dry Red Chilli",13,10,30,40,4,Udupi,Lunch,Vegetarian
Greek Style Grilled Pita Pizza Recipe,"Mini Pita Breads, Tomato, Feta Cheese, Fresh Thyme Leaves, Black Olives, Whole Black Peppercorns, Extra Virgin Olive Oil, Coriander, Homemade Hummus",9,10,20,30,4,Greek,Appetizer,Vegetarian
Baked Egg With Quinoa & Tomato Sauce Recipe,"Whole Egg, Quinoa, Dry Mix Herbs, Red Chilli Flakes, Extra Virgin Olive Oil, Cheddar Cheese, Salt, Garlic, Onion, Tomato, Dried Oregano, Mixed Herbs, Red Chilli Flakes, Red Chilli Sauce, Salt, Extra Virgin Olive Oil",16,10,45,55,2,Continental,Main Course,Eggetarian
Awadhi Style Kathal Ke Kebab Recipe- Raw Jackfruit Kebabs,"Jackfruit Raw, Onion, Green Chilli, Mint Leaves, Coriander, Ginger, Garlic, Gram Flour, Garam Masala Powder, Cumin Powder, Coriander Powder, Fennel Powder, Amchur, Salt, Sunflower Oil",15,45,30,75,4,Awadhi,Appetizer,Vegetarian
Raw Papaya Kofta In Yogurt Curry Recipe,"Raw Papaya, Cabbage, Potato, Gram Flour, Cumin Powder, Red Chilli Powder, Turmeric Powder, Salt, Sunflower Seeds, Curd, Gram Flour, Red Chilli Powder, Coriander Powder, Turmeric Powder, Garam Masala Powder, Sugar, Salt, Mustard Seeds, Bay Leaf, Curry Leaves, Ginger, Garlic, Sunflower Oil",23,10,35,45,4,North Indian Recipes,Lunch,Vegetarian
Kitkat Cake With Sponge Recipe (Eggless),"Whole Wheat Flour, Milk, Sunflower Oil, Caster Sugar, Vanilla Extract, Cocoa Powder, Baking Soda, Baking Powder, Fresh Cream, Dark Chocolate, Kitkat Bars, M&MâS Chocolate Candies",12,25,25,50,2,Indian,Dessert,Vegetarian
Strawberry Panna Cotta Tart With Chocolate Ganache Recipe,"All Purpose Flour, Sugar, Salt, Butter, Chilled Water, Strawberries, Fresh Cream, Gelatin  Unflavoured, Confectioners Sugar, Salt, Dark Chocolate, Fresh Cream, Strawberries, Badam, Pistachios",15,25,40,65,6,Continental,Dessert,Non Vegeterian
Moroccan Chickpeas And Vegetable Stew Recipe With Couscous,"Kabuli Chana, Brinjal, Kaddu, Tomato, Onion, Sultanas, Spinach, Garlic, Coriander Powder, Cumin Powder, Dry Ginger Powder, Turmeric Powder, Red Chilli Powder, White Pepper Powder, Couscous, Extra Virgin Olive Oil, Parsley Leaves, Salt",18,10,30,40,2,African,Dinner,High Protein Vegetarian
Baked Brie In Puff Pastry With Fruits Recipe,"Brie Cheese, Puff Pastry Sheet, Apple, Strawberries, Honey, Cinnamon Powder, Whole Egg, Fresh Fruits, Crackers",9,10,25,35,2,Continental,Dessert,Vegetarian
Homemade Coconut Milk Recipe,Fresh Coconut,1,10,0,10,500,Indian,Vegetarian,Vegetarian
Maharashtrian Golyachi Amti Recipe (Besan Balls In Tamarind Based Spicy Gravy),"Gram Flour, Sunflower Oil, Ajwain, Ginger Garlic Paste, Green Chilli, Turmeric Powder, Salt, Sunflower Oil, Mustard Seeds, Cumin Seeds, Curry Leaves, Asafoetida, Onion, Ginger Garlic Paste, Gram Flour, Coriander Powder, Dry Coconut, Sesame Seeds, Tamarind Paste, Jaggery, Coriander, Red Chilli Powder, Salt",23,10,20,30,4,Maharashtrian Recipes,Side Dish,Vegetarian
Ice Cream Tea Float Recipe,"Tea Monk Oo Tea, Honey, Scoop Vanilla Ice Cream, Aerated Water",4,20,5,25,2,European,Appetizer,Vegetarian
Burani Raita Recipe - Garlic Based Yogurt,"Curd, Garlic, Cumin Powder, Red Chilli Powder, Black Salt",5,5,0,5,4,Hyderabadi,Side Dish,Vegetarian
Matar Besan And Paneer Cheela Recipe -Green Peas & Paneer Crepes,"Green Peas, Gram Flour, Paneer, Ginger, Green Chilli, Turmeric Powder, Cumin Powder, Salt, Sunflower Oil, Salt, Sunflower Oil",11,10,30,40,4,North Indian Recipes,North Indian Breakfast,Vegetarian
Moong Dal Potli Recipe - With Baked Option,"All Purpose Flour, Ghee, Salt, Water, Yellow Moong Dal, Asafoetida, Garam Masala Powder, Red Chilli Powder, Amchur, Coriander Powder, Fennel Seeds, Sunflower Oil, Salt, Raisins, Slivered Almonds",15,20,20,40,6,Indian,Snack,Vegetarian
Mushroom & Bean Sloppy Joe Recipe,"Burger Buns, Button Mushrooms, Onion, Garlic, Red Bell Pepper, Rajma, Homemade Tomato Puree, Brown Sugar, Sriracha Sauce, Eggless Mayonnaise, Salt, Cucumber, Onion",13,150,30,180,4,Continental,Dinner,High Protein Vegetarian
Greek Style Broken Wheat Salad with Chickpeas Fresh Mint & Feta Recipe,"Broken Wheat, Kabuli Chana, Garlic, Onion, Carrot, Red Bell Pepper, Broccoli, Cinnamon Powder, Lemon Juice, Caster Sugar, Feta Cheese, Mint Leaves, Extra Virgin Olive Oil, Salt And Pepper",14,20,45,65,4,Greek,World Breakfast,Diabetic Friendly
Kundapur Taal Masala Powder Recipe - Mangalorean Garlic Chilli Powder,"Dry Red Chilli, Coriander, Whole Black Peppercorns, Methi Seeds, Cumin Seeds, Turmeric Powder, Garlic",7,15,10,25,4,Mangalorean,Side Dish,Vegetarian
Meghalaya Style Do O Kalai Recipe - Chicken With Black Lentils,"Chicken, Black Urad Dal, Onion, Ginger, Garlic, Green Chilli, Red Chilli Powder, Lemon Juice, Cooking Soda Baking Soda, Sunflower Oil, Salt",11,15,20,35,3,North East India Recipes,Side Dish,High Protein Non Vegetarian
Goan Poee Recipe -  Delicious Whole Wheat Buns Recipe,"All Purpose Flour, Whole Wheat Flour, Wheat Bran, Active Dry Yeast, Sugar, Salt, Water",7,90,10,100,12,Goan Recipes,Lunch,Vegetarian
Arbi Tomato Onion Sabzi Recipe (Spicy Colocasia Stir fry),"Colocasia Root, Onion, Tomato, Ginger Garlic Paste, Asafoetida, Turmeric Powder, Salt, Red Chilli Powder, Coriander Powder, Garam Masala Powder, Green Chilli, Dry Red Chilli, Sunflower Oil",13,10,45,55,4,North Indian Recipes,Lunch,Vegetarian
Creamy Mocha Lassi Recipe,"Hung Curd, Milk Water, Instant Coffee Powder, Honey, Cocoa Powder, Ice Cubes",6,15,0,15,2,Indian,Snack,Vegetarian
Crispy Amla Gawar Phali Sabzi ,"Gwar Pods, Green Chilli, Amla, Mustard, Cumin Seeds, Asafoetida, Turmeric Powder, Coriander Powder, Spoon Whole Black Pepper, Salt, As Per",11,15,30,45,4,Rajasthani,Dinner,Vegetarian
Satori Recipe (Maharashtrian Mawa Flat Bread),"Khoya, Poppy Seeds, Dry Dates Powder, Caster Sugar, Ghee, Milk, All Purpose Flour, Sooji, Gram Flour, Ghee",10,30,40,70,4,Maharashtrian Recipes,Dessert,Vegetarian
Balinese Black Rice Pudding Recipe,"Black Rice, Coconut Milk, Water, Palm Sugar, Salt, Ripe Bananas, Palm Sugar",7,0,90,90,4,Asian,Dessert,Vegetarian
Asian Style Paper Wrapped Chicken Recipe,"Boneless Chicken, Onion, Parsley Leaves, Dry Red Chilli, Soy Sauce, Salt, White Pepper Powder, Red Chilli Sauce, Chinese  Spice Powder, Spring Onion, Ginger, Garlic, Sunflower Oil Cook",13,120,15,135,4,Chinese,Appetizer,High Protein Non Vegetarian
Gujarati Biraj Recipe - Saffron Flavored Sweet Lentil Rice With Dry Fruits & Coconut,"Basmati Rice, Chana Dal, Fresh Coconut, Sugar, Cardamom Powder, Saffron Strands, Badam, Pistachios, Cashew Nuts, Raisins, Ghee",11,60,30,90,4,Gujarati Recipesï»¿,Dinner,Vegetarian
Asian Red Cabbage Salad With Roasted Peanuts Recipe,"Sesame, Honey, Cumin Powder, Black Pepper Powder, Vinegar, Carrot, Red Cabbage, Onion, Raw Peanuts",9,10,25,35,4,Asian,Appetizer,Vegetarian
Jowar and Vegetable Porridge Recipe,"Jowar Seeds, Green Beans, Carrots, Green Chilli, Curry Leaves, Coriander, Mustard Seeds, Sunflower Oil, Salt",9,5,15,20,4,South Indian Recipes,South Indian Breakfast,Vegetarian
Matta Rice/ Chemba Rice Recipe-Pressure Cooker Method,"Red Matta Rice, Water, Salt",3,30,40,70,4,Kerala Recipes,Lunch,Diabetic Friendly
Mint Flavoured Mixed Vegetable Pulao Recipe,"Basmati Rice, Green Peas, Carrot, Green Beans, Onion, Salt, Coriander, Mint Leaves, Sunflower Oil Cook, Garlic, Green Chilli, Cumin Seeds, Mustard Seeds, Bay Leaf, Cloves",15,10,20,30,4,Indian,Main Course,Vegetarian
Verusenaga Sambar Recipe (Fresh Groundnuts Sambar),"Roasted Peanuts, Onion, Cumin Seeds, Sambar Powder, Tamarind Paste, Coriander, Tomato, Curry Leaves, Sunflower Oil, Dry Red Chilli, Mustard Seeds",11,10,30,40,4,South Indian Recipes,Lunch,High Protein Vegetarian
Iyengar Style Masala Toast,"Bread Loaf, Ghee, Carrots, Cabbage, Onion, Tomato, Ginger, Garlic, Rye, Asafoetida, Garam Masala Powder, Salt, Green Chili",13,10,30,40,4,Karnataka,Snack,Vegetarian
Savoury Pancakes Recipe With Spinach & Paneer Filling,"Cup Baby Spinach, Cup Paneer, Cumin Seeds, Red Chilli Powder, Turmeric Powder, Garam Masala Powder, Garlic, Green Chilli, Mustard Oil Drizzle, Salt, Cup Gram Flour, Green Chilli, Onion, Red Chilli Powder, Turmeric Powder, Garam Masala Powder, Mustard Oil, Salt, Water",19,15,20,35,2,Continental,World Breakfast,Vegetarian
Paneer Pasanda Recipe -Cottage Cheese in Spicy Yogurt Curry,"Paneer, Curd, Gram Flour, Red Chilli Powder, Kasuri Methi, Garam Masala Powder, Salt, Cashew Nuts, Onion, Green Chilli, Ginger, Garlic, Cardamom, Sunflower Oil",14,20,30,50,4,Awadhi,Lunch,High Protein Vegetarian
Quinoa Sweet Paniyaram Recipe,"Rice, Quinoa, Salt, Baking Soda, Jaggery, Cardamom Powder, Ghee",7,10,40,50,4,South Indian Recipes,Snack,Vegetarian
Oatmeal Pancake Recipe With Orange,"Whole Wheat Flour, All Purpose Flour, Instant Oats, Curd, Whole Eggs, Baking Powder, Orange Zest, Fresh Orange Juice, Salt, Sunflower Oil Drizzle",10,10,20,30,4,Continental,World Breakfast,Vegetarian
Chole Pindi Recipe,"Black, Cardamom, Onion, Cinnamon, Ginger, Green Chilli, Tomato Puree, Small Spoon Turmeric Powder, Pomegranate, Coriander Powder, Garam Masala Powder, Amchur Lemon Juice, Red Chilli Powder, Oil Ghee, Salt, Ginger, Lemon",17,500,120,620,4,North Indian Recipes,Lunch,Vegetarian
Andhra Style Coconut Flavored Rice Upma Recipe,"Idli Rice, Fresh Coconut, Dry Red Chilli, Salt, Tamarind Paste, Jaggery, Water, Coconut Oil, White Urad Dal, Chana Dal, Curry Leaves, Dry Red Chilli, Roasted Peanuts",13,10,40,50,4,Andhra,South Indian Breakfast,Vegetarian
Vegetable Spring Rolls Recipe,"Spring Roll Wrappers, Cabbage, Carrots, Green Bell Pepper, Onion, Ginger, Salt And Pepper, All Purpose Flour, Sunflower Oil",9,10,30,40,4,Chinese,Snack,Vegetarian
Avocado Ada Pradhaman Recipe (With Vegan Option),"Rice Ada, Avocados, Brown Sugar, Cashew Nuts, Badam, Milk, Saffron Strands, Water, Cardamom, Kesar Milk Masala, Kesar Milk Masala",11,10,40,50,4,South Indian Recipes,Dessert,Vegetarian
Murgh Masala Recipe - Chicken Tangdi Masala,"Chicken Legs, Lemon Juice Tenderize The Chicken, Salt Tenderize The Chicken, Ginger Garlic Paste, Kashmiri Red Chilli Powder, Curd, Onion, Ginger, Cardamom, Cinnamon Stick, Bay Leaf, Homemade Tomato Puree, Honey, Turmeric Powder, Red Chilli Powder, Cumin Powder, Garam Masala Powder, Salt, Mustard Oil, Coriander",20,30,40,70,2,North Indian Recipes,Lunch,Non Vegeterian
Baked Chinese Potato Recipe (Koorka Mezhukuperatti),"Chinese Potato, Turmeric Powder, Shallots, Garlic, Red Chilli Flakes, Salt, Curry Leaves, Coconut Oil, Fresh Coconut",9,10,20,30,4,Kerala Recipes,Lunch,Vegetarian
Perfect Christmas Roast Potatoes Recipe,"Potato, Corn Flour, Red Chilli Powder, Garlic Powder, Onion Powder, Salt, Butter, Sunflower Oil",8,10,45,55,4,European,Dinner,Vegetarian
Iyengar Bakery Style Masala Bread Recipe,"Whole Wheat Brown Bread, Sunflower Oil, Mustard Seeds, Cumin Seeds, Green Chilli, Onion, Tomato, Cabbage, Carrots, Green Bell Pepper, Red Chilli Powder, Chaat Masala Powder, Tomato Ketchup, Salt, Coriander",15,0,25,25,5,Karnataka,Snack,Vegetarian
Simple & Easy Chicken Cutlet Recipe - High Protein Dish,"Chicken Breasts, Potato, Onion, Green Chilli, Fennel Seeds, Garam Masala Powder, Turmeric Powder, Red Chilli Powder, Coriander, Salt, Sunflower Oil, Whole Eggs, Whole Wheat Bread Crumbs",13,10,30,40,4,Continental,Appetizer,Vegetarian
Italian Baked Pasta Recipe With Cheese & Bread Crumbs,"Del Monte Farfalle Pasta, Button Mushrooms, Onion, Garlic, Tomato, Cherry Tomato, Basil Leaves, Parsley Leaves, Green Olives, Black Olives, Mozzarella Cheese, Parmesan Cheese, Whole Wheat Bread Crumbs, Whole Black Peppercorns, Extra Virgin Olive Oil, Butter, Salt",17,10,50,60,2,Italian Recipes,Dinner,Vegetarian
Traditional Mathri Recipe - North Indian Savoury Cracker Recipe,"Vivatta Maida, Ghee, Salt, Ajwain, Whole Black Peppercorns, Water Knead, Sunflower Oil",7,30,60,90,4,North Indian Recipes,Snack,Vegetarian
Matar Samosa Chaat Recipe - Delicious Evening Tea Time Snack,"Dried Green Peas, Kalonji, Ginger, Onion, Tomato, Green Chilli, Turmeric Powder, Chaat Masala Powder, Garam Masala Powder, Amchur, Salt, Punjabi Aloo Samosa, Sweet Chutney, Green Chutney, Sev, Onion, Fresh Pomegranate Fruit Kernels",17,45,45,90,4,North Indian Recipes,Snack,Vegetarian
Masala Omelette Waffles Recipe,"Whole Eggs, Milk, Onion, Green Bell Pepper, Tomato, Broccoli, Red Chilli Powder, Cumin Powder, Coriander Powder, Turmeric Powder, Salt, Butter",12,10,25,35,4,Fusion,Brunch,High Protein Vegetarian
Ridge Gourd Pachadi ,"Trumpet, Green Chilli, Tamarind Paste, Garlic, Cumin Seeds, Salt, Oil",7,15,15,30,5,South Indian Recipes,Side Dish,Vegetarian
Tangy Red Purifier - Tomato Beetroot Juice Recipe,"Beetroot, Tomato, Cucumber, Ginger, Lemon Juice, Coriander, Black Salt",7,10,10,20,2,Indian,Snack,Vegetarian
Choco Swirl Cookies Recipe (Eggless Choco Pinwheel Cookies),"All Purpose Flour, Sugar, Butter, Milk, Vanilla Extract, Baking Powder, Salt, All Purpose Flour, Cocoa Powder, Sugar, Butter, Vanilla Extract, Baking Powder, Milk, Salt",15,10,110,120,10,Continental,Snack,Vegetarian
Subz Noor E Chashm Recipe (Nawabi Curry Recipe ),"Cauliflower, Green Peas, Carrot, Bay Leaves, Cloves, Cumin Seeds, Garlic, Ginger, Turmeric Powder, Red Chilli Powder, Garam Masala Powder, Cumin Seeds, Onion, Tomato, Cashew Nuts, Badam, Curd, Salt, Sunflower Oil, Coriander",20,20,30,50,4,Awadhi,Lunch,Vegetarian
Roasted Chickpeas With Apples Salad Recipe,"Kala Chana, Apple   Into Matchstickthin Slices, Salad Leaves, Beetroot  Pickledroasted, Lemon Juice, Salt, Extra Virgin Olive Oil, Red Chilli Powder, Avocado, Walnuts",10,5,60,65,4,Continental,Appetizer,Vegetarian
Roasted Vegetables Pizza Pouch Recipe,"Homemade Pizza Dough, Onion, Red Bell Pepper, Button Mushrooms, Cabbage, Carrots, Green Peas, Clove Garlic, Sweet Corn, Raisins, Extra Virgin Olive Oil, Soy Sauce, Red Chilli Sauce, Salt",14,20,30,50,4,Italian Recipes,Appetizer,Vegetarian
Kaddu Simla Mirch Sabzi ,"Pumpkin, Tomato, Capsicum, Green Chili, Mustard, Cumin, Fenugreek Seeds, Turmeric Powder, Sambar Powder, Jaggery, Oil, Salt",12,15,30,45,6,North Indian Recipes,Lunch,Vegetarian
Creamy Veg Spring Roll Recipe,"Spring Roll Wrappers, All Purpose Flour, Hakka Noodles, Carrot, Yellow Bell Pepper, Cabbage, Eggless Mayonnaise, Salt And Pepper, Sunflower Oil",9,30,45,75,6,Continental,Snack,Vegetarian
Goan Egg Drop Curry ,"Eggs, Onion, Garlic, Coconut, Onion, Coriander Seeds, Tamarind, Dry Red Chili, Turmeric Powder, Water, Salt, Oil",12,15,30,45,2,Goan Recipes,Dinner,Eggetarian
Mooli Gobhi Aur Methi Sabzi Recipe,"Cauliflower, Mooli Mullangi, Methi Leaves, Garlic, Green Chilli, Turmeric Powder, Red Chilli Powder, Mustard Oil, Salt",9,10,15,25,4,Indian,Side Dish,Diabetic Friendly
Khatte Baingan Recipe,"Small Brinjal, Sunflower Oil, Cumin Seeds, Whole Black Peppercorns, Mustard Seeds, Sesame Seeds, Ginger Garlic Paste, Tomato, Tamarind, Red Chilli Powder, Coriander Powder, Turmeric Powder, Cumin Powder, Salt, Coriander, Sunflower Oil",16,5,20,25,4,Indian,Lunch,Vegetarian
Chettinad Masala Powder Recipe,"Coriander, Cumin Seeds, Dry Red Chilli, Ajwain, Star Anise, Cardamom, Cinnamon Stick, Cloves, Fennel Seeds, Whole Black Peppercorns, Methi Seeds, Poppy Seeds, Mace",13,5,10,15,1,Chettinad,Vegetarian,Vegetarian
Chicken Barbecue Pizza Recipe,"Whole Wheat Flour, Extra Virgin Olive Oil, Active Dry Yeast, Sugar, Salt, Lukewarm Water, Homemade Tomato Puree, Onion, Garlic, Dried Thyme Leaves, Red Chilli Flakes, Tabasco Original, Sugar, Salt, Chicken Breasts, Barbeque Sauce",16,30,60,90,4,Italian Recipes,Lunch,Non Vegeterian
Tomato Onion Gravy Sabzi Recipe,"Tomato, Onion, Cumin Seeds, Mustard Seeds, Curry Leaves, Asafoetida, Green Chilli, Garlic, Water, Red Chilli Powder, Turmeric Powder, Coriander Powder, Sunflower Oil, Salt, Coriander",15,15,15,30,3,Indian,Lunch,Vegetarian
Manathakkali Thayir Pachadi Recipe,"Manathakkali KaiÂ Vathal, Salt, Mor Milagai, Coriander, Sunflower Oil, Mustard Seeds, Asafoetida, Water, Curd",9,5,10,15,4,Tamil Nadu,Side Dish,Vegetarian
Dahi Achari Bhindi Recipe,"Bhindi, Onion, Tomato, Ginger, Red Chilli Powder, Turmeric Powder, Coriander Powder, Curd, Gram Flour, Fennel Seeds, Cumin Seeds, Kalonji, Mustard Seeds, Ajwain",14,10,45,55,4,North Indian Recipes,Side Dish,Vegetarian
Fusion Wrap Recipe (Mixed Vegetables Wrapped In Tortilla),"Extra Virgin Olive Oil, Onion, Garlic, Green Bell Pepper, Yellow Bell Pepper, Sweet Corn, Carrot, Tomato, Potato, Whole Black Peppercorns, Pizza Seasoning, Red Chilli Flakes, Tomato Ketchup, Salt, Tortillas, Classic Mayonnaise, Iceberg Lettuce, Cheddar Cheese",18,15,20,35,4,Continental,Lunch,Vegetarian
Heerekai Sippe Chutney Recipe (Ridge Gourd Peel Chutney),"Ridge Gourd Skin, Tamarind, Fresh Coconut, Green Chilli, Cumin Seeds, Butter, Jaggery, Sunflower Oil, Mustard Seeds, Cumin Seeds, Dry Red Chilli, Curry Leaves",12,10,20,30,4,Karnataka,Side Dish,Diabetic Friendly
Chettinad Dry Pepper Chicken Recipe,"Of Chicken, Onion, Tomato, Curry Leaves, Ginger Garlic Paste, Turmeric Powder, Cumin Powder, Coriander Powder, Fennel Powder, , Salt, Water, Oil, Coriander",14,10,30,40,4,Chettinad,Appetizer,High Protein Non Vegetarian
Shredded Chicken Cheese Sandwich Recipe,"Chicken Breasts, Basil Leaves, Tablespoon Homemade Pizza And Pasta Sauce, Italian Seasoning, Garlic, Black Pepper Powder, Cup Mozzarella Cheese, Cup Cheese, Butter, Extra Virgin Olive Oil",10,20,10,30,2,Continental,World Breakfast,High Protein Non Vegetarian
Dimer Malai Curry Recipe (Bengali Style Egg Curry In Coconut Milk),"Whole Eggs, Onion, Garlic, Ginger, Tomato, Coconut Milk, Green Chilli, Turmeric Powder, Coriander Powder, Red Chilli Powder, Cumin Powder, Bay Leaf, Cinnamon Stick, Whole Black Peppercorns, Black Cardamom, Cardamom, Salt, Sunflower Oil, Kasuri Methi, Coriander",20,15,50,65,4,Bengali Recipes,Lunch,Eggetarian
Baked Cheesy Broccoli Pasta Recipe,"Penne Pasta, Broccoli, Garlic, Black Pepper Powder, Italian Seasoning, Red Chilli Flakes, Mozzarella Cheese, Extra Virgin Olive Oil, Salt, Whole Wheat Flour, Milk, Fresh Cream, Salt And Pepper, Nutmeg",14,10,30,40,4,Italian Recipes,Dinner,High Protein Vegetarian
Whole Wheat Ravioli with Paneer & Creamy Mushroom Oat Sauce Recipe,"Button Mushrooms, Garlic, Milk, Instant Oats, Red Chilli Flakes, Basil Leaves Dried Basil, Salt, Whole Wheat Flour, Salt, Sunflower Oil, Paneer, Dried Oregano, Salt",13,10,60,70,4,Italian Recipes,Lunch,Vegetarian
Surati Jowar Vada,"Jowar Flour, Flour, Ginger, Garlic, Red Chili Powder, Turmeric Powder, Yogurt, Salt, Sesame Seeds, Oil",10,60,35,95,4,North Indian Recipes,Snack,Gluten Free
Gujarati Style Bhakri Recipe-A Multigrain Flat Bread,"Whole Wheat Flour, Jowar Flour, Ghee, Ajwain, Whole Black Peppercorns, Turmeric Powder, Dry Ginger Powder, Salt",8,20,30,50,4,Maharashtrian Recipes,North Indian Breakfast,Diabetic Friendly
Methi Murgh Recipe - Chicken with Fenugreek Leaves,"Chicken, Methi Leaves, Onion, Tomato, Garlic, Ginger, Fennel Seeds, Cinnamon Stick, Whole Black Peppercorns, Red Chilli Powder, Turmeric Powder, Garam Masala Powder, Cumin Powder, Salt, Sunflower Oil",15,10,45,55,4,North Indian Recipes,Lunch,High Protein Non Vegetarian
Amrood Ki Chutney ,"Guava, Green Chilli, Peanuts, Parsley, Garlic, Lemon Juice, Good, Oil, Salt, Black Urad Dal, Curry Leaves",11,20,25,45,4,Indian,Side Dish,Vegetarian
Homemade Mango Ice-Cream Recipe,"Fresh Cream, Mango Pulp, Sugar, Mango",4,20,900,920,6,Continental,Dessert,Vegetarian
Badam Burfi Recipe - Almond Burfi,"Badam, Milk, Sugar, Ghee",4,10,60,70,2,Indian,Dessert,Vegetarian
Madurai Spicy Tomato Chutney Recipe- Thakkali Vengayam Chutney,"Onion, Dry Red Chilli, Tomato, Curry Leaves, Mustard Seeds, White Urad Dal, Salt, Water, Gingelly Oil, Tamarind Paste, Sugar",11,10,10,20,4,Tamil Nadu,Side Dish,Vegetarian
Narikol Pitha Recipe - Sweetened Coconut Fritter,"Fresh Coconut, All Purpose Flour, Sugar, Baking Powder, Milk, Sunflower Oil Deep Fry",6,10,25,35,4,Assamese,Dessert,Vegetarian
Kelyachi Bhaji Recipe (Raw Banana Stir Fry),"Raw Banana, Onion, Fresh Coconut, Turmeric Powder, Red Chilli Powder, Asafoetida, Salt, Sunflower Oil",8,10,20,30,4,Goan Recipes,Lunch,Vegetarian
Pan Roasted Herbed Baby Potato Recipe With Vegetables,"Button Mushrooms, Carrot, Cauliflower, Baby Potato, Garlic, Dried Oregano, Dried Thyme Leaves, Red Chilli Flakes, Basil Leaves, Salt, Extra Virgin Olive Oil",11,5,45,50,4,Continental,Side Dish,Vegetarian
Baked Vegetable Salad Recipe,"Red Bell Pepper, Carrot, Onion, Potato, Green Zucchini, Baby Corn, Garlic, Extra Virgin Olive Oil, Salt, Black Pepper Powder, Cherry Tomato, Parsley Leaves, Mustard Sauce, Honey, Vinegar, Water, Dried Oregano, Water, Dried Oregano",19,10,20,30,2,Indian,Side Dish,Vegetarian
Mustard Egg Curry Recipe,"Whole Eggs, Mustard Seeds    Extra, Panch Phoran Masala, Green Chilli, Fresh Coconut, Turmeric Powder, Coconut Milk, Sunflower Oil, Salt, Sugar, Onion",11,10,30,40,3,Indian,Dinner,Eggetarian
Andhra Style Chama Dumpa Pulusu Recipe - Arbi With Sesame Tamarind Sauce Recipe,"Colocasia Root, Tamarind Paste, Green Chilli, Sesame Seeds, Salt, Sunflower Oil, Mustard Seeds, Cumin Seeds, Turmeric Powder, Curry Leaves, Coriander",11,20,20,40,4,Andhra,Dinner,Vegetarian
Beans On Toast Recipe,"Dry Beans, Extra Virgin Olive Oil, Garlic, Onion, Homemade Tomato Puree, Brown Sugar, Cumin Powder, Cayenne Pepper Red Chilli Powder, Salt, Water, Coriander, Slices Whole Wheat Brown Bread",12,10,120,130,2,Continental,World Breakfast,Vegetarian
Ragi (Finger Millet) Chocolate Brownie Recipe,"Cocoa Powder, Brown Sugar, Ragi Flour, Whole Wheat Flour Maida, Butter, Whole Eggs, Vanilla Extract, Salt, Baking Powder, Milk, Slivered Almonds",11,15,40,55,6,Continental,Dessert,Vegetarian
Asian Style Tofu in Spicy Orange Sauce Recipe,"Tofu, Orange Zest, Corn Flour, Whole Black Peppercorns, All Spice Powder, Rice Vinegar, Brown Sugar, Fresh Orange Juice, Sriracha Sauce, Ginger, Sesame, Sesame Seeds, Salt",13,10,30,40,4,Asian,Dinner,High Protein Vegetarian
Spinach And Coriander Dosa Recipe,"Rice, White Urad Dal, Methi Seeds, Salt, Spinach Leaves, Coriander, Sunflower Oil",7,10,45,55,5,South Indian Recipes,South Indian Breakfast,High Protein Vegetarian
Kasuri Methi Paneer Sabzi Recipe,"Paneer, Onion, Tomato, Ginger, Garlic, Turmeric Powder, Cumin Seeds, Red Chilli Powder, Garam Masala Powder, Kasuri Methi, Salt, Sunflower Oil",12,10,25,35,4,North Indian Recipes,Dinner,High Protein Vegetarian
Karamani Poriyal Recipe - Yard Long Beans Stir Fry | Chawli | Barbati Sabzi,"Green Chawli Beans, Sunflower Oil, Mustard Seeds, White Urad Dal, Turmeric Powder, Asafoetida, Curry Leaves, Fresh Coconut, Dry Red Chilli, Salt",10,10,20,30,4,South Indian Recipes,Lunch,Vegetarian
Coorg Style Kadumbuttu/Kadambuttu Recipe (Steamed Rice Balls Recipe),"Broken Raw Rice, Water, Salt, Fresh Coconut, Butter, Ghee",6,0,60,60,4,Coorg,South Indian Breakfast,Vegetarian
Herbed Butter Rice Recipe With Rosemary & Thyme,"Cooked Rice, Butter, Garlic, Rosemary, Dried Thyme Leaves, Red Chilli Flakes, Salt, Coriander",8,5,10,15,4,Continental,Main Course,Vegetarian
Homemade Canape Papdi Chaat Recipe,"Gram Flour, Instant Oats, Whole Wheat Flour, Kashmiri Red Chilli Powder, Sunflower Oil, Cooking Soda, Salt, Water, Green Moong Sprouts, Chickpea Sprouts, Onion, Tomato, Coriander, Lemon Juice, Chaat Masala Powder, Green Chilli, Sev",17,30,40,70,4,North Indian Recipes,Snack,Vegetarian
Raw Papaya Mor Kootu Recipe - Ayurvedic No Onion No Garlic Recipe,"Raw Papaya, Fresh Coconut, S Curry Leaves, Green Chilli, Cumin Seeds, Rice, Whole Black Peppercorns, Curd, Coconut Oil, Mustard Seeds, Curry Leaves",11,20,20,40,4,South Indian Recipes,Lunch,Vegetarian
Detox Blueberry Salad Recipe,"Blueberries, Kale, Red Cabbage, Cucumber, Avocado, Iceberg Lettuce, Red Onion, Red Yellow And Green Bell Peppers, Beetroot, Curd, Extra Virgin Olive Oil, Lemon Juice, Sea Salt Salt, Black Pepper Powder, Badam, Flax Seeds",16,10,15,25,2,Continental,Dinner,Vegetarian
Mushroom Fried Rice Recipe,"Basmati Rice, Onion, Spring Onion, Ginger, Garlic, Green Chilli JalapeÃ±os, Dry Red Chilli, Button Mushrooms, Carrots, Green Bell Pepper, Spring Onion Greens, Soy Sauce, White Vinegar, Sesame, Salt, Black Pepper Powder",16,10,5,15,2,Asian,Dinner,Vegetarian
Quick And Easy Chilli Bean Dip Recipe With Chips,"Baked Beans, Britannia Cheese Spread, Garlic, Spring Onion, Cumin Powder, Red Chilli Powder, Coriander, Salt, Extra Virgin Olive Oil",9,5,20,25,4,Mexican,Snack,High Protein Vegetarian
Pasta In Pudina Chutney Sauce - A Indian Fusion Recipe,"Shell Pasta, Mint Leaves, Coriander, Green Chilli, Garlic, Extra Virgin Olive Oil, Lemon Juice, Salt, Black Pepper Powder, Parsley Leaves, Spring Onion",11,10,30,40,2,Fusion,Dinner,Vegetarian
Oriya Kancha Kadali Bara Recipe (Raw Banana Cutlets),"Raw Banana, Green Chilli, Ginger, Red Chilli Powder, Cumin Powder, Chaat Masala Powder, Coriander, Sunflower Oil, Gram Flour, Salt",10,15,25,40,10,Oriya Recipes,Appetizer,Vegetarian
Baked Chana Dal Vada Recipe,"Chana Dal, Fennel Seeds, Cumin Seeds, Green Chilli, Curry Leaves, Onion, Coriander, Ginger, Garlic, Salt, Sunflower Oil, Baking Soda",12,195,20,215,10,Indian,Snack,Vegetarian
Chicken Cheese Stuffed Kulcha Recipe,"Chicken, Sunflower Oil, Garlic, Red Chilli Powder, Cumin Powder, Black Pepper Powder, Turmeric Powder, Garam Masala Powder, Cheese, Coriander Powder, Whole Wheat Flour, Active Dry Yeast, All Purpose Flour, Curd, Sugar, Salt, Water Knead The Dough, Butter, Butter, Kalonji, Butter Cook The Kulchas, Coriander",22,30,20,50,4,North Indian Recipes,Side Dish,Non Vegeterian
Bharma Baingan Aur Pyaaz Ki Sabzi ,"Brinjals, Onion, Oil, Bud Garlic, Green Chilli, Ginger, Red Chilli Powder, Teaspoon Coriander Powder, Asafoetida, Turmeric Powder, Green Coriander, Salt",12,10,45,55,3,Rajasthani,Lunch,Vegetarian
Low Fat Aloo Bonda Recipe,"Flour, Rice Flour, Turmeric Powder, Red Chilli Powder, Baking Soda, Salt, Oil, Potato, Mash, Rye, Green Chilli, Curry Leaves, Ginger, Turmeric Powder, Red Chilli Powder, Asafoetida",16,20,30,50,4,South Indian Recipes,Snack,Vegetarian
Classic Pizza Margherita Recipe - Pizza Topped With Cheese And Tomato Sauce,"All Purpose Flour, Sooji, Active Dry Yeast  Dried, Salt, Honey Sugar, Lukewarm Water, Extra Virgin Olive Oil, Sooji, Homemade Pizza And Pasta Sauce, Mozzarella Cheese, Basil Leaves, Dried Oregano, Red Chilli Flakes",13,10,60,70,4,Italian Recipes,Dinner,Vegetarian
Jackfruit Idli Recipe - Pansu Idli,"Rice, Fresh Coconut, Jaggery, Cardamom Powder, Salt, Ghee Grease Idli Moulds, Jackfruit Ripe",7,30,45,75,4,South Indian Recipes,South Indian Breakfast,High Protein Vegetarian
Karnataka Style Avarekalu Pulao Recipe - Avarekalu Pulao,"Basmati Rice  Soaked For  Minutes, Avarekalu  Lilva Beans, Onion, Tomato, Coriander Powder, Red Chilli Powder, Garam Masala Powder, Bay Leaf, Cinnamon Stick, Green Chilli, Ghee, Salt, Mint Leaves, Cinnamon Stick, Cloves, Cardamom, Garlic, Ginger, Green Chilli, Mint Leaves, Coriander",21,10,20,30,4,Karnataka,Dinner,Vegetarian
Mirchi Lahsun Ka Chunda Recipe (Chilli Garlic Chunda),"Green Chilli, Garlic, Sunflower Oil, Cumin Seeds, Asafoetida, Salt, Lemon Juice",7,15,7,22,4,Rajasthani,Side Dish,Vegetarian
Chicken In A Foil Recipe,"Chicken Legs, Tandoori Masala, Lemon, Curd, Red Chilli Sauce, Tomato Ketchup, Homemade Tomato Puree, Dessicated Coconut, Honey, Cashew Nuts, Poppy Seeds  Groundpaste, Salt, Ginger Garlic Paste, Red Chilli Powder, Cumin Powder, Cumin Powder",16,15,45,60,6,Indian,Appetizer,Non Vegeterian
Surul Appam Recipe,"All Purpose Flour, Sugar, Fresh Coconut, Cardamom Powder, Salt, Ghee",6,5,15,20,4,South Indian Recipes,Dessert,Vegetarian
Strawberry Yogurt Breakfast Parfait Recipe,"Strawberries, Honey, Hung Curd, Granola",4,15,20,35,4,French,World Breakfast,Vegetarian
Punjabi Choori Recipe (Sweet Crumbled Rotis),"Tawa Paratha, Ghee, Mixed Nuts, Sugar Grated Jaggery",4,20,10,30,4,Punjabi,Snack,Vegetarian
Cabbage Tomato Pachadi Recipe,"Tomato, Cabbage, Chana Dal, Cumin Seeds, Mustard Seeds, Asafoetida, Sunflower Oil, Dry Red Chilli, Tamarind, Turmeric Powder, Salt, Curry Leaves",12,5,10,15,3,South Indian Recipes,Side Dish,Vegetarian
Anhui Style Egg Dumpling Recipe,"Whole Eggs, Ginger, Black Pepper Powder, Salt, Ginger, Garlic, Onion, Rice, Soy Sauce, Red Chilli Sauce, Sugar, Spring Onion, Salt And Pepper, Sunflower Oil",14,5,30,35,4,Chinese,Appetizer,Eggetarian
Instant Sooji Oats Dhokla Recipe - Steamed Semolina & Oats Dhokla,"Sooji, Instant Oats, Curd, Enos Fruit Salt, Salt, Red Chilli Powder, Sunflower Oil, Mustard Seeds, Sesame Seeds, Ssp Asafoetida, Green Chilli, Curry Leaves, Fresh Coconut, Coriander",14,20,30,50,6,Gujarati Recipesï»¿,Snack,Vegetarian
"South Indian Kosambari Recipe With Raw Mango, Cucumber, Carrot & Beetroot","Chana Dal, Carrot, Beetroot, Cucumber, Mango, Green Chilli, Paneer, Fresh Coconut, Salt, Sunflower Oil, Mustard Seeds, White Urad Dal, Asafoetida, Curry Leaves",14,15,15,30,4,South Indian Recipes,Side Dish,Vegetarian
Chettinad Podalangai Vadai Recipe (Chettinad Style Snake Gourd Fritters),"Chana Dal, Yellow Moong Dal, Dry Red Chilli, Ginger, Fennel Seeds, Cinnamon Stick, Cloves, Snake Gourd, Green Chilli, Curry Leaves, Coriander",11,150,20,170,15,Chettinad,Snack,Vegetarian
Amritsari Dal ,"Black Urad Dal, Chana Dal, Onion, Tomato, Green Chilli, Ginger, , Red Chili Powder, Garam Masala Powder, Turmeric Powder, Lentil Sugar, Salt, Oil",13,10,30,40,4,Punjabi,Lunch,High Protein Vegetarian
Kerala Style Puttu Upma Recipe With Scrambled Eggs,"Rice Puttu Wheat Puttu, Whole Egg, Cumin Seeds, Mustard Seeds, Curry Leaves, Turmeric Powder, Green Chilli, Black Urad Dal, Sunflower Oil, Salt",10,5,15,20,2,Kerala Recipes,Snack,Eggetarian
The Croque Madame Sandwich Recipe,"Whole Wheat Brown Bread, Whole Eggs, Cheese, Butter, Whole Wheat Flour, Milk, Dijon Mustard, Nutmeg, Salt And Pepper, Butter",10,10,30,40,3,French,World Breakfast,Eggetarian
Hesarukalu Bele Kosambari Recipe-Sprouted Green Moong With Tadka,"Green Moong Dal, Carrot, Fresh Coconut, Cucumber, Green Chilli, Onion, Lemon Juice, Coriander, Salt",9,10,5,15,4,South Indian Recipes,Side Dish,Diabetic Friendly
Fish Tikka Masala Skewer Recipe,"Fish Fillet, Lemon Juice, Curd, Salt, Kashmiri Red Chilli Powder, Coriander, Mint Leaves, Tablespoon Mustard Oil, Gram Flour, Garam Masala Powder, Chaat Masala Powder",11,20,10,30,2,Punjabi,Appetizer,High Protein Non Vegetarian
Methi Jowar Ragi Thalipeeth Recipe - Healthy Diabetic Friendly Recipe,"Methi Leaves, Onion, Green Chilli, Jowar Flour, Ragi Flour, Gram Flour, Red Chilli Powder, Turmeric Powder, Coriander Powder, Cumin Powder, Sunflower Oil Smear, Salt",12,15,30,45,4,Maharashtrian Recipes,Indian Breakfast,Diabetic Friendly
Vellai/Jaggery Dosa Recipe,"Whole Wheat Flour, Jaggery, Water, Cardamom Powder, Ghee",5,15,35,50,8,South Indian Recipes,South Indian Breakfast,Vegetarian
Paneer Kolhapuri Recipe (Cottage Cheese In Maharashtrian Gravy With Kolhapuri Masala),"Paneer, Ginger Garlic Paste, Onion, Tomato, Cashew Nuts, Red Chilli Powder, Turmeric Powder, Salt, Coriander, Kolhapuri Masala",10,15,25,40,8,Maharashtrian Recipes,Side Dish,High Protein Vegetarian
Instant Masala Beans Idli Recipe,"Sooji, Sunflower Oil, Green Beans, Kala Jeera, Enos Fruit Salt, Curd, Salt, Mustard Seeds, Asafoetida, Ginger, White Urad Dal",11,0,20,20,4,South Indian Recipes,South Indian Breakfast,Vegetarian
Grilled Eggplant With Spirulina Basil Pesto and Tofu Recipe,"Brinjal, Tofu, Basil Leaves, Mint Leaves, Spirulina, Badam, Garlic, Tofu, Black Pepper Powder, Salt, Extra Virgin Olive Oil, Onion, Yellow Bell Pepper, Green Bell Pepper, Black Pepper Powder, Garlic, Ginger, Red Chilli Sauce, Extra Virgin Olive Oil",19,10,30,40,4,Continental,Appetizer,Vegetarian
Arbi Ke Patte Ke Pakode - Colocasia Leaf Rolls Recipe,"Gram Flour, Colocasia Leaves, Red Chilli Powder, Amchur, Coriander Powder, Cumin Powder, Ginger Garlic Paste, Salt, Water, Chaat Masala Powder Sprinkle, Lemon Wedges, Sunflower Oil Cook",12,20,40,60,5,Maharashtrian Recipes,Snack,Vegetarian
Mexican Vegetarian Fajitas Recipe,"Green Bell Peppers, Yellow Bell Pepper, Red Bell Pepper, Onion, Cumin Powder, Black Pepper Powder, Paprika Powder, Dried Thyme Leaves, Salt, Rajma, Onion, Tomato, Dried Oregano, Cumin Powder, Paprika Powder, Black Pepper Powder, Salt, Sunflower Oil, Tortillas Serve, Tomato Salsa Serve, Sour Cream Serve, Guacamole Serve, Cheddar Cheese Serve",23,10,25,35,4,Mexican,Main Course,Vegetarian
Sprouted Horse Gram Thoran Recipe - No Onion No Garlic,"Horse Gram Dal, Fresh Coconut, Green Chilli, Cumin Seeds, Ginger, Cumin Seeds, Turmeric Powder, Red Chilli Powder, Salt, Tomato    Optional",10,10,15,25,4,Kerala Recipes,Lunch,Vegetarian
Creamy Dal Makhani Recipe,"Black Urad Dal, Rajma, Fresh Cream, Butter, Red Chilli Powder, Turmeric Powder, Cumin Seeds, Water, Onion, Homemade Tomato Puree, Ginger, Garam Masala Powder, Asafoetida, Black Cardamom, Cloves, Green Chilli, Coriander Powder, Salt",18,10,55,65,4,North Indian Recipes,Lunch,High Protein Vegetarian
Instant Red Chilli Pickle Recipe,"Fresh Red Chilli, Mustard Seeds, Fennel Seeds, Turmeric Powder, Salt, Sunflower Oil, Lemon Juice",7,15,5,20,10,Indian,Side Dish,Vegetarian
Vaangi Shimla Mirchi Bhaji Recipe - Brinjal Capsicum Gravy,"Brinjal, Potato, Green Bell Pepper, Onion, Tomato, Garlic, Ginger, Turmeric Powder, Byadagi Chilli Powder, Kashmiri Red Chilli Powder, Garam Masala Powder, Salt, Coriander, Sunflower Oil, Mustard Seeds, Asafoetida, Curry Leaves",17,35,35,70,4,Maharashtrian Recipes,Lunch,Vegetarian
Aloo Gobi Matar Ki Sabzi Recipe,"Cauliflower, Potato, Green Peas, Red Chilli Powder, Coriander Powder, Turmeric Powder, Onion, Ginger, Methi Leaves, Coriander, Sunflower Oil, Salt",12,15,35,50,4,North Indian Recipes,Lunch,Vegetarian
Banana And Ragi Porridge Recipe For Babies And Toddlers,"Ragi Flour, Ripe Bananas",2,2,10,12,2,Indian,Lunch,Vegetarian
Tofu Chocolate Mousse Recipe,"Tofu, Cocoa Powder, Maple Syrup Honey, Salt, Vanilla Extract, Coconut Oil, Almond Milk",7,10,0,10,8,Continental,Dessert,High Protein Vegetarian
Pumpkin Wade (Sweet Pumpkin Pooris) Recipe,"Whole Wheat Flour, Kaddu, Cumin Seeds, Jaggery, Sesame Seeds, Cooking Soda, Sunflower Oil, Salt, Sunflower Oil",9,20,40,60,4,Indian,Snack,Vegetarian
Dahi Ma Bheeda Recipe (Dahi Bhindi - Parsi Style Okras Cooked In Yogurt Recipe),"Bhindi, Ginger, Garlic, Turmeric Powder, Red Chilli Powder, Cumin Powder, Curd, Salt, Sunflower Oil",9,10,30,40,4,Parsi Recipes,Lunch,Vegetarian
Gujarati Sev Tameta Nu Shaak | Sev Tamatar Ki Sabzi Recipe,"Tomato, Ghee, Mustard Seeds, Cumin Seeds, Curry Leaves, Green Chilli, Ginger, Turmeric Powder, Red Chilli Powder, Jaggery, Sev, Salt",12,10,15,25,4,Gujarati Recipesï»¿,Main Course,No Onion No Garlic (Sattvic)
Broccoli & Pepper Rice ,"Rice, Broccoli, Capsicum, Capsicum, Onion, Green Chilli, Garlic, Lemon Juice, Coriander, Black Pepper Powder, Salt, As Per",12,20,40,60,4,Indian,Lunch,Vegetarian
Thai Style Mung Bean Fritter Recipe,"Yellow Moong Dal, Whole Egg, Baking Powder, Stalks Spring Onion Greens, Coriander, Fresh Red Chilli, Garlic, Sugar, Lemon Juice, Salt, Coriander, Green Chilli, Garlic, Vinegar",14,60,25,85,4,Thai,Appetizer,Gluten Free
Masala Soda Shikanji Recipe,"Sprite Any Lemon Soda, Lemon, Green Chilli, Chaat Masala Powder, Black Saltrock Salt, Cumin Powder, Lemon, Peppermint, Ice",9,15,0,15,3,Indian,Snack,Vegetarian
Potato Basil Fritters Recipe,"Potato, Basil Leaves, Whole Wheat Bread Crumbs, Italian Seasoning, Whole Eggs, Red Chilli Flakes, Salt, Sunflower Oil",8,20,30,50,4,Continental,Snack,Vegetarian
Tuna Rasam Bhaji Recipe (Tuna Sabzi Flavoured With Rasam Powder),"Canned Tuna, Onion, Tomato  Bitesize, Green Bell Pepper, Potato, Carrot, Green Chilli, Ginger, Rasam Powder, Turmeric Powder, Red Chilli Powder, Cumin Seeds, Lemon, Salt, Coriander, Sunflower Oil Saute, Mixed Vegetables",17,15,15,30,4,Fusion,Side Dish,High Protein Non Vegetarian
Thai Coconut Garlic Rice Recipe,"Coconut Oil, Garlic, Rice, Water, Coconut Milk, Of Green Coriander, Salt, Coconut Oil, Garlic, Dry Coconut",10,5,20,25,3,Thai,Main Course,Vegetarian
Kaya Tholi Thoran Recipe (Raw Banana Thoran),"Raw Banana Peel, Turmeric Powder, Water, Salt, Fresh Coconut, Garlic, Cumin Seeds, Green Chilli, Shallots, Salt, Sunflower Oil, Mustard Seeds, Dry Red Chilli, Curry Leaves",14,10,30,40,2,Kerala Recipes,Lunch,Vegetarian
Patiala Aloo Recipe,"Potato, Mustard Oil Any Other Oil, Cumin Seeds, Asafoetida, Fenugreek Seeds, Green Chili, Red Chilli Powder, Cumin Powder, Bay Leaf, Coriander Powder, Amchur Powder, Chaat Masala Powder, Garam Masala Powder, Turmeric Powder, Kasoori Methi, Tomato Puree, Tamarind Paste, Green Coriander",18,10,25,35,4,North Indian Recipes,Main Course,No Onion No Garlic (Sattvic)
Quinoa Brown Rice and Vegetable Pulao Recipe,"Quinoa, Brown Rice, Cauliflower, Potato, Carrot, Green Beans, Green Peas, Garam Masala Powder, Black Pepper Powder, Turmeric Powder, Onion, Fennel Seeds, Ginger, Garlic, Green Chilli, Lemon Juice, Extra Virgin Olive Oil Ghee, Salt, Coconut Milk, Hot Water, Coriander",21,20,35,55,4,Indian,Lunch,Diabetic Friendly
Quinoa and Vegetable Saute Recipe,"Yield, Quinoa, Onion, Red Bell Pepper, Carrots, Green Peas, Cumin Seeds, Ginger, Red Chilli Powder, Coriander Powder, Turmeric Powder, Lemon Juice, Extra Virgin Olive Oil, Salt",14,10,25,35,3,Indian,Dinner,High Protein Vegetarian
Paneer Do Pyaza Recipe,"Paneer, Sunflower Oil, Onion   Lengthwise, Onion, Tomato  Finely, Cumin Seeds, Cardamom, Ginger Garlic Paste, Turmeric Powder, Coriander Powder, Red Chilli Powder, Kasuri Methi, Garam Masala Powder, Heavy Whipping Cream, Salt",15,10,30,40,2,North Indian Recipes,Dinner,Vegetarian
Pakistani Bhuna Gosht Recipe,"Mutton, Onion, Garlic, Ginger, Curd, Coriander Powder, Red Chilli Powder, Turmeric Powder, Salt, Sunflower Oil, Ghee, Coriander, Dry Red Chilli, Bay Leaf, Cinnamon Stick, Mace, Ajwain, Cloves, Whole Black Peppercorns, Cardamom, Black Cardamom, Nutmeg",22,10,60,70,5,Pakistani,Dinner,Non Vegeterian
Mushroom Stuffed Ravioli With Burnt Butter Sauce Recipe,"Extra Virgin Olive Oil, Water More If Needed, Whole Eggs, All Purpose Flour, Salt, Extra Virgin Olive Oil, Clove Garlic  Minced, Onion, Button Mushrooms  Coarsely, Britannia Cream Cheese, Parmesan Cheese, Mozzarella Cheese, Spinach, Chives, Parsley Leaves, Cayenne Pepper, Salt, Black Pepper Powder, Egg White, Butter, Basil Leaves, Garlic, Salt, Black Pepper Powder",24,10,45,55,4,Italian Recipes,Dinner,Vegetarian
Badam Milk Recipe,"Almonds, Milk, Sugar, Cardamom, Saffron",5,5,30,35,4,Indian,Side Dish,Vegetarian
Creamy Beetroot and Potato Puree Recipe - Baby Food,"Beetroot, Potato, Salt, Turmeric Powder, Cumin Powder, Asafoetida",6,10,30,40,2,Indian,Lunch,Vegetarian
Green Beans Fry ,"Green Beans, Asafoetida, Cumin Seeds, Green Chili, Red Chilli Powder, Turmeric Powder, Coriander Powder, Oil",8,10,30,40,2,Indian,Lunch,Vegetarian
Cheesy Garlic Spinach Corn Paneer Sandwich Recipe,"Garlic, Spinach, Sweet Corn, Paneer, Britannia Cheese Block, Nutralite Cheesy Garlic Mayo, Whole Wheat Brown Bread, Herb Butter",8,10,25,35,4,Continental,World Breakfast,High Protein Vegetarian
Shrimp Stir Fry With Cheesy Dip Mayo Recipe,"Green Bell Pepper, Red Bell Pepper, Yellow Bell Pepper, Onion, Tomato, Garlic, Basil Leaves, Broccoli, Shrimps  Deveined, Del Monte Cheesy Dip, Soy Sauce, Green Chilli Sauce, Garam Masala Powder, Sunflower Oil, Red Chilli Powder, Salt, Salt, Salt",18,15,45,60,4,Asian,Side Dish,High Protein Vegetarian
Tofu Strawberry Puree Recipe For Babies And Toddlers,"Strawberries, Tofu",2,2,5,7,2,Continental,Snack,Vegetarian
Ginger-Holy Basil Tisane - Adrak Tulsi Chai Recipe,"Tulsi, Lemon, Ginger, Honey, Water",5,2,5,7,2,Indian,Vegetarian,Vegetarian
Spinach Mushroom Stir Fry Recipe,"Spinach, Button Mushrooms, Onion, Garlic, Whole Black Pepper Corns, Cumin Powder, Salt",7,10,15,25,4,Continental,Main Course,High Protein Vegetarian
A Creamy & Delicious Gulkand Kulfi Recipe,"Milk, Sugar, Fennel Seeds, Gulkand, Badam, Gulkand, Betel Nut",7,10,45,55,6,Indian,Dessert,Vegetarian
Couscous Salad With Cucumber And Feta Cheese Recipe,"Couscous, Water, Sunflower Oil, Salt, Cucumber, Raisins, Kalmatta Olives, Feta Cheese, Coriander, Extra Virgin Olive Oil, Salt, Black Pepper Powder",12,20,30,50,4,Continental,Dinner,Diabetic Friendly
Mexican Chicken Soup Recipe,"Onion, Carrot, Celery, Sweet Corn, Garlic, Green Chilli, Tomato, Chicken Breasts, Dried Oregano, Red Chilli Powder, Cumin Powder, Coriander, Chicken Stock, Lemon Juice, Salt, Canola Oil",16,15,40,55,4,Continental,Appetizer,Non Vegeterian
Zoodles In Creamy Basil Pesto Recipe,"Basil Leaves, Avocado, Cashew Nuts, Garlic, Extra Virgin Olive Oil, Parmesan Cheese, Lemon Juice, Salt, Green Zucchini, Extra Virgin Olive Oil, Sun Dried Tomato, Basil Leaves Garnish",12,10,15,25,2,Italian Recipes,Dinner,Vegetarian
Bread Halwa Recipe,"Whole Wheat Brown Bread, Sugar, Milk  Preferably âWhole Milkâ, Fresh Cream, Ghee  Adjustable, Cardamom Powder, Mixed Dry Fruits, Edible Silver Foilleaf",8,10,20,30,2,Mughlai,Dessert,Vegetarian
Saunf Wali Hari Gobi Sabzi Recipe - Cauliflower Spiced with Fennel and Green Chutney,"Cauliflower, Fennel Seeds, Ginger, Tomato, Bay Leaves, Green Chutney, Curd, Turmeric Powder, Coriander Powder, Salt, Red Chilli Powder, Sunflower Oil",12,20,30,50,4,North Indian Recipes,Side Dish,No Onion No Garlic (Sattvic)
Malabar Style Kozhi Pidi Recipe - Rice Dumplings In Chicken Stew,"Chicken, Onion, Garlic, Ginger, Curry Leaves, Fresh Coconut, Turmeric Powder, Red Chilli Powder, Coriander Powder, Garam Masala Powder, Salt, Coconut Oil, Hot Water, Rice Flour, Salt",15,10,45,55,4,Malabar,Lunch,Non Vegeterian
Beetroot And Chickpea Kebab/Tikki Recipe - Evening Snack,"Beetroots, Kabuli Chana, Roasted Peanuts, Cumin Powder, Coriander Powder, Red Chilli Powder, Garam Masala Powder, Turmeric Powder, Amchur, Asafoetida, Gram Flour, Corn Flour, Sooji, Salt, Sunflower Oil",15,800,30,830,6,Indian,Snack,High Protein Vegetarian
Instant Rava Appam With Vegetables Recipe,"Sooji, Curd, Water, Enos Fruit Salt, Carrot, Onion, Tomato, Green Beans, Coriander, Green Chilli, Salt, Sunflower Oil",12,10,10,20,4,South Indian Recipes,South Indian Breakfast,Vegetarian
Tamil Nadu Style Potato Masiyal Recipe (South Indian Style Aloo Masala),"Potato, Onion, Green Chilli, Ginger, Garlic, Cashew Nuts  Roughly, Gram Flour, Turmeric Powder, Salt, Few  Coriander, Sesame, Mustard Seeds, Chana Dal, Curry Leaves",14,30,40,70,4,Tamil Nadu,Lunch,Vegetarian
Cauliflower Pepper Fry Recipe (Chettinad Style),"Cauliflower, Sunflower Oil, Mustard Seeds, Asafoetida, Curry Leaves, Turmeric Powder, Cumin Seeds, Whole Black Peppercorns, Dry Red Chilli, Salt",10,10,10,20,4,Chettinad,Lunch,Vegetarian
Quinoa Vangi Bath Recipe,"Quinoa, Brinjal, Dry Red Chilli, Mustard Seeds, Chana Dal, White Urad Dal, Cashew Nuts, Kabuli Chana, Curry Leaves, Asafoetida, Turmeric Powder, Vangi Bath Powder, Lemon Juice, Salt, Sunflower Oil",15,20,35,55,4,Indian,Lunch,Vegetarian
Cheesy Mushroom Masala Dosa Recipe,"Idli Rice, Ragi Seeds, Barley, White Urad Dal, Methi Seeds, Water, Onion, Garlic, Green Chilli, Tomato, Button Mushrooms, Red Chilli Powder, Pav Bhaji Masala, Chaat Masala Powder, Paneer, Mint Leaves, Britannia Cheese Block",17,300,30,330,10,South Indian Recipes,South Indian Breakfast,Vegetarian
Orange & Date Muffin Recipe,"Whole Wheat Flour, All Purpose Flour, Brown Sugar, Baking Powder, Baking Soda, Salt, Cinnamon Powder, Orange Zest, Fresh Orange Juice, Butter, Buttermilk, Whole Egg Flaxseed Egg Replacer, Dates, Walnuts",14,20,40,60,6,Continental,Dessert,Eggetarian
Dhaba Style Dal Palak Recipe,"Arhar Dal, Spinach Leaves, Sunflower Oil, Onion, Tomato, Green Chilli, Ginger, Garlic, Garam Masala Powder, Turmeric Powder, Salt, Lemon, Ghee, Cumin Seeds, Garlic, Dry Red Chilli",16,10,20,30,4,North Indian Recipes,Lunch,High Protein Vegetarian
Bihari Chana Dal Puri Recipe,"Whole Wheat Flour, Chana Dal, Cumin Seeds, Red Chilli Powder, Coriander Powder, Turmeric Powder, Coriander, Salt, Sunflower Oil Deep Fry",9,30,30,60,3,Bihari,North Indian Breakfast,Vegetarian
Kolhapuri Akkha Masoor Dal Recipe (Masoor Dal in Kholapuri Masala),"Masoor Dal, Onion, Tomato, Ginger, Garlic, Red Chilli Powder, Turmeric Powder, Kolhapuri Khanda Lasun Masala Goda Masala, Sesame Seeds, Dessicated Coconut",10,10,35,45,4,North Indian Recipes,Lunch,High Protein Vegetarian
Mango Buckwheat Porridge Recipe,"Buckwheat Flour, Ripe Bananas, Mango, Dates, Milk, Lemon Juice, Cashew Nuts, Strawberries, Badam, Mint Leaves",10,5,10,15,2,Continental,World Breakfast,Vegetarian
Aam Pora Shorbot Recipe - Bengali Aam Panna Recipe,"Mango, Sugar Jaggery, Cumin Powder, Black Salt, Mint Leaves, Chilled Water, Ice Cubes",7,5,25,30,4,Bengali Recipes,Appetizer,Vegetarian
Penne Pasta With Veggies in Tomato Base Recipe,"Penne Pasta, Extra Virgin Olive Oil Cook, Onion, Green Bell Pepper, Carrot, Green Beans, Black Olives, Milk, All Purpose Flour, Salt, White Pepper Powder, Dried Oregano, Red Chilli Flakes, Homemade Tomato Puree, Rosemary, Cheese",16,10,40,50,2,Italian Recipes,Dinner,Vegetarian
Malabar Style Ney Pathiri Recipe (Fried Masala Rice Puri),"Rice Flour, Salt, Sunflower Oil, Onion, Cumin Seeds, Fresh Coconut",6,15,35,50,4,Malabar,Side Dish,Vegetarian
Fresh Fruit Bowl Recipe,"Strawberries, Green Seedless Grapes, Orange, Ripe Bananas, Fresh Pomegranate Fruit Kernels, Kiwi, Apple, Red Grapes, Chaat Masala Powder, Salt And Pepper",10,20,0,20,2,Continental,Snack,Vegetarian
Whole Wheat Pasta Salad With Capsicum And Corn Recipe,"Pasta  Fusilli, Sweet Corn, Tomato, Red Yellow And Green Bell Peppers, Lettuce Leaves, Coriander, Classic Mayonnaise, Curd, Garlic, Extra Virgin Olive Oil, Salt And Pepper",11,15,10,25,4,Continental,Side Dish,Vegetarian
Cauliflower Coconut Milk Stew Recipe,"Cauliflower, Garlic, Bay Leaf, Cardamom, Whole Black Peppercorns, Red Chilli Powder, Turmeric Powder, Homemade Tomato Puree, Coconut Milk, Salt, Coriander, Sunflower Oil",12,10,40,50,4,South Indian Recipes,Lunch,Vegetarian
Caribbean Vegetable Patties Recipe (Hand Pie),"All Purpose Flour, Salt, Turmeric Powder, Curry Powder, Butter, Chilled Water, Mixed Vegetables, Cabbage, Green Bell Pepper, Tomato, Onion, Ginger Garlic Paste, Salt Tate, Coconut Oil, Paprika Powder, All Spice Powder, Nutmeg Powder, Cinnamon Powder",18,60,30,90,10,Caribbean,Snack,Vegetarian
Roasted Cauliflower Dill Soup Recipe,"Flower Cabbage, Milk, Heart Leaves, Walnuts, Salt, Pepper Powder, Oil",7,10,45,55,4,Continental,Appetizer,Vegetarian
Moong Dal Methi Ki Sabzi ,"Green Moong Dal, Fenugreek, Tomato, Onion, Green Chilli, Cumin Seeds, Teaspoon Ginger, Cumin Seeds, Turmeric Powder, Coriander Powder, Cumin Powder, Asafoetida, Oil, Water",14,10,30,40,4,Indian,Lunch,Vegetarian
Goan Egg Drop Curry Recipe,"Whole Eggs, Onion, Garlic, Fresh Coconut, Onion, Coriander, Tamarind, Dry Red Chilli, Turmeric Powder, Water, Salt, Sunflower Oil",12,15,30,45,2,Goan Recipes,Dinner,Eggetarian
Spicy Soya Bhurji Recipe - North Indian Soya Matar Bhurji,"Soybeans, Green Peas, Onion, Tomato, Green Chilli, Garlic, Ginger, Coriander Powder, Red Chilli Powder, Turmeric Powder, Chana Masala Powder, Garam Masala Powder, Coriander, Sunflower Oil, Salt",15,10,15,25,4,North Indian Recipes,Lunch,High Protein Vegetarian
Bihari Style Kadhi Bari Recipe,"Gram Flour, Red Chilli Powder, Coriander Powder, Turmeric Powder, Cumin Seeds, Ajwain, Enos Fruit Salt, Salt, Curd, Gram Flour, Turmeric Powder, Coriander, Bay Leaf, Curry Leaves, Garlic, Cumin Seeds, Dry Red Chilli, Ghee, Kashmiri Red Chilli Powder, Salt",20,10,30,40,4,Bihari,Lunch,Vegetarian
Sprouted Kollu Sambar Recipe - Horse Gram Sambar With Vegetables,"Horse Gram Dal, Carrot, Bottle Gourd, Tomato, Pearl Onion, Tamarind Water, Sambar Powder, Turmeric Powder, Salt, Gingelly Oil, Mustard Seeds, Dry Red Chilli, Asafoetida, Curry Leaves",14,10,20,30,4,South Indian Recipes,Lunch,Diabetic Friendly
Parsi Salli Murgh Recipe ,"Hen, Onion, Ginger Garlic Paste, Green Chilli, Red Chilli Sauce, Yogurt, Coriander Powder, Kashmiri Red Chilli, Turmeric Powder, Garam Masala Powder, Nutmeg Powder, Cardamom, Whole Black Pepper, Lavang, Cardamom, Cinnamon, Bay Leaves, Oil, Potato, Nuggets Coriander, Coriander",21,20,45,65,4,Parsi Recipes,Dinner,Non Vegeterian
Sukha Bhel Recipe With Boiled Peanuts - Peanut Bhel Chaat,"Raw Peanuts, Potato, Puffed Rice, Onion, Tomato, Coriander, Lemon Juice, Green Chilli, Mustard Oil, Red Chilli Powder, Chaat Masala Powder, Black Salt",12,15,15,30,3,Indian,Snack,Vegetarian
Warm Red Lentil Salad With Goat Cheese Recipe,"Masoor Dal, Onion, Tomato, Spinach, Goat Cheese, Bay Leaf, Extra Virgin Olive Oil, Vinegar, Kasundi Mustard Sauce, Garlic, Black Pepper Powder, Salt",12,5,20,25,4,Indian,Side Dish,Vegetarian
Goan Recheado Masala Recipe,"Dry Red Chilli, Tamarind Paste, Cloves, Cardamom, Cinnamon Stick, Cumin Seeds, Black Pepper Corns, Ginger, Garlic, Onion, Turmeric Powder, Vinegar, Jaggery, Salt",14,30,5,35,1,Goan Recipes,Vegetarian,Vegetarian
Shakarkandi Ka Halwa Recipe (Sweet Potato Halwa),"Sweet Potato, Sugar, Ghee, Mixed Nuts, Cardamom Powder",5,10,20,30,2,North Indian Recipes,Dessert,Vegetarian
Bengali Style Dimer Torka Recipe (Egg Tadka Dal Recipe),"Arhar Dal, Chana Dal, White Urad Dal, Cinnamon Stick, Cloves, Cardamom Powder, Onion, Tomato, Green Chilli, Red Chilli Powder, Turmeric Powder, Coriander Powder, Cumin Powder, Kasuri Methi, Ghee, Salt, Onion, Garlic, Ginger",19,30,30,60,4,Bengali Recipes,Lunch,Eggetarian
Milagu Keerai Poricha Kootu Recipe - Palak And Moong Dal Kootu,"Red Amaranth Leaves, Yellow Moong Dal, Turmeric Powder, Salt, Cumin, Whole Black Peppercorns, Fresh Coconut, Coconut Oil, Mustard Seeds, Cumin, White Urad Dal, Curry Leaves",12,20,30,50,4,South Indian Recipes,Lunch,Diabetic Friendly
Lehsun Methi Raita Recipe,"Methi Leaves, Curd, Sunflower Oil, Garlic, Salt, Cumin Powder, Chaat Masala Powder, Black Salt, Water, Chaat Masala Powder, Black Salt, Water, Sunflower Oil, Garlic, Kashmiri Red Chilli Powder",15,10,15,25,4,Indian,Side Dish,Vegetarian
Chickpea and Broccoli Quesadilla Recipe,"Tortillas, Onion, Garlic, Kabuli Chana, Broccoli, Cumin Powder, Dried Oregano, Red Chilli Flakes, Fresh Cream, Salt",10,10,30,40,4,Mexican,Appetizer,Vegetarian
Bengali Egg Curry Recipe,"Whole Eggs, Potato, Turmeric Powder, Red Chilli Powder, Salt, Onion, Ginger Garlic Paste, Cumin Seeds, Whole Black Peppercorns, Tomato, Bay Leaf, Cardamom, Onion, Green Chilli, Cumin Powder, Coriander Powder, Panch Phoran Masala, Red Chilli Powder, Water, Sunflower Oil, Salt, Coriander",22,20,45,65,8,Bengali Recipes,Lunch,Eggetarian
Averekaalu Rava Laddu Recipe - Field Beans Semolina Ladoo,"Sooji, Avarekalu  Lilva Beans, Dessicated Coconut, Cardamom Powder, Jaggery, Ghee",6,10,45,55,4,Karnataka,Dessert,Vegetarian
"Beetroot, Carrot & Cucumber Salad with Peanuts Recipe","Chakundar, Carrots, Cucumber, Peanuts, Green Chilli, Coriander, Lemon Juice, Black Pepper Powder, Chaat Masala Powder, Salt",10,30,0,30,4,North Indian Recipes,Side Dish,Vegetarian
Mediterranean Quinoa Bowl Recipe With Red Bell Pepper Sauce,"Quinoa, Mixed Vegetables, Tomato, Spring Onion Greens, Fresh Herbs, Lemon Juice, Black Pepper Powder, Black Olives, Salt, Red Bell Pepper, Badam, Lemon Juice, Pomegranate Molasses, Salt, Paprika Powder, Extra Virgin Olive Oil",16,10,30,40,2,Mediterranean,Dinner,High Protein Vegetarian
Oreo Paneer Modak Recipe,"Condensed Milk, Paneer, Oreo Biscuits, Butter, Cardamom Powder",5,35,10,45,5,Indian,Dessert,Vegetarian
Pineapple Paneer Tikka Recipe,"Paneer, Pineapple, Red Bell Pepper, Sunflower Oil, Hung Curd, Gram Flour, Garlic, Ginger, Kasuri Methi, Fennel Seeds, Ajwain, Cumin Powder, Coriander Powder, Black Pepper Powder, Turmeric Powder, Red Chilli Powder, Garam Masala Powder, Black Salt, Salt",19,30,30,60,4,North Indian Recipes,Appetizer,High Protein Vegetarian
Kale And Mushroom French Soup Recipe,"Kale, Gm Button Mushrooms, Onion, Garlic, Capsicum, Vegetable Stock Chicken Stock, Capsicum, Parcel, Cream, Salt, Black Pepper Powder, Butter",12,15,15,30,2,Continental,Dinner,Non Vegeterian
Sabudana Tikki Recipe ( Spiced Tapioca Pearls Patties Recipe),"Sabudana, Potato, Green Chilli, Roasted Peanuts, Raisins, Badam, Cumin Powder, Amchur, Rock Salt, Peanut Oil",10,370,30,400,4,Indian,Snack,Vegetarian
Mushroom Tikka Masala Dry Recipe,"Button Mushrooms, Green Bell Pepper, Onion, Curd, Gram Flour, Ginger Garlic Paste, Turmeric Powder, Kashmiri Red Chilli Powder, Garam Masala Powder, Turmeric Powder, Chaat Masala Powder, Lemon Juice, Sunflower Oil, Salt, Kasuri Methi",15,5,30,35,4,North Indian Recipes,Lunch,High Protein Vegetarian
Honey Glazed Corn Fritters Recipe,"Sweet Corn  Boiled And Mashed Coarsely, Potato, Green Chilli, Ginger, Salt, All Purpose Flour, Whole Wheat Bread Crumbs, Sunflower Oil, Ginger, Sweet Corn, Roasted Tomato Pasta Sauce, Green Chilli Sauce, Soy Sauce, Honey, Spring Onion",15,20,30,50,4,Indian,Appetizer,No Onion No Garlic (Sattvic)
Paal Kozhukattai Recipe,"Rice Flour, Milk, Jaggery, Coconut Milk, Cardamom Powder, Fresh Coconut, Salt, Water, Ghee",9,10,50,60,4,Chettinad,Dessert,Vegetarian
Baked Mexican Rice Recipe,"Cooked Rice, Onion, Ginger Garlic Paste, Red Chilli Flakes, Rajma, Sunflower Oil, Salt, Black Pepper Powder, Tomato, Onion, Garlic, Dried Oregano, Red Chilli Flakes, Sugar, Sunflower Oil, Salt, Black Pepper Powder, Tomato Ketchup, Sweet Corn, Green Bell Pepper, Tomato, Black Olives, Mozzarella Cheese",23,10,25,35,2,Mexican,Dinner,Vegetarian
Karela Tikki Recipe - Healthy Diabetic Snack,"Karela, Carrot, Paneer, Oats Flour, Green Chilli, Red Chilli Powder, Turmeric Powder, Chaat Masala Powder, Coriander, Salt, Sunflower Oil, Sunflower Oil",12,15,15,30,4,Indian,Snack,Diabetic Friendly
Mande Roti Recipe,"Whole Wheat Flour, Cardamom Powder, Nutmeg Powder, Milk, Saffron Strands, Salt, Sunflower Oil, Ghee",8,10,30,40,4,Pakistani,Side Dish,Vegetarian
Aloo Patta Gobi Sabzi Recipe,"Potato, Onion, Cabbage, Turmeric Powder, Red Chilli Powder, Coriander Powder, Cinnamon, , Bay Leaf, Fennel, Cumin, Salt, Oil, Coriander Leaves",14,5,15,20,4,North Indian Recipes,Lunch,Vegetarian
Aam Ka Panna Recipe With Jaggery,"Mango, Jaggery Sugar, Cumin Powder, Black Salt, Black Pepper Powder, Mint Leaves, Water, Ice Cubes",8,20,20,40,4,North Indian Recipes,Appetizer,Vegetarian
Thakkali Rasam Recipe - South Indian Tomato Rasam,"Arhar Dal, Turmeric Powder, Tamarind Water, Tomato, Garlic, Cumin Powder, Coriander Powder, Black Pepper Powder, Red Chilli Powder, Salt, Curry Leaves, Mustard Seeds, Cumin Seeds, Ghee, Asafoetida, Coriander",16,10,30,40,4,Tamil Nadu,Main Course,Vegetarian
Cheesy Corn On The Cob Recipe,"Sweet Corn, Salted Butter, Ginger, Lemon Juice, Lemon Zest, Parmesan Cheese Any Cheese Of Your Choice, Sunflower Oil, Coriander",8,5,20,25,4,Continental,Appetizer,Vegetarian
Quinoa Rice Pudding With Turmeric Recipe,"Basmati Rice, Quinoa, Coconut Milk, Sugar, Turmeric Powder, Cardamom, Mixed Nuts Fruit, Honey Maple Syrup",8,10,35,45,4,South Indian Recipes,Dessert,Vegetarian
Thai Style Beansprouts & Raw Mango Salad Recipe,"Mango, Roasted Peanuts, Green Moong Sprouts, Brown Sugar, Red Chilli Powder, Salt, Soy Sauce, Chilli Oil Sesame Oil, Lemon Juice, Coriander",10,15,25,40,3,Thai,Appetizer,Vegetarian
Ragi Kanji Recipe - Salt Version,"Water, Ragi Flour, Cumin Seeds, Ajwain, Asafoetida, Salt, Curd, Cumin Powder",8,10,20,30,4,South Indian Recipes,South Indian Breakfast,Diabetic Friendly
Gujarati Dal ,"Tur Dal, Mustard, Cumin Seeds, Curry Leaves, Ginger, Tomato, Kokum, Cinnamon, Asafoetida, Turmeric Powder, Red Chili Powder, Peanuts, Jaggery, Oil, Green Coriander, Salt",16,10,10,20,2,Gujarati Recipesï»¿,Lunch,Vegetarian
Andi Unda (Kerala Special Cashew & Rice Balls) Recipe,"Red Matta Rice, Cashew Nuts, Jaggery, Dry Coconut",4,10,30,40,2,Kerala Recipes,Dessert,Vegetarian
Achari Baingan Bharta Recipe,"Brinjal, Tomato, Onion, Garlic, Green Chilli, Ginger, Turmeric Powder, Coriander, Coriander Powder, Red Chilli Powder, Mango Pickle  Optional, Achari Masala, Sunflower Oil, Asafoetida, Salt, Mustard Seeds, Cumin Seeds, Fennel Seeds, Kalonji, Methi Seeds, Ajwain, Dry Red Chilli, Amchur",23,10,45,55,3,North Indian Recipes,Lunch,Vegetarian
Puffed Lotus Seed Pakoras Recipe,"Gm Makhana, Crush  Flour, Onion, Green Chili, Cumin Seeds, Red Chilli Powder, Turmeric Powder, Salt    Of Green Coriander, Of Curry Leaves, Oil",10,10,30,40,4,Indian,Snack,Vegetarian
Pattani Sundal Recipe - Green Peas Sundal Recipe,"Green Peas, Mustard Seeds, White Urad Dal, Asafoetida, Dry Red Chilli, Ginger, Green Chilli, Fresh Coconut, Curry Leaves, Sunflower Oil, Salt",11,30,20,50,4,South Indian Recipes,Side Dish,Vegetarian
Carrot and Capsicum Mix Dal Recipe,"Arhar Dal, Carrot, Red Yellow And Green Bell Peppers, Tomato, Ginger, Turmeric Powder, Tamarind Water, Salt, Mustard Seeds, Cumin Seeds, Asafoetida, Curry Leaves, Tomato, Green Chilli",14,10,30,40,4,South Indian Recipes,Lunch,High Protein Vegetarian
Pineapple Cucumber Salad Recipe,"Pineapple, Cucumber, Coriander, Lemon Zest, Lemon Juice, Salt, Black Pepper Powder",7,15,10,25,4,Indian,Side Dish,Vegetarian
Egg White Cheese Scrambled Eggs With Spinach & Caramelized Onion Recipe,"Egg Whites, Onion, Spinach, Butter, Cheddar Cheese, Salt, Black Pepper Powder",7,10,15,25,2,Continental,World Breakfast,Eggetarian
Creamy Pumpkin Pasta Sauce Recipe,"Kaddu, Garlic, Red Bell Pepper, Extra Virgin Olive Oil, Milk, Britannia Cream Cheese, Salt",7,0,30,30,1,Italian Recipes,Vegetarian,Eggetarian
Baked Whole Wheat Masala Baati Recipe (Healthy Rajasthani Spiced Wheat Dumplings),"Whole Wheat Flour, Sooji, Ghee, Salt, Curd, Green Peas, Onion, Green Chilli, Cumin Seeds, Ginger Garlic Paste, Red Chilli Powder, Turmeric Powder, Coriander Powder, Cumin Powder, Salt, Sunflower Oil",16,20,60,80,4,Rajasthani,Lunch,Vegetarian
Carrot Cashew Smoothie Recipe,"Carrots, Cashew Nuts, Cardamom Powder, Honey",4,10,15,25,2,Continental,World Breakfast,Vegetarian
Instant Dosa Mix Powder Recipe,"Rice Flour Sooji Rice Will Also Do, Sooji, Poha, White Urad Dal, Black Urad Dal, Arhar Dal, Chana Dal, Methi Seeds",8,0,30,30,4,South Indian Recipes,South Indian Breakfast,Vegetarian
Pearl Barley Vegetable Soup Recipe,"Barley, Extra Virgin Olive Oil, Onion, Garlic, Stalk Celery, Carrot, Potato, Button Mushrooms, Bay Leaf, Vegetable Stock, Parsley Leaves, Whole Black Peppercorns, Salt, Red Chilli Powder",14,20,30,50,2,Continental,Side Dish,Gluten Free
Chicken Mole With Brown Rice Recipe,"Chicken, Homemade Mole Sauce, Brown Rice, Sweet Corn, Dried Oregano, Salt",6,10,65,75,4,Mexican,Lunch,Non Vegeterian
Vegetarian Malai Kebab Recipe,"Cheese, Green Coriander, Rice Flour, Salt, Oil",5,25,10,35,6,North Indian Recipes,Snack,Vegetarian
Tomato Rasam ,"Tur Dalchana Dal, Turmeric Powder, Tamarind Paste, Tomato, Garlic, Cumin Powder, Coriander Powder, Pepper Powder, Red Chili Powder, Salt, Curry Leaves, Small Spoon Rye, Cumin Powder, Ghee   Asafoetida  As Desired, Green Coriander",15,10,20,30,2,South Indian Recipes,Dinner,Vegetarian
Roasted Garlic Pineapple Paneer Pizza Recipe,"Whole Wheat Flour, All Purpose Flour, Active Dry Yeast, Salt, Sugar, Extra Virgin Olive Oil, Water, Pineapple, Paneer, Red Bell Pepper, Onion, Mixed Herbs, Britannia Cheese Spread, Britannia Cheezza, Homemade Pizza And Pasta Sauce, Broccoli, Black Olives, Pickled Jalapenos",18,120,20,140,4,Italian Recipes,Dinner,Vegetarian
Maharashtrian Tomato Saar Recipe,"Tomato, Garlic, Fresh Coconut, Cumin Seeds, Dry Red Chilli, Mustard Seeds, Asafoetida, Curry Leaves, Sunflower Oil, Salt",10,10,15,25,4,Maharashtrian Recipes,Side Dish,Vegetarian
Mixed Vegetable Paratha Recipe,"Whole Wheat Flour, Water Knead, Sunflower Oil, Salt, Potato, Carrot, Onion, Cauliflower, Green Peas, Green Chilli, Coriander, Coriander Powder, Red Chilli Powder, Garam Masala Powder, Salt, Ghee",16,25,25,50,6,Indian,Dinner,Vegetarian
Red Picante Salsa Recipe,"Tomato, Onion, Green Bell Pepper, Red Bell Pepper, Garlic, Chipotle Peppers, Salt, Sugar, Extra Virgin Olive Oil, Coriander",10,10,30,40,4,Mexican,Side Dish,Vegetarian
Crispy Crab Rangoons Recipe,"Wonton Wraps, Sunflower Oil, Crab Meat, Ginger, Onion, Carrot, Britannia Cream Cheese, Sugar, Soy Sauce",9,60,20,80,20,Indo Chinese,Appetizer,Non Vegeterian
Rayalseema Style Borugula Upma Recipe,"Puffed Rice, Onion, Green Chilli, Roasted Peanuts, Lemon Juice, Turmeric Powder, Salt, Coriander, Dessicated Coconut, Roasted Gram Dal, Mustard Seeds, White Urad Dal, Cumin Seeds, Curry Leaves, Sunflower Oil",15,5,15,20,4,Andhra,South Indian Breakfast,Vegetarian
Milk Sooji Fudge Recipe,"Milk, Fresh Cream, Ghee, Sooji, Sugar, Slivered Almonds, Cardamom Powder",7,5,25,30,8,Karnataka,Dessert,Vegetarian
Jello Poke Cake Recipe,"Vivatta Maida, Baking Powder, Butter, Sugar, Whole Eggs, Milk, Salt, Sprig Extract Of Natural Bourbon Vanilla, Jelly Mix, Hot Water, Sugar, Milk, Butter, Sprig Extract Of Natural Bourbon Vanilla, Walnuts, Pecans",16,20,35,55,6,Continental,Dessert,Eggetarian
Uggani Recipe - Puffed Rice Upma,"Puffed Rice, Roasted Gram Dal, Onion, Tomato, Green Chilli, Coriander, Lemon, Turmeric Powder, Salt, Mustard Seeds, White Urad Dal, White Urad Dal, Raw Peanuts, Curry Leaves",14,10,10,20,4,South Indian Recipes,Indian Breakfast,Vegetarian
Uttarakhand Aloo Ke Gutke Recipe,"Potato, Mustard Oil, Red Chilli Powder, Coriander Powder, Cumin Seeds, Turmeric Powder, Dry Red Chilli, Asafoetida, Salt, Coriander",10,10,30,40,2,Uttar Pradesh,Lunch,Vegetarian
Kanda Keri Nu Kachumber Recipe- Instant Mango Pickle,"Mango, Onion, Jaggery, Red Chilli Powder, Cumin Powder, Salt",6,20,0,20,2,Indian,Appetizer,Vegetarian
Aloo Posto Recipe (Potatoes In Poppy Seed Paste),"Poppy Seeds, Potato, Onion, Kalonji, Green Chilli, Sunflower Oil, Mustard Oil, Turmeric Powder, Salt, Coriander",10,10,30,40,4,Bengali Recipes,Lunch,Vegetarian
Teriyaki Tofu Recipe,"Tofu, Dark Soy Sauce, Brown Sugar, Honey, Sesame Seeds, Sriracha Sauce Any Chilli Sauce, S Spring Onion Greens",7,10,15,25,4,Japanese,Appetizer,Vegetarian
Chewy Strawberry Muesli Oats Cookie Recipe,"Whole Wheat Flour, Cinnamon Powder, Instant Oats, Muesli, Strawberries, Vanilla Extract, Jaggery, Extra Virgin Olive Oil, Milk, Whole Egg",10,10,35,45,4,Continental,Snack,Eggetarian
Sweet and Sour Mangalore Cucumber Chutney Recipe,"Mangalorean Cucumber, Turmeric Powder, Red Chilli Powder, Tamarind Water, Jaggery, Salt, Mustard Seeds, White Urad Dal, Curry Leaves, Asafoetida, Sunflower Oil",11,10,45,55,4,South Indian Recipes,Side Dish,Vegetarian
Hot Coffee Latte Recipe,"Milk, Sugar, Coffee Decoction, Cocoa Powder",4,5,15,20,2,Continental,World Breakfast,Vegetarian
Alfredo Spaghetti Pasta Recipe in Broccoli & Olives,"Del Monte Spaghetti Pasta, Broccoli, Black Olives, Garlic, Milk, Fresh Cream, Cheese Spread, Salt, Black Pepper Powder, Sunflower Oil",10,20,30,50,4,Italian Recipes,Dinner,Vegetarian
Eggless Paneer Mc Puff Recipe -Mc Donald's Style,"All Purpose Flour, Ghee Butter, Salt, Chilled Water, Paneer, Green Bell Pepper, Red Bell Pepper, Garlic, Green Chilli Sauce, Roasted Tomato Pasta Sauce, Soy Sauce, Black Pepper Powder, Salt, Butter, Sugar",15,20,25,45,4,Continental,Snack,Vegetarian
Paneer Stuffed Kuzhi Paniyaram Recipe,"Idli Dosa Batter, Onion  Finely, Coriander, Paneer, Onion, Tomato, Ginger, Cumin Seeds, Green Chilli, Red Chilli Powder, Turmeric Powder, Sunflower Oil, Salt",13,10,30,40,4,South Indian Recipes,South Indian Breakfast,Vegetarian
Grilled Sub Sandwich Recipe With Paneer & Roasted Vegetables,"Baguette, Paneer, Red Bell Pepper, Yellow Zucchini, Garlic, Red Chilli Flakes, Dried Oregano, Dried Thyme Leaves, Rosemary, Lemon Juice, Extra Virgin Olive Oil, Salt And Pepper, Mustard Sauce, Iceberg Lettuce, Butter, Cheese",16,10,20,30,2,Continental,Dinner,High Protein Vegetarian
Eggless Oreo Cake Recipe With Buttercream Frosting,"Oreo Biscuits, Milk, Sugar, Enos Fruit Salt, Caster Sugar, Butter, Vanilla Extract, Milk, Icing Sugar, Badam, Oreo Biscuits",11,10,20,30,300,Continental,Dessert,Vegetarian
Curry Patta Chaas Recipe,"Curd, Water, Curry Leaves, Green Chilli, Salt, Black Pepper Powder",6,10,0,10,4,Indian,Snack,Vegetarian
Paplet Hooman Recipe - Goan Pomfret Curry,"Pomfret Fish, Onion, Coconut Oil, Salt, Fresh Coconut, Dry Red Chilli, Turmeric Powder, Coriander, Whole Black Peppercorns, Tamarind",10,20,20,40,3,South Indian Recipes,Dinner,High Protein Non Vegetarian
Pudina Pyaz Kachumber Salad Recipe,"Onion, Green Coriander, Peppermint, Lemon Juice, Cumin Powder, Black Saltrock Salt",6,10,0,10,4,Indian,Side Dish,Vegetarian
Red Smoothie Bowl Recipe,"Ripe Bananas, Mango, Cucumber, Spinach, Broccoli, Strawberries, Beetroot, Celery, Flax Seed Powder, Lemon, Tender Coconut Water, Ice Cubes, Coconut Cream, Mint Leaves, Kiwi",15,10,5,15,2,Continental,World Breakfast,Vegetarian
Traditional Whole Gobi Musallam Recipe,"Cauliflower, Cashew Nuts, Onion, Tomato, Garlic, Ginger, Cumin Powder, Coriander Powder, Red Chilli Powder, Garam Masala Powder, Kasuri Methi, Turmeric Powder, Coriander, Water, Salt",15,10,55,65,3,North Indian Recipes,Dinner,Diabetic Friendly
Broccoli Keema And Cheese Uttapam Recipe,"Broccoli, Onion, Clove Garlic, Green Chilli, Coriander Powder, Red Chilli Powder, Sunflower Oil, Salt, Idli Dosa Batter, Mozzarella Cheese, Sunflower Oil",11,15,30,45,4,South Indian Recipes,South Indian Breakfast,Vegetarian
Aval Dosa | Poha Dosa Recipe (Savory Flattened Rice Crepe),"Rice, White Urad Dal, Poha, Curd, Salt, Water, Sunflower Oil Ghee For Cooking The Dosa",7,0,30,30,8,South Indian Recipes,South Indian Breakfast,Gluten Free
Asian Style Mixed Fried Rice Recipe,"Rice  Cooked, Carrot, Sweet Corn, Green Bell Pepper, Spring Onion Greens, Spring Onion, Garlic, Roasted Peanuts, Peanut Butter, Dark Soy Sauce, Red Chilli Sauce, Rice Vinegar, Salt, Black Pepper Powder, Sesame",15,20,30,50,4,Asian,Dinner,Vegetarian
Dhingri Matar Recipe (Mushrooms and Peas Spicy Curry),"Button Mushrooms, Green Peas, Soy Chunks, Homemade Tomato Puree, Turmeric Powder, Garam Masala Powder, Red Chilli Powder, Garlic, Ginger, Poppy Seeds, Cashew Nuts, Sunflower Oil, Salt, Stalk Coriander",14,20,30,50,4,North Indian Recipes,Lunch,Vegetarian
Uchellu Chutney Recipe,"Kala Jeera, Fresh Coconut, Dry Red Chilli, Garlic, Coriander, Sugar, Salt, Sesame, Mustard Seeds, Curry Leaves, Dry Red Chilli",11,10,10,20,6,North Karnataka,Side Dish,Vegetarian
Muttaikose Pattani Poriyal Recipe - Tamil Nadu Style Cabbage And Peas Stir Fry,"Cabbage, Green Peas, Mustard Seeds, White Urad Dal, Asafoetida, Curry Leaves, Dry Red Chilli, Fresh Coconut, Salt",9,10,25,35,4,Tamil Nadu,Side Dish,Vegetarian
Mirchi Ka Kuta Recipe,"Green Chilli, Mustard Seeds, Fennel Seeds, Salt, Lemon, Sunflower Oil",6,10,15,25,4,Rajasthani,Side Dish,Vegetarian
Moryechi Xacuti Recipe (Goan Style Shark Curry),"Shark Fish, Fresh Coconut, Onion, Garlic, Tamarind, Kashmiri Red Chilli Powder, Turmeric Powder, Coriander, Sunflower Oil, Salt, Ginger Garlic Paste, Turmeric Powder, Salt, Whole Black Peppercorns, Cloves, Cinnamon Stick, Fennel Seeds, Coriander, Dry Red Chilli",19,10,60,70,6,Goan Recipes,Dinner,Non Vegeterian
Vegetarian Nasi Goreng Recipe,"Cooked Rice Leftover, Sunflower Oil, Butter, Fresh Red Chilli, Green Chilli, Garlic  Pods, Ginger, Shallots, Stock Celery, Green Bell Pepper, Carrot, Cabbage, Green Peas, Whole Black Peppercorns, Cumin Powder, Coriander Powder, Lemon, Red Chilli Sauce, Tofu  Cubes, Nachos  Coarsely Crushed, Salt, Parsley Leaves",22,15,15,30,2,Indonesian,Lunch,Vegetarian
Spiced Buttermilk With Coriander And Ginger Recipe,"Curd, Coriander, Ginger, Salt, Water",5,15,0,15,4,Indian,Appetizer,Vegetarian
Walnut Cranberry No Bake Cheesecake Recipe With Strawberries,"Britannia Cream Cheese, Hung Curd, Fresh Cream, Icing Sugar, Vanilla Extract, Walnuts, Cranberries, Dessicated Coconut, Strawberries",9,120,15,135,4,Continental,Dessert,Vegetarian
Karnataka Style Avarekalu Chitranna Recipe (Field Beans Tossed With Lemon Rice),"Avarekalu  Lilva Beans, Rice, Turmeric Powder, Asafoetida, Green Chilli, Curry Leaves, Mustard Seeds, White Urad Dal, Lemon Juice, Coriander, Onion, Ghee Oil, Salt",13,10,30,40,4,Karnataka,South Indian Breakfast,Vegetarian
Chettinad Masala Powder Recipe,"Coriander Seeds, Cumin Seeds, Dry Red Chilli, Celery, Star Anis, Cinnamon, Cardamom, , Fennel, Whole Black Peppercorns, Fenugreek Seeds, Khus Khus, Mace",13,5,10,15,1,Chettinad,Vegetarian,High Protein Vegetarian
Stir Fried Wild Rice with Peri Peri Tofu Recipe,"Wild Rice, Green Bell Pepper, Yellow Bell Pepper, Red Bell Pepper, Onion, Ginger, Garlic, Soy Sauce, Green Chilli Sauce, Salt And Pepper, Sunflower Oil, Paprika Powder, Dried Oregano, Black Pepper Powder, Cinnamon Powder, Ginger, Sugar, Garlic, Onion, Salt, Tofu",21,20,60,80,4,Fusion,Lunch,Vegetarian
Kongunad Chicken Fry Recipe,"Cinnamon Stick, Black Pepper Powder, Coriander, Fennel Seeds, Poppy Seeds, Red Chilli Powder, Dry Coconut, Chicken Breasts, Sunflower Oil, Onion, Turmeric Powder, Salt, Curry Leaves, Coriander, Water",15,15,25,40,4,South Indian Recipes,Side Dish,High Protein Non Vegetarian
Lemon Grilled Chicken Recipe,"Chicken Breasts, Lemon Juice, Dried Oregano, Dried Thyme Leaves, Black Pepper Powder, Salt, Extra Virgin Olive Oil, Sweet Potato, Milk, Butter, Garlic, Salt And Pepper, Broccoli, Red Bell Pepper, Beetroot, Dried Oregano, Salt And Pepper",17,10,45,55,4,Continental,Lunch,Non Vegeterian
Milagai Bajji Stuffed with Masala Chicken Recipe,"Badi Hari Mirch, Sunflower Oil, Chicken Breasts, Onion, Homemade Tomato Puree, Ginger, Garlic, Salt, Ajwain, Fennel Seeds, Cumin Seeds, Coriander, Whole Black Peppercorns, Dry Red Chilli, Fresh Coconut",15,10,60,70,4,Tamil Nadu,Appetizer,Non Vegeterian
Hibiscus (Chembaruthi) Neer Dosa Recipe,"Dosa Rice, Water, Salt And Pepper, White Hibiscus Leaves, Sunflower Oil",5,300,45,345,4,South Indian Recipes,South Indian Breakfast,Vegetarian
Srilankan Prawn Curry Recipe,"Prawns, Fresh Coconut, Coriander, Fennel Seeds, Black Pepper Powder, Cumin Powder, Curry Powder, Turmeric Powder, Red Chilli Flakes, Onion, Garlic, Ginger, Coconut Milk, Lemon Juice, Salt, Sunflower Oil, Curry Leaves",17,25,20,45,4,Sri Lankan,Lunch,Non Vegeterian
Stove Top Green Peas Seekh Kebab Recipe,"Green Peas, Potato, Gram Flour, Onion, Ginger Garlic Paste, Green Chilli Paste, Garam Masala Powder, Cumin Powder, Mint Leaves, Coriander, Lemon Juice, Salt, Sunflower Oil Shallow Fry",13,30,20,50,6,Indian,Appetizer,Vegetarian
Whole Wheat and Jowar (Pearl Millet) Orange Cake With Orange Glaze Recipe,"Whole Wheat Flour, Jowar Flour, Baking Powder, Whole Eggs, Brown Sugar, Orange Zest, Butter, Milk, Brown Sugar, Fresh Orange Juice, Rum Port",11,15,40,55,5,Continental,Dessert,Eggetarian
Bharwa Besan Mirch Sabzi Recipe - Chillies Stuffed With Spiced Gram Flour,"Badi Hari Mirch, Gram Flour, Sunflower Oil, Cumin Seeds, Ssp Asafoetida, Amchur, Turmeric Powder, Coriander Powder, Salt, Coriander, Sunflower Oil, Water",12,10,45,55,3,Rajasthani,Lunch,Vegetarian
Jalapeno Cilantro Lime Rice Recipe,"Cooked Rice, Onion, Garlic, Ginger, Coriander, Dried Thyme Leaves, Dried Oregano, Red Chilli Flakes, Pickled Jalapenos, Salt, Lemon",11,10,25,35,4,Continental,Dinner,Vegetarian
Pina Colada Cake Recipe,"Vivatta Maida, Milk, Sunflower Oil, Butter, Sugar, Baking Powder, Baking Soda, Dry Coconut, Rum, Pineapple, Butter, Caster Sugar, Coconut Milk",13,40,30,70,10,Continental,Dessert,Vegetarian
One Pot Punjabi Rajma Masala Recipe,"Kidney Beans, Ginger, Garlic, Onion, Tomato Puree, Turmeric Powder, Cumin Powder, Small Spoon Garam Masala Powder, Cardamom, Cinnamon, Butter, Coriander Leaves, Oil, Salt",14,15,90,105,4,North Indian Recipes,Main Course,Vegetarian
Curry Leaves Buttermilk Recipe - Curry Patta Chaas Recipe,"Curd, Water, Curry Leaves, Green Chilli, Salt, Black Pepper Powder",6,10,0,10,4,Indian,Snack,Vegetarian
Sundakkai And Methi Leaves Sambar Recipe,"Sundakkai, Methi Leaves, Arhar Dal, Tomato, Tamarind, Turmeric Powder, Sambar Powder, Coriander Powder, Mustard Seeds, Cumin Seeds, Dry Red Chilli, Asafoetida, Sunflower Oil, Salt, Curry Leaves, Coriander, Water",17,30,35,65,4,South Indian Recipes,Lunch,Diabetic Friendly
Nigella Seed Beetroot Rice Recipe,"Basmati Rice, Beetroot, Kalonji, Turmeric Powder, Black Pepper Powder, Green Chilli, Sunflower Oil, Water, Salt, Coriander",10,10,15,25,2,Indian,Dinner,Vegetarian
Stuffed Bun With Veggies Recipe,"All Purpose Flour, Milk, Lukewarm Water, Active Dry Yeast, Sugar, Salt, Extra Virgin Olive Oil, Black Sesame Seeds, Sesame Seeds, Cabbage, Potato, Carrot, Green Beans, Onion, Ajwain, Garam Masala Powder, Cheese, Red Chilli Powder, Turmeric Powder, Coriander, Lemon Juice, Sunflower Oil, Salt",23,80,20,100,4,Continental,Appetizer,Vegetarian
Hara Chana Masala ,"Green, Onion, Tomato, Lentil Sugar, Coriander Powder, Red Chili Powder, Garam Masala Powder, Large Spoon Ghee, Green Coriander, Salt, Ginger, Garlic, Green Chili, Green Coriander, Lentil Sugar, ",16,20,30,50,4,North Indian Recipes,Lunch,Vegetarian
Mambazha Mor Kuzhambu Recipe - Ripe Mango Mor Kuzhambu,"Mango, Turmeric Powder, Fresh Coconut, Cumin Seeds, Green Chilli Fry Red Chilli, Curd, Salt, Coconut Oil, Mustard Seeds, Methi Seeds, Curry Leaves",11,15,15,30,4,South Indian Recipes,Lunch,Vegetarian
Bengali Style Shaak Bhaja Recipe (Stir Fried Green Amaranth leaves Recipe),"Green Amaranth Leaves, Poppy Seeds, Raw Peanuts, Dry Red Chilli, Garlic, Ginger, Cumin Powder, Salt, Mustard Oil",9,15,30,45,2,Bengali Recipes,Lunch,Vegetarian
Aloo Methi Paratha Recipe,"Whole Wheat Flour, Water, Sunflower Oil, Whole Wheat Flour, Salt, Potato, Onion, Methi Leaves, Green Chilli, Coriander, Coriander Powder, Red Chilli Powder, Garam Masala Powder, Chaat Masala Powder, Salt, Ghee",16,20,25,45,4,North Indian Recipes,North Indian Breakfast,Vegetarian
Chicken Sandwich With Sweet Corn Recipe,"Chicken Breasts, Sweet Corn, Classic Mayonnaise, Salt, Tomato Ketchup, Whole Black Peppercorns, Hot Dog Bread, Iceberg Lettuce, Tomato  Sliced, Onion",10,15,10,25,2,Continental,Main Course,High Protein Non Vegetarian
Karnataka Style Heerekai Dosa Recipe-Ridge Gourd Dosa Recipe,"Ridge Gourd, Dosa Rice, Chana Dal, Green Moong Dal, Methi Seeds, Coriander, Cumin Seeds, Dry Red Chilli, Turmeric Powder, Fresh Coconut, Jaggery, Tamarind, Salt",13,500,20,520,4,Karnataka,South Indian Breakfast,Vegetarian
Konkani Style Southe Koddel Recipe-Mangalore Cucumber in Coconut curry,"Mangalorean Cucumber, Tamarind Water, Jaggery, Turmeric Powder, Salt, Sunflower Oil, Methi Seeds, White Urad Dal, Chana Dal, Fresh Coconut, Cumin Seeds, Dry Red Chilli, Curry Leaves, Garlic, Sunflower Oil, Mustard Seeds, White Urad Dal, Curry Leaves",18,10,35,45,4,Konkan,Lunch,Vegetarian
Mini Bajra Uttapam Recipe,"Bajra, Idli Rice, White Urad Dal, Methi Seeds, Salt, Onion, Green Bell Pepper, Green Chilli, Salt, Mint Leaves, Cumin Powder, Ghee Cook The Uttapam",12,500,20,520,10,South Indian Recipes,South Indian Breakfast,Gluten Free
Kalmi Kabab Recipe - Mughlai Style Chicken Tangdi Kebab,"Chicken Legs, Hung Curd, Fresh Cream, Ginger, Garlic, Lemon Juice, Turmeric Powder, Cashew Nuts, Cumin Powder, Garam Masala Powder, Red Chilli Powder, Black Pepper Powder, Salt",13,30,20,50,3,Mughlai,Appetizer,High Protein Non Vegetarian
Seem Paal Recipe - Steamed Colostrum Milk Pudding,"Colostrum, Jaggery Sugar, Cardamom",3,10,25,35,5,Indian,Dessert,Vegetarian
Healthy Veg Lollipop Recipe With Palak & Rajma,"Rajma, Spinach Leaves, Rolled Oats, Red Chilli Powder, Garam Masala Powder, Cumin Powder, Amchur, Salt, Sunflower Oil, Gram Flour, Water, Turmeric Powder, Salt, Rolled Oats",14,30,35,65,15,North Indian Recipes,Appetizer,High Protein Vegetarian
Coorg Style Mushroom Curry Recipe,"Button Mushrooms, Green Chilli, Dry Red Chilli, Whole Black Peppercorns, Onion, Tomato, Curry Leaves, Coriander, Turmeric Powder, Salt, Sunflower Oil, Fresh Coconut, Cumin Seeds, Garlic",14,10,25,35,2,Coorg,Lunch,Vegetarian
Tambdi Bhaji Recipe - Goan Style Red Amaranth Stir Fry,"Red Amaranth Leaves, Onion, Garlic, Green Chilli, Fresh Coconut, Cumin Seeds, Curry Leaves, Sunflower Oil, Salt",9,10,10,20,3,Goan Recipes,Lunch,Vegetarian
Chemmeen Muringakka Curry Recipe -Prawn Drumstick Curry,"Onion, Garlic, Coriander, Cumin Seeds, Fresh Coconut, Dry Red Chilli, Turmeric Powder, Prawns, Drumstick, Green Chilli, Onion, Red Chilli Powder, Mustard Seeds, Curry Leaves, Coconut Oil, Salt",16,5,35,40,4,Kerala Recipes,Lunch,Non Vegeterian
Honey and Sesame Tossed Flat Noodles with Toasted Tofu Recipe,"Rice Noodles, Tofu, Salt, Black Pepper Powder, Sesame Seeds, Egg Noodles, Spring Onion Greens, Garlic, Ginger, Soy Sauce, Honey, Chinese  Spice Powder",12,5,25,30,4,Indo Chinese,Lunch,Vegetarian
Quick Beetroot Pulao Recipe,"Beetroot, Rice  Cooked, Green Chilli, Extra Virgin Olive Oil, Cumin Seeds, Black Pepper Powder, Coriander Powder, Lemon Juice, Coriander, Salt",10,10,10,20,3,Indian,Lunch,Vegetarian
Spicy Vegetarian Thai Noodle Bowl Recipe,"Rice Vermicelli Noodles, Vegetable Stock, Thai Red Curry Paste, Dark Soy Sauce, Rice Vinegar, Ginger, Garlic, Tofu, Carrots, Red Bell Pepper, Yellow Bell Pepper, Baby Corn, English Cucumber, Basil Leaves, Mint Leaves, Coriander, Alfalfa Sprouts, Roasted Peanuts, Chilli Oil, Sesame Seeds, Salt And Pepper, Thai Red Chilli, Lemon Wedges",23,30,20,50,4,Thai,Dinner,Vegetarian
Fresh Basil Pesto Recipe,"Basil Leaves, Walnuts, Garlic, Salt, Grind   Whole Black Pepper, Olive Oil, Parmesan Cheese",7,10,20,30,10,Thai,Dinner,Vegetarian
Spiced Khooba Roti (Rajasthani Pinched Flatbread Recipe),"Whole Wheat Flour  Â CupsÂ Whole Wheat Flour, Salt, Cumin Seeds, Ghee",4,20,15,35,4,Rajasthani,Lunch,Diabetic Friendly
Apple Cucumber Salad Recipe,"Apple, Cucumber, S Mint, Salt, Crush   Whole Pepper, Lemon Juice",6,15,0,15,4,Continental,Appetizer,Vegetarian
Vegetable Uttapam ,"Idli Dosa Mixture, Onion, Capsicum, Carrots, Tomato, Green Chilies, Coriander, Oil",8,10,10,20,2,South Indian Recipes,South Indian Breakfast,Vegetarian
Herbed Tofu & Spinach In Tomato Basil Sauce Recipe,"Tofu, Spinach, Red Bell Pepper, Onion, Garlic, Homemade Tomato Puree, Mixed Herbs, Extra Virgin Olive Oil, Cayenne Pepper, Black Pepper Powder, Water, Corn Flour, Salt",13,15,30,45,4,Continental,Dinner,Vegetarian
Matki Khichdi Recipe - Palak Pudina Moth Bean Khichdi Recipe,"Rice, Moth Dal, Onion, Spinach, Mint Leaves, Garam Masala Powder, Cumin Seeds, Black Pepper Powder, Asafoetida, Ghee, Salt, Ghee, Garlic",13,10,20,30,4,North Indian Recipes,Dinner,Vegetarian
Pistachio Lemon Cookie Recipe,"Maida, Baking Powder, Salt, Butter, Sugar, Honey, Hung Curd, Lemon Juice, Lemon Juice, Pistachios, Grind, Icing Sugar",12,20,40,60,5,Continental,Snack,Vegetarian
Mango & Lemon Bar Recipe,"All Purpose Flour, Salt, Icing Sugar, Butter, Sugar, All Purpose Flour, Whole Eggs, Mango Pulp, Lemon Juice, Lemon Zest, Vanilla Extract",11,60,30,90,6,Continental,Snack,Eggetarian
Chunni Ki Puri Recipe - Moong Dal And Besan Fried Puri Recipe,"Yellow Moong Dal, Gram Flour, Whole Wheat Flour, Salt, Asafoetida, Sunflower Oil, Sunflower Oil",7,15,15,30,3,North Indian Recipes,Lunch,Vegetarian
Kathirikai Paruppu Kootu Recipe,"Small Brinjal, Arhar Dal, Boiled Peanuts, Mustard Seeds, Ginger, Curry Leaves, Tamarind Water, Jaggery, Turmeric Powder, Salt, Coriander, White Urad Dal, Black Pepper Powder, Chana Dal, Dry Red Chilli, Fresh Coconut, Sunflower Oil",17,10,30,40,4,Tamil Nadu,Side Dish,Vegetarian
Tamil Nadu Style Arachuvitta Rasam Recipe,"Tamarind, Tomato, Turmeric Powder, Cumin Seeds, Whole Black Peppercorns, Green Chilli, Curry Leaves, Coriander, Mustard Seeds, Asafoetida, Ghee, Salt, Arhar Dal, Cumin Seeds, Dry Red Chilli",15,10,20,30,2,South Indian Recipes,Lunch,Vegetarian
Goan Style Sangacho Ross Recipe-Drumstick Curry,"Arhar Dal, Drumstick, Onion, Fresh Coconut, Coriander, Dry Red Chilli, Tamarind, Whole Black Peppercorns, Turmeric Powder",9,10,30,40,2,Goan Recipes,Lunch,Vegetarian
Muesli Chia Seed and Dry Fruit Jar Recipe,"Muesli, Chia Seeds, Curd, Cinnamon Powder, Ripe Bananas, Honey, Salt, Prunes, Cranberries, Anardana Powder",10,30,0,30,1,Continental,Snack,Sugar Free Diet
Chow Chow Pasi Paruppu Poriyal Recipe - Chayote Squash And Moong Stir Fry,"Chow Chow, Yellow Moong Dal, Green Chilli, Fresh Coconut, Dry Red Chilli, Mustard Seeds, Curry Leaves, Asafoetida, Lemon Juice, Sunflower Oil, Salt",11,10,20,30,4,South Karnataka,Side Dish,Vegetarian
Aloo Matar Korma Recipe In White Gravy,"Baby Potato, Green Peas, Bay Leaf, Cardamom, Cloves, Garam Masala Powder, Curd, Fresh Cream, Ghee, Salt, Onion, Cashew Nuts, Green Chilli, Ginger",14,15,15,30,4,North Indian Recipes,Lunch,Vegetarian
Roasted Vegetable Au Gratin Recipe,"Sunflower Oil, Green Zucchini, Carrot, Green Beans, Butter, All Purpose Flour, Milk, Britannia Cheese Spread, Britannia Cheese Block",9,20,40,60,4,French,Dinner,Vegetarian
Thengai Poli Recipe - Coconut Poli Recipe,"Whole Wheat Flour, Salt, Ghee, Water, Fresh Coconut, Palm Jaggery, Cardamom Powder, Ghee",8,120,30,150,10,South Indian Recipes,Dessert,Vegetarian
Falsa/Phalsa Ka Sharbat Recipe - Indian Berry Juice,"Falsa Falsaphalsa, Sugar As Per, Cumin Powder, Black Salt, Mint Leaves, Lemon Wedges",6,10,35,45,2,Indian,Snack,Vegetarian
Aavryachi Bhaji-Avarakkai Poriyal Recipe-Broad Beans Stir Fry,"Avarekai, Onion, Fresh Coconut, Green Chilli, Jaggery, Asafoetida, Sunflower Oil, Salt",8,10,30,40,4,North Karnataka,Dinner,High Protein Vegetarian
Beet Quinoa Sliders Recipe,"Sweet Potato, Quinoa, Cumin Powder, Tofu, Beetroot, Onion, Walnuts, Whole Wheat Bread Crumbs, Coriander, Red Chilli Powder, Black Pepper Powder, Parsley Leaves, Dried Oregano, Dried Basil Leaves, Garlic, Lemon Juice, Red Chilli Sauce, Salt, Burger Buns, Classic Mayonnaise, Mustard Sauce, Pickled Jalapenos, Iceberg Lettuce, Avocados, Extra Virgin Olive Oil",25,15,60,75,4,Continental,Snack,High Protein Vegetarian
Spicy Dry Bottle Gourd ,"Gourd, Turmeric Powder, Kashmiri Red Chilli Powder, Salt, Oil, Mustard, Dry Red Chili, White Urad Dal, Curry Leaves, Coconut",10,10,30,40,4,Tamil Nadu,Lunch,Vegetarian
Conchiglie Pasta With Broccoli Recipe,"Conchiglie Pasta, Broccoli, Extra Virgin Olive Oil, Butter, Black Pepper Powder, White Vinegar, Dried Oregano, Salt, Rosemary, Fresh Thyme Leaves",10,5,30,35,4,Italian Recipes,Lunch,Vegetarian
Chickpea & Date Tagine Recipe,"Kabuli Chana, Dates, Onion, Homemade Tomato Puree, Garlic, Ginger, Cumin Powder, Coriander Powder, Cinnamon Powder, Paprika Powder, Salt, Extra Virgin Olive Oil, Mint Leaves, Couscous",14,15,60,75,4,African,Dinner,High Protein Vegetarian
Chettinad Prawn Curry Recipe,"Prawns, Onion, Tomato, Ginger Garlic Paste, Water, Whole Black Peppercorns, Dry Red Chilli, Mustard Seeds, Cinnamon Stick, Curry Leaves, Coriander, Turmeric Powder, Cumin Powder, Tamarind Paste, Tomato, Sunflower Oil, Salt",17,15,30,45,4,Chettinad,Lunch,Non Vegeterian
Chicken In Lemon Butter Sauce Recipe,"Chicken Breasts, Lemon Juice, Salt And Pepper, Onion, Garlic, Honey, Lemon Juice, Butter, Fresh Oregano, Fresh Cream, Parmesan Cheese, Corn Flour, Salt And Pepper",13,10,35,45,1,Continental,Main Course,Non Vegeterian
Stuffed Ridge Gourd Recipe,"Ridge Gourd, Mustard Seeds, Onion, Tomato, Roasted Peanuts, Green Chilli, Coriander, Garlic, Cumin Seeds",9,10,30,40,4,North Indian Recipes,Lunch,Vegetarian
Ajo Blanco Recipe (Chilled White Grape and Almond Gazpacho),"Badam, Ice Cubes, Clove Garlic, Whole Wheat Brown Bread, Green Seedless Grapes, Cucumber, Chilled Water, Extra Virgin Olive Oil, Parsley Leaves, White Wine Vinegar Sherry Vinegar, Salt, Black Pepper Powder, Badam, Green Seedless Grapes",14,15,2,17,2,Continental,Side Dish,Vegetarian
Almond Meal Muffins Recipe (Gluten Free and Grain Free),"Almond Meal, Chia Seeds Flax Seeds, Cinnamon Powder, Baking Powder, Salt, Blueberries Any Locally Available Berry, Fresh Raspberries Any Locally Available Berry, Milk, Coconut Oil Almond Oil, Honey, Vanilla Extract, Whole Eggs, Flaxmeal Egg Replacer",13,15,30,45,6,Continental,Snack,Vegetarian
Maharashtrian Ghavan Recipe - Rice Flour Crepes,"Rice, Sunflower Oil, Salt",3,10,45,55,4,Maharashtrian Recipes,North Indian Breakfast,Vegetarian
Gulab Jamun Trifle Recipe,"Gulab Jamun, Custard Powder, Milk, Sugar",4,5,15,20,2,Indian,Dessert,Vegetarian
No Onion No Garlic Aloo Makhana Sabzi Recipe,"Baby Potato, Phool Makhana, Cumin Seeds, Fennel Seeds, Green Chilli, Red Chilli Powder, Turmeric Powder, Coriander Powder, Salt, Sunflower Oil",10,10,35,45,2,Indian,Lunch,Vegetarian
Healthy Maravalli Kizhangu Bonda Recipe - Spicy Tapioca Fritters,"Tapioca Root, Gram Flour, Rice Flour, Onion, Green Chilli, Ginger, Coriander, Asafoetida, Salt, Sunflower Oil",10,15,30,45,5,South Indian Recipes,Snack,Vegetarian
Coffee Banana Oats Smoothie Recipe,"Instant Oats, Ripe Bananas, Milk, Instant Coffee Powder, Sugar",5,5,5,10,2,Continental,World Breakfast,Gluten Free
"Broccoli, Paneer & Peanut Sandwich Recipe","Breads, Broccoli, Cottage Cheese, Peanuts, Garlic, Red Chilli Sauce, Pepper Powder, Salt, Oil",9,10,30,40,4,Continental,Snack,High Protein Vegetarian
Nimki Aloo Anardana Curry Recipe - Potato And Nimki Curry,"All Purpose Flour, Ajwain, Sooji, Ghee, Salt, Water, Sunflower Oil, Potato, Onion, Ginger Garlic Paste, Homemade Tomato Puree, Sunflower Oil, Cumin Seeds, Turmeric Powder, Red Chilli Powder, Coriander Powder, Anardana Powder, Fennel Seeds, Sugar, Garam Masala Powder, Salt, Kasuri Methi, Coriander, Fresh Pomegranate Fruit Kernels, Lemon Wedges, Onion",26,75,30,105,4,North Indian Recipes,Lunch,Vegetarian
Parsi Lagan Nu Custard Recipe,"Whole Eggs, Milk, Condensed Milk, Sugar, Cardamom, Vanilla Extract, Nutmeg Powder, Badam",8,10,80,90,8,Parsi Recipes,Dessert,Eggetarian
Broccoli Cheddar Frittata Recipe,"Whole Eggs, Milk, Onion, Broccoli, Salt, Whole Black Peppercorns, Cheddar Cheese, Parsley Leaves",8,15,20,35,5,Italian Recipes,World Breakfast,Eggetarian
Grilled Chicken Salad Recipe,"Chicken Breasts, Extra Virgin Olive Oil, Lettuce Leaves, Gouda Cheese, Green Bell Pepper, Cucumber, Badam, Cherry Tomato, Salt, Black Pepper Powder, Lemon Juice, Garlic, Parsley Leaves, Vinegar, Extra Virgin Olive Oil, Parsley Leaves, Garlic, Salt, Red Chilli Flakes",19,10,30,40,4,Continental,Dinner,High Protein Non Vegetarian
Bhaji Vada Recipe (Lentil And Vegetable Fritters),"Green Amaranth Leaves, Chana Dal, Ginger, Green Chilli, Asafoetida, Red Chilli Powder, Turmeric Powder, Salt, Sunflower Oil",9,20,30,50,4,Indian,Snack,Vegetarian
Chicken Parmigiana Recipe,"Chicken Breasts, Whole Wheat Bread Crumbs, All Purpose Flour, Salt And Pepper, Whole Egg, Parmesan Cheese, Mozzarella Cheese, Homemade Tomato Puree, Onion, Garlic, Sugar, Red Chilli Powder, Red Chilli Flakes, Rosemary, Tabasco Original, Salt, Sunflower Oil",17,10,60,70,2,Italian Recipes,Lunch,Non Vegeterian
Aam Papad Recipe (Tasty Mango Bars),"Mango Pulp, Sugar, Ghee, Cardamom Powder",4,10,30,40,4,North Indian Recipes,Dessert,Vegetarian
Vegetarian Mexican Fried Rice Recipe,"Cooked Rice, Rajma, Sweet Corn, Onion, Tomato, Green Bell Pepper, Garlic, Butter, Salt, Tomato Ketchup Tomato Puree, Vinegar, Cayenne Pepper Red Chilli Powder",12,10,30,40,4,Mexican,Lunch,Vegetarian
Thekera Tenga Recipe,"Potato, Mustard Oil, Turmeric Powder, Rice Flour, Lemon Juice  Thekera Pieces Soaked In  Of Water, Salt, Mustard Oil, Panch Phoran Masala, Green Chilli, Coriander",10,10,20,30,4,Assamese,Dinner,Vegetarian
Konkani Style Kotte Saaru/Halasina Bijada Saru Recipe-Jackfruit Seed Rasam,"Jackfruit Seeds, Green Chilli, Garlic, Tamarind, Rasam Powder, Onion, Garlic, Turmeric Powder, Sunflower Oil, Turmeric Powder, Curry Leaves",11,10,40,50,4,Konkan,Lunch,Vegetarian
Doodhi Sabudana Kheer Recipe,"Milk, Bottle Gourd, Sabudana, Sugar, Pistachios, Khoya, Rice, Ghee, Cardamom, Slivered Almonds",10,30,30,60,4,Indian,Dessert,Vegetarian
"Kashmiri Pulao Recipe - Pulao Spiced With Saffron, Whole Spices & Nuts","Basmati Rice, Ginger, Dry Ginger Powder, Fennel Seeds, Green Chilli  Slit, Kashmiri Red Chilli Powder, Cashew Nuts, Badam, Walnuts, Raisins, Pistachios, Saffron Strands, Milk, Water, Salt, Ghee, Ajwain, Cinnamon Stick, Black Cardamom, Cardamom, Cloves, Bay Leaves, Apples, Pineapple, Caramelized Onion",25,20,45,65,6,Kashmiri,Dinner,Vegetarian
Butternut Squash And Carrot Soup Recipe,"Butternut Squash, Onion, Carrots, Stalk Celery, Coriander, Basil Leaves, Vegetable Stock, Lemon Juice, Extra Virgin Olive Oil, Butter, Salt, Whole Black Peppercorns, Fresh Cream",13,10,60,70,2,Continental,Appetizer,Vegetarian
Poricha Kuzhambu Recipe (Tamil Nadu Style Mixed Vegetables and Lentil Stew),"Arhar Dal, Carrots, Green Peas, Green Beans, Cauliflower, Fresh Coconut, Cumin Seeds, Dry Red Chilli, Rice, Turmeric Powder, Mustard Seeds, White Urad Dal, Curry Leaves, Salt",14,10,20,30,4,Tamil Nadu,Dinner,Vegetarian
Boiled Egg White Sandwich Recipe,"Whole Eggs, Whole Wheat Brown Bread, Onion, Black Pepper Powder, Cheese, Butter, Salt",7,10,30,40,2,Continental,World Breakfast,Eggetarian
Cabbage Pachadi Recipe,"Sesame, White Urad Dal, Roasted Gram Dal, Cabbage, Green Chilli, Curry Leaves, Salt, Tamarind Paste, Water, Mustard Seeds, Asafoetida, Dry Red Chilli, Sunflower Oil",13,10,25,35,2,South Indian Recipes,Side Dish,Vegetarian
Garlic Chickpeas And Spinach Curry Recipe,"Kabuli Chana, Spinach Leaves, Onion, Tomato, Garlic, Extra Virgin Olive Oil, Cumin Powder, Paprika Powder, Turmeric Powder, Garam Masala Powder, Salt",11,15,45,60,4,Middle Eastern,Dinner,High Protein Vegetarian
Kolhapuri Masala Recipe (Maharashtrian Masala Chutney Powder),"Coriander, Cumin Seeds, Dessicated Coconut, Sesame Seeds, Whole Black Peppercorns, Cinnamon Stick, Poppy Seeds, Methi Seeds, Fennel Seeds, Onion, Garlic, Coriander, Sunflower Oil, Red Chilli Powder",14,0,30,30,100,Maharashtrian Recipes,Dessert,Eggetarian
Red Kidney Beans Chocolate Barfi Recipe,"Rajma, Sugar, Ghee, Beetroot, Milk Powder, Cardamom Powder, Cocoa Powder, Vanilla Extract",8,6,45,51,4,Indian,Dessert,Vegetarian
Chutney Chilli Cheese Toast Recipe,"Whole Wheat Brown Bread, Tomato, Green Bell Pepper, Butter, Red Chilli Flakes, Mozzarella Cheese Cheddar Cheese, Mint Leaves, Coriander, Ginger Garlic Paste, Green Chilli, Fresh Coconut, Cumin Powder, Salt, Lemon Juice",14,10,20,30,2,Indian,Snack,Vegetarian
Railway Mutton Curry Recipe,"Mutton, Ginger Garlic Paste, Mustard Oil, Curd, Kashmiri Red Chilli Powder, Turmeric Powder, Salt, Fennel Seeds, Coriander, Cumin Seeds, Whole Black Peppercorns, Onion, Potato, Tomato, Ginger Garlic Paste, Turmeric Powder, Kashmiri Red Chilli Powder, Green Chilli, Black Cardamom, Cardamom, Cinnamon Stick, Cloves, Bay Leaf, Mace, Nutmeg, Lukewarm Water, Mustard Oil, Salt, Garam Masala Powder, Ghee",30,10,30,40,4,Indian,Dinner,Non Vegeterian
Classic Caesar Salad Recipe,"Lettuce, Cucumber, Small Tomato, Bread Crutons, Mayo, Mustard Sauce, Salt, Lemon Juice, Whole Pepper, Olive Oil, Garlic, Sugar, Parmesan Cheese",13,15,0,15,4,Italian Recipes,Appetizer,Vegetarian
Tandoori Gobi Tikka Recipe,"Cauliflower, Hung Curd, Red Chilli Powder, Garam Masala Powder, Chaat Masala Powder, Turmeric Powder, Coriander Powder, Ajwain, Kasuri Methi, Gram Flour, Sunflower Oil, Salt",12,15,60,75,4,North Indian Recipes,Side Dish,Vegetarian
Appe Payasa Recipe - Poori Payasam,"Sooji, Salt, Ghee, Water, Sunflower Oil, Milk, Sugar, Nutmeg Powder, Cardamom Powder, Saffron Strands, Mixed Nuts",11,80,30,110,3,South Indian Recipes,Dessert,Vegetarian
Masoor Dal Makhani ,"Masoor Dal, Onion, Tomato, Garlic, Ginger, Bay Leaf, , Cumin Seeds, Lentil Sugar, Red Chilli Powder, Garam Masala Powder, Coriander Powder, Ghee, Cream, Salt",15,10,20,30,4,North Indian Recipes,Lunch,High Protein Vegetarian
Herbed Dinner Rolls Recipe,"Vivatta Maida, Active Dry Yeast, Sugar, Salt, Butter, Whole Eggs, Fresh Herbs, Lukewarm Water, Milk  Lukewarm, Whole Egg, Sesame Seeds",11,15,30,45,6,European,Dinner,Eggetarian
Goan Dessert Sakhar Bhaat Recipe,"Cup Basmati Rice, Cup Ghee, Cup Sugar, Saffron Strands, Tablespoons Mixed Nuts, Tablespoons Raisins, Cups Water, Cardamom Powder, Salt",9,20,20,40,6,Goan Recipes,Dessert,Vegetarian
Bihari Green Peas Bharbhara Recipe,"Green Peas, Gram Flour, Onion, Green Chilli, Ginger, Garam Masala Powder, Black Pepper Powder, Cumin Powder, Coriander, Red Chilli Powder, Salt, Sunflower Oil",12,10,30,40,4,Bihari,Snack,Vegetarian
Kulia Fruit Chaat Recipe,"Fresh Pomegranate Fruit Kernels, Salt, Sugar, Chaat Masala Powder, Lemon Juice, Cucumber, Mint Leaves",7,10,15,25,2,Indian,Snack,Vegetarian
Maharashtrian Style Kairichi Dal Recipe (Chana Dal and Raw Mango Hash),"Chana Dal, Mango, Fresh Coconut, Turmeric Powder, Green Chilli, Coriander, Salt, Mustard Seeds, Asafoetida",9,60,20,80,4,Maharashtrian Recipes,Side Dish,Vegetarian
Bihari Kale Chane Ki Ghugni Recipe,"Kala Chana, Onion, Ginger Garlic Paste, Green Chilli, Cumin Seeds, Bay Leaf, Turmeric Powder, Red Chilli Powder, Coriander Powder, Black Pepper Powder, Cumin Powder, Mustard Oil, Onion, Green Chilli, Fresh Coconut, Cumin Seeds",16,520,60,580,4,Bihari,Dinner,Vegetarian
Chickpea and spinach fritters Recipe,"Kabuli Chana, Spinach Leaves, Corn Flour, Baking Powder, Cumin Seeds, Red Chilli Powder, Onion, Ginger, Salt And Pepper, Sunflower Oil",10,500,35,535,4,Greek,Appetizer,High Protein Vegetarian
Stir Fried Beetroot ,"Chakundar, Mustard, Cumin Seeds, White Urad Dal, Curry Leaves, Asafoetida, Turmeric Powder, Coconut, Oil, Salt, Small Onion, Green Chilli",12,10,30,40,2,Tamil Nadu,Side Dish,Vegetarian
Lauki Bharta Recipe - Spiced & Mashed Bottled Gourd Recipe,"Bottle Gourd, Onion, Tomato, Ginger Garlic Paste, Cumin Seeds, Red Chilli Powder, Turmeric Powder, Garam Masala Powder, Salt, Sunflower Oil, Sugar, Coriander",12,15,30,45,4,Indian,Dinner,Diabetic Friendly
Chicken Manchurian Recipe,"Chicken, Whole Egg, Corn Flour, Salt, Soy Sauce, Sunflower Oil, Corn Flour, Soy Sauce, Red Chilli Sauce, Homemade Tomato Puree, Chilli Vinegar, Water, Garlic, Ginger, Onion, Green Bell Pepper, Green Chilli, Spring Onion Greens",18,15,50,65,4,Indo Chinese,Appetizer,High Protein Non Vegetarian
Mahunada Khaja Recipe - Rose Cookie Recipe,"All Purpose Flour, Rice Flour, Caster Sugar, Cardamom Powder, Sesame Seeds, Milk, Sunflower Oil Cook",7,10,10,20,4,Indian,Snack,Vegetarian
Spicy Tandoori Paneer Open Puff Recipe,"All Purpose Flour, Butter, Salt, Butter, Paneer, Sweet Corn, Onion, Green Bell Pepper, Tomato, Ginger Garlic Paste, Turmeric Powder, Red Chilli Powder, Cumin Powder, Chaat Masala Powder, Lemon Juice, Hung Curd",16,120,35,155,4,French,Snack,Vegetarian
Eggplant Rolls Recipe,"Brinjal, Paneer, Green Bell Pepper, Carrot, Onion, Green Chilli, Garlic, Basil Leaves, Parsley Leaves, Extra Virgin Olive Oil, Black Pepper Powder, Salt, Dried Oregano, Mozzarella Cheese, Tomato Basil Pasta Sauce",15,10,100,110,2,Italian Recipes,Main Course,Vegetarian
Smoked Dhaba Dal Recipe,"Arhar Dal, Green Moong Dal, Onion, Tomato, Garlic, Ginger, Green Chilli, Cumin Powder, Coriander Powder, Red Chilli Powder, Turmeric Powder, Black Salt, Salt, Sunflower Oil, Ghee, Cumin Seeds, Dry Red Chilli, Garlic, Coriander, Charcoal",20,10,40,50,4,Punjabi,Lunch,High Protein Vegetarian
Konkani Style Patholi/Kadabu Recipe-Sweet Dumpling Recipe,"Rice, Fresh Coconut, Poha, Fresh Coconut, Jaggery, Cardamom",6,90,20,110,4,Konkan,Dessert,Vegetarian
Tamil Nadu Style Badam Puri Recipe (Almond Stuffed Whole Wheat Puri Recipe),"Whole Wheat Flour, Sooji, Water Knead, Badam, Palm Jaggery",5,10,20,30,4,Tamil Nadu,Dessert,Vegetarian
Spiced Bottle Gourd And Spinach Juice Recipe,"Bottle Gourd, Spinach Leaves, Cucumber, Ginger, Cumin Seeds, Black Salt, Lemon, Water",8,10,0,10,4,Continental,World Breakfast,Vegetarian
Roasted Pumpkin Rava Dhokla Recipe - Sooji Dhokla,"Kaddu, Sunflower Oil, Sooji, Curd, Salt, Green Chilli, Enos Fruit Salt, Sunflower Oil, Mustard Seeds, Cumin Seeds, Asafoetida, Sesame Seeds, Curry Leaves, Coriander",14,10,20,30,4,Gujarati Recipesï»¿,North Indian Breakfast,Vegetarian
Mambhazam Pulissery Recipe,"Mango, Coconut Oil, Turmeric Powder, Salt, Fresh Coconut, Curd, Cumin Seeds, Green Chilli, Coconut Oil, Mustard Seeds, White Urad Dal, Curry Leaves, Methi Powder, Curry Leaves, Dry Red Chilli",15,15,30,45,4,Kerala Recipes,Lunch,Vegetarian
Carrot & Capsicum Sabzi Recipe - No Onion No Garlic,"Carrots, Green Bell Pepper, Kalonji, Mustard Seeds, Asafoetida, Coriander Powder, Garam Masala Powder, Red Chilli Powder, Amchur, Salt, Sunflower Oil",11,10,25,35,4,North Indian Recipes,Side Dish,Vegetarian
Mexican Chicken Meatball Chilli Stew Recipe,"Onion, Tomato, Green Zucchini, Ginger, Garlic, Rajma, Cumin Powder, Paprika Powder, Black Pepper Powder, Salt, Sunflower Oil, Chicken, Chipotle Chilli  Peppers Dried Red Chilli Will Do, Cumin Powder, Onion, Salt",16,15,45,60,4,Mexican,Dinner,Non Vegeterian
Raw Jackfruit Biryani Recipe - Kathal Biryani,"Jackfruit Raw, Curd, Ginger Garlic Paste, Red Chilli Powder, Turmeric Powder, Garam Masala Powder, Lemon Juice, Salt, Basmati Rice, Sunflower Oil, Onion, Cinnamon Stick, Cardamom, Cloves, Black Cardamom, Star Anise, Bay Leaves, Coriander, Mint Leaves, Green Chilli, Salt, Ghee, Cashew Nuts, Cashew Nuts",24,30,45,75,4,Indian,Lunch,Vegetarian
Kabuli Chana Kofta Biryani Recipe - Chickpea Kofta Biryani,"Kabuli Chana, Onion, Green Chilli, Garlic, Coriander, Mint Leaves, Turmeric Powder, Red Chilli Powder, Fennel Seeds, Salt, Onion, Ginger, Garlic, Homemade Tomato Puree, Red Chilli Powder, Coriander Powder, Garam Masala Powder, Fresh Cream, Salt, Sunflower Oil, Basmati Rice, Bay Leaf, Cloves, Cardamom, Salt, Milk, Saffron Strands, Coriander, Mint Leaves, Ghee",30,20,40,60,4,North Indian Recipes,Main Course,Vegetarian
Curry Fried Quinoa Rice Recipe,"Quinoa, Brown Rice, Carrots, Green Peas, Red Bell Pepper, Curry Leaves, Onion, Extra Virgin Olive Oil, Garlic, Whole Eggs, Curry Powder, Soy Sauce, Brown Sugar, Salt, Black Pepper Powder",15,20,20,40,4,Indian,Lunch,Vegetarian
Paleo Breakfast Casserole Recipe In A Mug,"Whole Eggs, Onion, Green Chilli, Cup Cauliflower, Red Bell Pepper, Yellow Bell Pepper, Red Chilli Flakes, Black Pepper Powder, Salt",9,20,45,65,2,Continental,World Breakfast,Eggetarian
Bihari Style Aloo Ka Chokha Recipe - Spiced & Mashed Potatoes With Mustard Oil,"Potato, Green Chilli, Onion, Red Chilli Powder, Mustard Oil, Salt, Coriander",7,10,45,55,4,Bihari,Lunch,Vegetarian
Palak Paneer Kathi Roll Recipe -High Protein Spinach Cottage Cheese Wraps Recipe,"Whole Wheat Flour, Spinach Leaves, Green Chilli, Cumin Powder, Salt, Sunflower Oil, Paneer, Green Chilli, Garlic  Finely, Onion, Coriander, Tomato, Red Chilli Powder, Garam Masala Powder, Turmeric Powder, Roasted Tomato Pasta Sauce, Mustard Sauce, Salt",18,15,30,45,4,Indian,Snack,Vegetarian
Bangalore Restaurant Style Sambar Recipe - For Idlis,"Cumin Seeds, Coriander, Byadagi Dried Chilli, Guntur Dried Chilli, Fresh Coconut, Arhar Dal, Shallots, Onion, Tomato, Curry Leaves, Mustard Seeds, Turmeric Powder, Asafoetida, Coriander, Tamarind Water, Jaggery, Salt, Sunflower Oil, Coriander",19,15,25,40,5,South Indian Recipes,Side Dish,Vegetarian
Aloo Bhindi Masala Gravy Recipe,"Bhindi, Ssp Asafoetida, Mustard Oil, Salt, Potato, Asafoetida, Cumin, Turmeric Powder, Salt, Mustard Oil, Onion, Garlic, Ginger, Tomato, Cinnamon Stick, Bay Leaf, Turmeric Powder, Red Chilli Powder, Coriander Powder, Water, Salt, Sunflower Oil, Kasuri Methi, Coriander",24,15,20,35,4,North Indian Recipes,Lunch,Vegetarian
Chocolate Salted Caramel Tart Recipe,"All Purpose Flour, Sugar, Butter, Whole Egg, Water, Sugar, Water, Salted Butter, Heavy Whipping Cream, Heavy Whipping Cream, Dark Chocolate, Sea Salt",12,60,45,105,4,French,Dessert,Vegetarian
Spicy Babycorn Satay Recipe,"Baby Corn, Sunflower Oil, Curd, Corn Flour, Turmeric Powder, Red Chilli Powder, Clove Garlic, Ajwain, Garam Masala Powder, Salt",10,10,30,40,4,Asian,Appetizer,Vegetarian
Khatte Chole Recipe - A Delicious North Indian Chana Masala,"Kabuli Chana, Onion, Tomato, Cinnamon Stick, Cloves, Ginger, Ajwain, Coriander Powder, Red Chilli Powder, Garam Masala Powder, Amchur, Ghee, Salt, Onion, Green Chilli",15,60,30,90,4,North Indian Recipes,Lunch,Vegetarian
Besan Capsicum Ki Sabzi Recipe,"Sunflower Oil, Gram Flour, Onion, Red Bell Pepper, Yellow Bell Pepper, Red Chilli Powder, Turmeric Powder, Water, Coriander",9,10,40,50,4,Rajasthani,Lunch,Vegetarian
Pan Fried Broccoli Pakora Recipe,"Broccoli, Onion, Gram Flour, Fennel Seeds, Chaat Masala Powder, Salt, Sunflower Oil",7,5,30,35,4,North Indian Recipes,Snack,Vegetarian
Kerala Style Varutharacha Mutton Curry Recipe,"Mutton, Shallots, Tomato, Curry Leaves, Green Chilli, Cumin Seeds, Turmeric Powder, Red Chilli Powder, Fresh Coconut, Salt, Coconut Oil, Coriander, Dry Red Chilli, Garlic, Ginger, Cumin Seeds, Fennel Seeds, Whole Black Peppercorns, Cinnamon Stick, Cloves, Cardamom Powder, Curry Leaves, Fresh Coconut, Shallots, Coconut Oil",25,15,30,45,3,Kerala Recipes,Side Dish,Non Vegeterian
Nagaland Style Pumpkin Oambal Recipe,"Kaddu, Tamarind, Water, Sunflower Oil, Dry Red Chilli, Mustard Seeds, Green Chilli, Raisins, Jaggery, Salt",10,15,10,25,3,Nagaland,Side Dish,Vegetarian
Bottle Gourd Peel Chutney Recipe,"Cup Bottle Gourd, Tomato, Green Chilli, Salt, Turmeric Powder, Sunflower Oil, Mustard Seeds, Methi Seeds, White Urad Dal, Dry Red Chilli, Asafoetida, Coriander, Tamarind Paste",13,10,15,25,6,South Indian Recipes,Side Dish,Vegetarian
Mooga Gathi (Sprouted Moong In Coconut Paste) Recipe,"Green Moong Sprouts, Fresh Coconut, Whole Black Peppercorns, Dry Red Chilli, Coriander, Turmeric Powder, Tamarind, Mustard Seeds, Curry Leaves, Asafoetida, Jaggery, Sunflower Oil",12,540,40,580,4,Goan Recipes,Lunch,High Protein Vegetarian
Maharashtrian Green Moong Bhat Recipe - Sprouted Green Moong Pulao,"Cooked Rice, Green Moong Sprouts, Cumin Seeds, Cinnamon Stick, Cloves, Cardamom, Asafoetida, Onion, Green Bell Peppers, Green Chilli, Ginger, Garlic, Red Chilli Powder, Turmeric Powder, Coriander Powder, Coriander",16,10,30,40,4,Maharashtrian Recipes,Lunch,Vegetarian
Glazed Apples and Banana Wheat Crumb Tart Recipe,"Marie Biscuit, Wheat Flakes, Butter, Apples, Ripe Bananas, Nutmeg Powder, Slivered Almonds, Honey, Hung Curd, Sage",10,60,10,70,4,Continental,Dessert,Sugar Free Diet
Shimla Mirchi Panchamrut Recipe | Konkani Capsicum Cashew Peanut Sabzi,"Green Bell Pepper, Raw Peanuts, Cashew Nuts, Coconut Oil, Mustard Seeds, Methi Seeds, Asafoetida, Turmeric Powder, Red Chilli Powder, Jaggery, Cloves, Cinnamon Stick, Coriander, Cumin Seeds, Whole Black Pepper Corns, Methi Seeds, Fresh Coconut, Roasted Peanuts, Tamarind",19,20,20,40,4,Konkan,Main Course,Vegetarian
Bhey Vangan Saag Recipe - Sindhi Style Lotus Stem Spinach Brinjal Sabzi,"Spinach Leaves, Brinjal, Lotus Stem, Potato, Ginger, Tomato, Green Chilli, Salt, Red Chilli Powder, Coriander Powder, Garam Masala Powder, Cumin Powder, Turmeric Powder, Salt, Sunflower Oil, Cumin Seeds",16,30,30,60,6,Sindhi,Main Course,Vegetarian
Savoury Carrot And Coriander Pancakes Recipe,"Oats Flour, Carrots, Paneer, Coriander, Buttermilk, Green Chilli, Ginger, Baking Powder, Butter Make Pancakes, Salt",10,10,20,30,2,Indian,Snack,Vegetarian
Idli Tikka Recipe With Sambar,"Idli Dosa Batter, Sunflower Oil, Mustard Seeds, White Urad Dal, Curry Leaves, Salt, Green Bell Pepper, Yellow Bell Pepper, Red Bell Pepper, Salt, Sunflower Oil Saute Veggies, Arhar Dal, Tamarind Water, Turmeric Powder, Sambar Powder, Pearl Onion, Bottle Gourd, Drumstick, Tomato, Sunflower Oil, Mustard Seeds, Curry Leaves, Bay Leaf, Kashmiri Dry Red Chilli",24,20,30,50,2,Fusion,Indian Breakfast,Vegetarian
Indo Chinese Prawn And Chicken Fried Rice Recipe,"Rice, Prawns, Chicken, Water, Onion, Cloves Garlic, Fresh Red Chilli, Dark Soy Sauce, Sunflower Oil, Green Peas, Fish Sauce, Spring Onion Greens, Whole Eggs, Salt And Pepper",14,20,15,35,2,Thai,Dinner,Non Vegeterian
Easy Spaghetti Recipe In Creamy Tomato Sauce  | Vegetarian & Kid Friendly,"Del Monte Spaghetti Pasta, Carrot, Green Bell Pepper, Dried Oregano, Red Chilli Flakes, Fresh Cream, Salt, Extra Virgin Olive Oil, Tomato, Garlic, Onion, Basil Leaves, Extra Virgin Olive Oil, Salt And Pepper",14,10,30,40,4,Italian Recipes,Dinner,Vegetarian
Moong Dal With Radish Greens Recipe,"Yellow Moong Dal, Mooli Ke Patte, Salt, Garlic, Ginger, Turmeric Powder, Red Chilli Powder, Amchur, Sunflower Oil, Ghee, Cumin Seeds, Dry Red Chilli",12,21,30,51,4,Indian,Side Dish,High Protein Vegetarian
Brownie Butter Cake Recipe,"Dark Chocolate, Butter, Sugar, Whole Egg, All Purpose Flour, Instant Coffee Powder, All Purpose Flour, Baking Powder, Sugar, Butter, Whole Eggs, Milk, Vanilla Extract, Pink Food Colour",14,25,60,85,4,Continental,Dessert,Eggetarian
Chopped Spinach And Pomegranate Salad Recipe,"Spinach, Fresh Pomegranate Fruit Kernels, Onion, Pecans Walnuts, Extra Virgin Olive Oil, Vinegar, Dried Oregano, Parsley Leaves, Salt And Pepper",9,15,0,15,4,Continental,Side Dish,Vegetarian
Hariyali Chicken Tikka Masala Recipe,"Chicken Breasts, Red Chilli Powder, Turmeric Powder, Garam Masala Powder, Amchur, Cumin Powder, Curd, Fresh Cream, Salt, Coriander, Mint Leaves, Green Chilli",12,80,30,110,4,North Indian Recipes,Lunch,Non Vegeterian
Vermicelli Kunafa Recipe With Paneer & Cream Filling,"Semiya, Butter, Milk, Paneer, Corn Flour, Custard Powder, All Purpose Flour, Condensed Milk, Sugar, Cardamom, Almond Essence, Kewra Essence, Mixed Nuts, Water, Sugar, Honey, Rose Water, Lemon Juice",18,30,45,75,6,Fusion,Dessert,Vegetarian
Chena Kaya Erissery Recipe,"Elephant Yam, Raw Banana, Turmeric Powder, Kashmiri Red Chilli Powder, Black Pepper Powder, Coconut Oil, Salt, Fresh Coconut, Cumin Seeds, Water, Fresh Coconut, Coconut Oil, Cumin Seeds, Mustard Seeds, Turmeric Powder, Red Chilli Powder, Dry Red Chilli, Curry Leaves",18,10,25,35,4,Kerala Recipes,Lunch,Vegetarian
Meen Peera (Kerala Style Fish Recipe With Shredded Coconut),"Sardine Fish, Fresh Coconut, Shallots, Green Chilli, Dry Red Chilli, Ginger, Clove Garlic, Methi Powder, Turmeric Powder, Coconut Oil, Curry Leaves, Kokum, Kokum, Salt",14,10,30,40,4,Kerala Recipes,Dinner,High Protein Non Vegetarian
Green Moong Dal Cheela Recipe - Savory Green Mung Bean Pancakes,"Green Moong Dal, Rice Flour, Coriander, Green Chilli, Ginger, Garlic, Water, Salt, Red Chilli Powder, Garam Masala Powder, Flax Seed Powder, Sunflower Oil",12,7,30,37,4,North Indian Recipes,North Indian Breakfast,Diabetic Friendly
Karela Thepla Recipe - Bitter Gourd Indian Flat Bread,"Whole Wheat Flour, Gram Flour, Karela, Ajwain, Ginger, Green Chilli, Salt, Red Chilli Powder, Cumin Powder, Turmeric Powder, Ghee Oil, Lukewarm Water, Butter",13,25,25,50,4,Indian,Lunch,Diabetic Friendly
Lavender Lemonade Cooler Recipe,"Water, Sugar, Lavender Flowers, Lemon Juice, Salt, Sugar, , Few Ice Cubes",8,10,20,30,4,Continental,Vegetarian,Diabetic Friendly
Roasted Vegetable Panini Sandwich With Feta Cheese Recipe,"Panini Bread, Green Zucchini   Into Thick Slices, Red Bell Pepper, Tomato, Red Onion, Feta Cheese, Homemade Basil Pesto, Tabasco Original  Hot Sauce, Salt And Pepper",9,20,28,48,3,Continental,Main Course,Vegetarian
Thavala Adai Recipe,"Chana Dal, Arhar Dal, Rice, White Urad Dal, Dry Red Chilli, Gingelly Oil, Asafoetida, Curry Leaves, Mustard Seeds",9,10,30,40,4,South Indian Recipes,Appetizer,Vegetarian
Achari Paneer Mini Bread Bowl With Cheesy Twist Recipe,"Soup Buns, Paneer, Onion, Tomato, Green Bell Pepper, Green Chilli, Extra Virgin Olive Oil, Ginger Garlic Paste, Red Chilli Powder, Coriander Powder, Achari Masala, Kasuri Methi, Garam Masala Powder, Salt, Mozzarella Cheese, Cheese Spread",16,10,20,30,4,Indian,Appetizer,High Protein Vegetarian
Karnataka Style Alugadde and Mentye Pakoda Recipe (Potato and fenugreek leaves fritters),"Methi Leaves, Potato, Gram Flour, Cumin Seeds, Red Chilli Powder, Coriander Powder",6,10,20,30,4,Karnataka,Snack,Vegetarian
Kori Gassi Recipe - Mangalorean Traditional Chicken Curry With Coconut Milk,"Onion, Garlic, Byadagi Dried Chilli, Coriander, Cumin Seeds, Methi Seeds, Whole Black Peppercorns, Tamarind, Fresh Coconut, Ghee, Chicken, Onion, Salt, Turmeric Powder, Coconut Milk, Coconut Milk, Ghee, Cinnamon Stick, Cloves, Cardamom, Curry Leaves",21,20,40,60,6,Mangalorean,Dinner,Non Vegeterian
Kale And Vegetable Fried Quinoa Recipe,"Quinoa, Onion, Celery, Kale, Carrots, Green Peas, Garlic, Extra Virgin Olive Oil, Salt",9,10,30,40,4,North Indian Recipes,Indian Breakfast,Vegetarian
Sweet & Spicy Raw Papaya Moongphali Ki Sabzi Recipe,"Raw Papaya, Mustard Seeds, Fennel Seeds, Onion, Ginger, Garlic, Red Chilli Powder, Turmeric Powder, Garam Masala Powder, Amchur, Jaggery, Raw Peanuts, Salt, Sunflower Oil",14,10,30,40,4,Rajasthani,Side Dish,Vegetarian
Chenakayi Erissery Recipe - Yam Erissery,"Elephant Yam, Turmeric Powder, Salt, Fresh Coconut, Green Chilli, Cumin Seeds, Whole Black Peppercorns, Coconut Oil, Mustard Seeds, Curry Leaves",10,15,15,30,4,Kerala Recipes,Side Dish,Vegetarian
Goan Style Chicken Galinha Cafreal Recipe,"Chicken Drumstick, Onion, Salt, Onion, Coriander, Coriander, Cumin Seeds, Garam Masala Powder, Black Pepper Powder, Lemon Juice, Green Chilli, Ginger, Garlic",13,60,45,105,4,Goan Recipes,Lunch,Non Vegeterian
Delicious Paneer Satay Recipe With Tandoori Mayo Recipe,"Paneer, Del Monte Mint Mayo, Raw Peanuts, Lemon Juice, Extra Virgin Olive Oil, Salt",6,30,15,45,4,Continental,Appetizer,Non Vegeterian
Makai Ka Cheela Recipe - Delicious Corn Cheela Recipe,"Sweet Corn, Gram Flour, Onion, Green Chilli, Ginger, Coriander, Sunflower Oil, Salt",8,10,20,30,4,North Indian Recipes,North Indian Breakfast,Vegetarian
Mooli Jowar Ki Roti Recipe - Mullangi Kambu Chapathi,"Mooli Mullangi, Jowar Flour, Ginger Garlic Paste, Red Chilli Powder, Salt, Sunflower Oil, Hot Water",7,15,20,35,4,North Indian Recipes,Lunch,Vegetarian
Arabian Chicken Mandi Recipe -Yemeni Style Rice & Chicken,"Chicken, Onion, Tomato, Green Chilli, Ginger Garlic Paste, Bay Leaves, Ghee, Cardamom, Cloves, Cinnamon Stick, Whole Black Peppercorns, Extra Virgin Olive Oil, Butter, Salt, Basmati Rice, Water, Cardamom, Cloves, Whole Black Peppercorns, Nutmeg Powder, Dry Ginger Powder, Bay Leaves",22,30,90,120,4,Middle Eastern,Lunch,Non Vegeterian
Mini Lemon Tarts Recipe,"All Purpose Flour, Salt, Sugar, Chilled Butter, Chilled Water, Whole Egg, Egg Yolks, Caster Sugar, Lemon Zest, Lemon Juice, Butter",11,120,25,145,4,Continental,Dessert,Eggetarian
Bengali Sukto Recipe - Mixed Vegetable Curry,"Karela, Sweet Potato, Brinjal, Kaddu, Drumstick, Raw Papaya, Ridge Gourd, Badi, Plantain Stem, Mustard Seeds, Poppy Seeds, Sugar, Milk, Turmeric Powder, Cumin Powder, Methi Seeds, Dry Red Chilli, Bay Leaf, Ginger, Ghee, Mustard Oil, Salt",22,20,35,55,4,Bengali Recipes,Lunch,Vegetarian
Mexican Chicken Tostadas Recipe,"Corn Flour Tortilla, Chicken Breasts, Sunflower Oil, Red Chilli Powder, Coriander Powder, Garam Masala Powder, Salt, Lemon Juice, Cabbage, Sour Cream, Coriander",11,10,25,35,4,Mexican,Appetizer,Non Vegeterian
Achari Chole Aloo Tikki Chaat Recipe,"Kabuli Chana, Cumin Seeds, Ginger, Tomato, Bay Leaf, Nutralite Classic Spread, Turmeric Powder, Amchur, Garam Masala Powder, Coriander Powder, Anardana Powder, Kashmiri Red Chilli Powder, Black Pepper Powder, Black Salt, Green Chutney, Sweet Chutney, Onion, Green Chilli, Coriander, Sev, Potato, Ginger, Green Chilli, Onion, Red Chilli Powder, Garam Masala Powder, Coriander, Corn Flour, Salt, Achari Mayo, Whole Wheat Bread Crumbs, Nutralite Garlic & Oregano Spread",32,15,45,60,4,Indian,Snack,Vegetarian
Tomato Rasam Recipe For Babies And Toddlers,"Tomato, Turmeric Powder, Yellow Moong Dal, Cumin Powder, Coriander Powder, Black Pepper Powder, Salt, Ghee, Mustard Seeds, Coriander",10,5,15,20,4,South Indian Recipes,Lunch,Vegetarian
Crispy Fried Kurkuri Bhindi Recipe Spiced With Cumin & Chaat Masala,"Bhindi, Coriander Powder, Red Chilli Powder, Kashmiri Red Chilli Powder, Turmeric Powder, Cumin Powder, Chaat Masala Powder, Asafoetida, Salt, Gram Flour, Rice Flour, Curry Leaves, Sunflower Oil",13,10,15,25,4,Indian,Side Dish,Vegetarian
Rajma Cutlet (Kidney Beans Patties) Recipe,"Rajma, Potato, Red Chilli Powder, Garam Masala Powder, Salt, Fennel Powder, All Purpose Flour, Whole Wheat Bread Crumbs, Sunflower Oil",9,40,20,60,4,Indian,Snack,Vegetarian
Salted Caramel Popcorn Recipe,"Sunflower Oil, Dry Corn Kernals, Butter, Corn Syrup, Sugar, Vanilla Extract, Salt, Baking Soda",8,10,20,30,4,Indian,Snack,Vegetarian
Raw Papitha No Sambharo Recipe,"Sunflower Oil, Mustard Seeds, Cumin Seeds, Asafoetida, Turmeric Powder, Green Chilli, Raw Papaya, Salt",8,10,20,30,4,Gujarati Recipesï»¿,North Indian Breakfast,Diabetic Friendly
Vegetarian Momo Recipe-Steamed Dumplings/A Street Food from the North East India,"Cabbage, Carrots, Onion, Ginger, Salt, Sunflower Oil, All Purpose Flour, Water",8,15,30,45,4,North East India Recipes,Appetizer,Vegetarian
Capsicum Bath Recipe,"Rice, Green Bell Pepper, Fistful Green Peas, Onion, Green Chilli, Vangi Bath Powder, Salt, Tamarind, Lemon Juice, Dry Coconut, Sunflower Oil, Mustard Seeds, Chana Dal, White Urad Dal, Few Cashew Nuts, Few Curry Leaves, Dry Red Chilli, Turmeric Powder",18,15,10,25,4,Indian,Lunch,Vegetarian
Watermelon Seeds Rice Recipe,"Basmati Rice, Watermelon Seeds, Dry Red Chilli, Mustard Seeds, White Urad Dal, Curry Leaves, Raw Peanuts, Asafoetida, Salt, Sunflower Oil",10,20,30,50,4,Indian,Lunch,Vegetarian
Classic Andhra Style Chicken Curry Recipe,"Chicken, Red Chilli Powder, Turmeric Powder, Salt, Ginger, Garlic, Cinnamon Stick, Cloves, Cardamom, Poppy Seeds, Dry Coconut, Hot Water, Sunflower Oil, Cinnamon Stick, Cloves, Cardamom, Bay Leaf, Onion, Green Chilli, Curry Leaves, Red Chilli Powder, Turmeric Powder, Salt, Garam Masala Powder, Coriander",25,10,60,70,4,Andhra,Dinner,High Protein Non Vegetarian
Moroccan Lentil Stew Recipe With Raisins,"Extra Virgin Olive Oil, Onion, Ginger, Stalk Celery, Carrot, Sweet Potato, Homemade Tomato Puree, Vegetable Stock, Lukewarm Water, Green Moong Dal, Raisins, Salt, Lemon Wedges, Coriander, Cinnamon Stick, Paprika Powder, Turmeric Powder, Garlic Powder, Cumin Seeds, Cloves, Coriander Powder, White Pepper Powder, Salt",23,15,30,45,4,African,Main Course,High Protein Vegetarian
Phool Mathri Recipe,"All Purpose Flour, Ghee, Ajwain, Salt, Lukewarm Water, Sunflower Oil",6,30,15,45,5,Indian,Snack,Vegetarian
Homemade Multigrain Baby Cereal Recipe (Baby Porridge),"Brown Rice, Instant Oats, Ragi Seeds, Barley",4,10,30,40,2,Indian,Lunch,Vegetarian
Palak Patta Chaat Recipe-Delhi style Spinach leaf Chaat,"Spinach Leaves, Enos Fruit Salt, Gram Flour, Salt, Green Chutney, Sweet Chutney, Lahsun Ki Chutney, Sev Garnish, Onion, Curd, Potato, Carrot, Red Chilli Powder Sprinkle, Cumin Powder, Chaat Masala Powder Sprinkle",15,10,10,20,2,North Indian Recipes,Appetizer,Vegetarian
Konkani Style Kadgi Chakko Recipe - Raw Jackfruit With Coconut,"Jackfruit Raw, Coriander, White Urad Dal, Coconut Oil, Fresh Coconut, Dry Red Chilli, Tamarind Paste A Marble Sized Tamarind, Jaggery, Curry Leaves, Salt",10,20,20,40,4,Konkan,Side Dish,Vegetarian
Spicy Grilled Pineapple Salsa Recipe,"Pineapple, Onion, Tomato, Pickled Jalapenos Green Chili, Garlic, Cumin Powder, Red Chilli Powder, Lemon Juice, Coriander, Salt",10,10,15,25,4,Mexican,Side Dish,Vegetarian
Hariyali Gobi Recipe - Palak Cauliflower Curry Recipe,"Cauliflower, Turmeric Powder, Garam Masala Powder, Salt, Spinach, Tomato, Garlic, Ginger, Green Chilli, Cumin Seeds, Cinnamon Powder, Cumin Powder, Turmeric Powder, Garam Masala Powder, Fresh Cream, Butter, Salt",17,20,25,45,4,North Indian Recipes,Lunch,Diabetic Friendly
Motichoor Modak Recipe,"Gram Flour, Salt, Orange Color, Ghee, Baking Soda, Water, Sunflower Oil, Sugar, Water, Saffron Strands, Cardamom Powder, Salt, Rose Water, Melon Seeds, Badam, Ghee",16,15,45,60,10,Indian,Dessert,Vegetarian
Royyala Kura Recipe (Andhra Style Prawn Curry),"Prawns, Bay Leaves, Cardamom, Cloves, Ajwain, Onion, Ginger Garlic Paste, Curry Leaves, Coriander Powder, Red Chilli Powder, Salt, Turmeric Powder, Garam Masala Powder, Tomato, Sunflower Oil",15,15,15,30,2,Andhra,Dinner,Non Vegeterian
"Macaroni Minestrone Soup Pot Recipe (Wholesome Italian Soup Made Using Vegetables, Beans And Macaroni)","Extra Virgin Olive Oil, Onion, Garlic, Carrot, Green Peas, Sweet Corn, Green Beans, Celery, Green Zucchini, Button Mushrooms, Yellow Bell Pepper, Canned Beans, Homemade Tomato Puree, Black Pepper Powder, Paprika Powder, Macaroni Pasta, Vegetable Stock, Bay Leaf, Sugar, Salt, Mixed Herbs, Parmesan Cheese",22,10,35,45,2,Italian Recipes,Side Dish,Vegetarian
Shakarkandi Malpua Recipe - Mishti Aloo Malpua Recipe,"Sweet Potato, Milk Powder, All Purpose Flour, Sugar, Sooji, Fennel Seeds, Cardamom Powder, Sugar, Water, Rose Water, Sunflower Oil Ghee, Pistachios",12,30,40,70,6,North Indian Recipes,Dessert,Vegetarian
Figs and Muesli Bread Pudding Recipe,"Muesli, Fresh Figs, Whole Wheat Brown Bread, Whole Eggs, Milk, Vanilla Extract, Honey, Nutmeg Powder",8,25,25,50,2,Continental,Dessert,Sugar Free Diet
Eggless Peanut Butter Cookies Recipe,"Peanut Butter, All Purpose Flour, Sugar, Baking Powder, Baking Soda, Milk",6,20,50,70,4,Continental,Snack,Vegetarian
Mulakootal (Vegetables In Coconut Gravy) Recipe,"Mixed Vegetables, Arhar Dal, Turmeric Powder, Fresh Coconut, White Urad Dal, Mustard Seeds, Dry Red Chilli, Cumin Seeds, Coconut Oil, Mustard Seeds, Dry Red Chilli, Curry Leaves",12,15,30,45,4,South Indian Recipes,Lunch,Vegetarian
Manga Rasam Recipe - Raw Mango Rasam Recipe,"Mango, Water, Arhar Dal, Ghee, Mustard Seeds, Cumin Seeds, Curry Leaves, Green Chilli, Asafoetida, Ginger, Tomato, Cumin Powder, Lemon Juice, Black Pepper Powder, Turmeric Powder, Coriander Powder, Jaggery, Salt, Coriander",19,10,30,40,4,South Indian Recipes,Lunch,Vegetarian
Oriya Special Dalma Recipe - Lentils Cooked With Vegetables & Raw Papaya,"Arhar Dal, Potato, Carrot, Kaddu, Brinjal, Papaya, Onion, Tomato, Ginger, Bay Leaf, Ghee, Garlic, Green Chilli, Dry Red Chilli, Panch Phoran Masala, Garam Masala Powder, Turmeric Powder, Cumin Powder, Red Chilli Powder, Salt, Fresh Coconut, Coriander",22,33,40,73,2,Oriya Recipes,Lunch,High Protein Vegetarian
Tamil Nadu Style Pala Kottai Sambar Recipe - Mangalore Cucumber & Jackfruit Seed Sambar,"Mangalorean Cucumber, Jackfruit Seeds, Arhar Dal, Tamarind Water, Green Chilli Paste, Turmeric Powder, Salt, Sunflower Oil, Fresh Coconut, Sambar Powder",10,10,45,55,4,Tamil Nadu,Main Course,Vegetarian
Mango Kheer Recipe,"Mango Pulp, Milk, Semiya, Ghee, Cardamom Powder, Sugar, Slivered Almonds, Raisins, Saffron Strands",9,20,30,50,4,North Indian Recipes,Dessert,Vegetarian
Anar & Aloo Pakora Recipe - Dry Pomegranate & Potato Pakora,"Potato, Green Chilli, Coriander, Anardana Powder, Red Chilli Powder, Cumin Seeds, Salt, Chaat Masala Powder, Gram Flour, Sunflower Oil",10,30,15,45,5,North Indian Recipes,Snack,Vegetarian
Goan Prawns Balchao Recipe (Prawns Pickle),"Prawns, Onion, Garlic, Turmeric Powder, Salt, Lemon, Tamarind Paste, Asafoetida, Whole Black Peppercorns, Mustard Seeds",10,20,30,50,5,Goan Recipes,Appetizer,Non Vegeterian
Kale Apple Salad Recipe,"Apple, Kale, Badam, Chia Seeds, Dijon Mustard, Honey, Salt",7,15,0,15,2,Continental,Lunch,Vegetarian
Egg Biryani Recipe With Coconut Milk,"Rice, Whole Eggs, Bay Leaf, Cardamom, Cloves, Green Chilli, Whole Black Peppercorns, Onion, Tomato, Garlic, Ginger, Turmeric Powder, Red Chilli Powder, Cumin Powder, Coriander Powder, Garam Masala Powder, Coconut Milk, Water, Salt, Coriander, Mint Leaves",21,30,90,120,2,Indian,Lunch,Eggetarian
Halli Style Mutton Saaru Recipe - South Indian Mutton Curry,"Mutton, Onion, Sunflower Oil, Curry Leaves, Fresh Coconut, Tomato, Coriander, Green Chilli, Dry Red Chilli, Ginger, Garlic, Poppy Seeds, Roasted Gram Dal, Sambar Powder, Salt",15,15,25,40,4,Karnataka,Main Course,Non Vegeterian
Murungai Keerai Paruppu Usili Recipe - Drumstick Leaves & Toor Dal,"Drumstick Leaves, Mustard Seeds, Dry Red Chilli, Asafoetida, Sunflower Oil, Salt, Arhar Dal, Fennel Seeds, Dry Red Chilli, Salt",10,10,20,30,4,Tamil Nadu,Side Dish,Diabetic Friendly
Cucumber Mor Kuzhambu Recipe (Cucumber Curry),"Cucumber, Fresh Coconut, Ginger, Mustard Seeds, Green Chilli, Turmeric Powder, Coriander, Hung Curd, Salt",9,15,20,35,4,South Indian Recipes,Lunch,Vegetarian
Mini Key Lime Pie Recipe (No Bake And Eggless),"Marie Biscuit, Butter, Heavy Whipping Cream, Condensed Milk, Lemon Juice, Lemon Juice, Water, Sugar, Green Food Colour",9,45,0,45,4,Continental,Dessert,Vegetarian
Kesar-Pista White Chocolate Truffles Recipe,"White Chocolate, Double Cream, Butter, Saffron Strands, Nutmeg, Badam, Edible Silver Foilleaf",7,40,20,60,4,Fusion,Dessert,Vegetarian
Andhra Style Beerakaya Pappu Recipe (Ridge Gourd Dal Recipe),"Ridge Gourd, Arhar Dal, Yellow Moong Dal, Masoor Dal, Onion, Tomato, Green Chilli, Ginger Garlic Paste, Turmeric Powder, Red Chilli Powder, Salt, Tamarind Water, Mustard Seeds, Cumin Seeds, Garlic, Curry Leaves, Asafoetida, Dry Red Chilli, Sunflower Oil",19,5,25,30,4,Andhra,Lunch,Vegetarian
Dates Chocolate & Nut Balls Recipe (Energy Balls),"Dates, Cashew Nuts, Badam, Pistachios, Cocoa Powder, Sesame Seeds, Ghee",7,10,30,40,2,Continental,Snack,Vegetarian
Sorakkai Kozhukattai Paal Kuzhambu Recipe - Bottle Gourd Curry,"Bottle Gourd, Rice Flour, Chana Dal, Fresh Coconut, Milk, Mustard Seeds, White Urad Dal, Dry Red Chilli, Sugar, Sunflower Oil, Salt, Water",12,15,35,50,4,Tamil Nadu,Lunch,Vegetarian
Tea Spiced Nuts Recipe (Skillet Roasted),"Badam, Cashew Nuts, Walnuts, Pecans, Tea Leaves, Dried Rose Petals, Honey, Cinnamon Powder, Vanilla Extract, Black Pepper Powder, Paprika Powder, Sea Salt, Butter",13,5,10,15,4,Indian,Snack,Vegetarian
Turmeric Milk Recipe - Haldi Doodh / Golden Milk,"Fresh Turmeric Root, Milk, Honey Sugar, Black Pepper Powder",4,10,5,15,1,Indian,Snack,Vegetarian
Sweet And Sour Vegetables Recipe,"Cauliflower, Carrots, Baby Corn, Green Bell Pepper, Onion, Garlic, Spring Onion Greens, Salt And Pepper, Tomato Ketchup, Red Chilli Sauce, Soy Sauce, Vinegar, Soy Sauce, Corn Flour",14,20,30,50,4,Indo Chinese,Main Course,Vegetarian
Turai Baingan Ki Sabzi Recipe - Eggplant Ridge Gourd Sabzi,"Small Brinjal, Ridge Gourd, Onion, Garlic, Tomato, Jaggery, Turmeric Powder, Amchur, Dhansak Masala, Salt",10,10,45,55,4,Parsi Recipes,Lunch,Vegetarian
Vegetarian Thukpa Recipe,"Mustard Oil, Spring Onion, Garlic, Tomato, Cumin Powder, Garam Masala Powder, Whole Black Peppercorns, Spinach Leaves, Mooli Mullangi, Coriander, Lemon Juice, Whole Wheat Flour, Whole Eggs, Salt",14,20,40,60,4,Lunch,Vegetarian,Vegetarian
Chinese Vegetarian Fried Rice With Apples Recipe,"Basmati Rice, Apples, Red Yellowgreen Bell Pepper, Cashew Nuts, Raisins, Sugar, Ginger, Soy Sauce, Black Pepper Powder, Sunflower Oil, Water, Salt",12,35,15,50,4,Chinese,Dinner,Vegetarian
Vaangi Bhaat Recipe (Maharashtrian Style Brinjal Rice),"Brinjal, Rice, Asafoetida, Salt, Sunflower Oil, Mustard Seeds, Turmeric Powder, Coriander, Cloves, Whole Black Peppercorns, Cinnamon Stick, Dry Coconut, Dry Red Chilli, Coriander, Cumin Seeds",15,20,30,50,4,Maharashtrian Recipes,Lunch,Vegetarian
Cauliflower And Red Bell Pepper Stir Fry Recipe,"Cauliflower, Red Bell Pepper, Coriander Powder, Red Chilli Powder, Turmeric Powder, Garam Masala Powder, Kasuri Methi, Sunflower Oil, Salt",9,10,20,30,4,South Indian Recipes,Lunch,Vegetarian
Nutella Pancakes Recipe,"Nutella Spread, All Purpose Flour, Baking Powder, Sugar, Salt, Whole Egg, Milk, Vanilla Extract, Butter, Strawberries",10,30,20,50,4,Continental,World Breakfast,Vegetarian
Roasted Vegetable Farfalle Pasta Salad Recipe,"Del Monte Farfalle Pasta, Carrot, Green Beans, Red Bell Pepper, Asparagus, Green Peas, Basil Leaves, Dried Oregano, Extra Virgin Olive Oil, Salt, Tomato, Onion, Garlic, Salt And Pepper, Paprika Powder, Sugar",16,10,15,25,4,Italian Recipes,Dinner,Vegetarian
Black Forest Cupcake Recipe,"Vivatta Maida, Sugar, Cocoa Powder, Butter, Milk, Whole Eggs, Baking Powder, Baking Soda, Pitted Cherries, Vanilla Extract, Britannia Cream Cheese, Sour Cream, Icing Sugar, Fresh Cherries, Britannia Cream Cheese, Chocolate Bar",16,15,30,45,4,Indian,Dessert,Vegetarian
Papad Nachos With Salsa Recipe,"Papads, Onion, Tomato, Garlic, Cheddar Cheese, Coriander, Red Chilli Powder Chilli Flakes, Dried Oregano, Lemon Juice, Dried Oregano Mexican Spice Mix, Salt",11,10,10,20,4,Fusion,Appetizer,Vegetarian
French GÃ¢teaux Recipe (Layered Fruit and Cream Cake),"Butter, Sugar, Flaxmeal Egg Replacer Eggs, Vivatta Maida  Plus More For Pan, Almond Meal, Salt, Baking Powder, Milk, Lemon Juice, Vanilla Extract, Heavy Whipping Cream, Mascarpone Cheese, Caster Sugar, Vanilla Extract, Sugar, Water, Fresh Orange Juice, Kiwi, Oranges, Pineapple, Fresh Cherries, Slivered Almonds",22,25,100,125,6,French,Dessert,Eggetarian
Manga Ogre Recipe (Mango Rice),"Cooked Rice, Salt, Mango, Fresh Coconut, Mustard Seeds, Green Chilli, Turmeric Powder, Coriander, Jaggery, Sunflower Oil, Curry Leaves, Cumin Seeds, Mustard Seeds, Chana Dal, Asafoetida",15,20,60,80,4,Indian,Lunch,Vegetarian
Spring Onion Pakora Recipe - Made In Kuzhi Paniyaram Pan,"Stalks Spring Onion, Cup Gram Flour, Cup Rice Flour, Green Chilli, Mint Leaves, Red Chilli Powder, Coriander, Turmeric Powder, Enos Fruit Salt, Salt, Sunflower Oil Make The Pakoras",11,15,15,30,4,Indian,Snack,Vegetarian
Sweet Pongal With Thai Jasmine Rice And Palm Sugar Recipe,"Thai Jasmine Rice, Cardamom, Palm Sugar  Powdered, Yellow Moong Dal, Water, Milk, Cashew Nuts, Raisins, Ghee, Kesar Milk Masala, Saffron Strands",11,10,75,85,4,South Indian Recipes,Dessert,Vegetarian
Pepper Cauliflower Recipe,"Cauliflower, Onion, Garlic, Black Pepper Powder, Cumin Powder, Red Chilli Powder, Coriander, Salt, Mustard Seeds, Curry Leaves, Black Urad Dal, Dry Red Chilli, Sunflower Oil",13,10,20,30,4,Indian,Dinner,Vegetarian
Hare Chane Ka Kebab Recipe,"Hara Chana, Ginger Garlic Paste, Cumin Powder, Turmeric Powder, Garam Masala Powder, Green Chilli, Mango, Spinach, Mint Leaves, Coriander, Gram Flour, Salt",12,40,20,60,4,Indian,Snack,Vegetarian
Savory Bread Pudding with Broccoli and Tomato Recipe,"Kaddu, Broccoli, Onion, Garlic, Rosemary, Cinnamon Powder, Salt, Baguette, Milk, Tomato, Whole Egg, Milk, Vanilla Extract, Honey",14,10,25,35,4,Continental,World Breakfast,Vegetarian
Ice Tea Sangria Recipe,"Tea Monk Oo Tea, Apple, Orange, Honey, Fresh Orange Juice, Grape Juice, Star Anise, Ice Cubes",8,20,5,25,4,European,Appetizer,Sugar Free Diet
Whole Wheat Achaari Aloo Tacos - Indo Mexican Fusion Recipe,"Whole Wheat Flour Tortilla, Onion, Cherry Tomato, Purple Cabbage Regular Cabbage, Coriander, Potato, Turmeric Powder, Kashmiri Red Chilli Powder, Cumin Powder, Coriander Powder, Garlic Powder, Salt, Mustard Oil Sesame Oil, Mustard Seeds, Fennel Seeds, Ajwain, Cheddar Cheese, Lemons",18,10,60,70,4,Fusion,Snack,Vegetarian
Daal Pithi Recipe,"Whole Wheat Flour, Water, Masoor Dal, Cumin Powder, Coriander Powder, Turmeric Powder, Red Chilli Powder, Ginger Garlic Paste, Onion, Garlic, Green Chilli, Cumin Seeds, Ghee, Coriander",14,10,25,35,4,Bihari,Lunch,Vegetarian
Karuvepillai Pachadi Recipe - Curry Leaf Raita,"Curd, Salt, Curry Leaves, Ginger, Green Chilli, Cumin Seeds, Whole Black Pepper Corns, Sunflower Oil, Mustard Seeds, White Urad Dal, Curry Leaves, Dry Red Chilli",12,15,5,20,4,South Indian Recipes,Side Dish,Vegetarian
Kashmiri Style Nadru Ke Kabab Recipe-Lotus Stem in Spicy Gravy,"Lotus Stem, Onion, Green Chilli, Potato, Salt, Coriander Powder, Garam Masala Powder, Red Chilli Powder, Ajwain, Ginger, Garlic, Roasted Gram Flour, Fennel Seeds, Lemon Juice, Whole Wheat Bread Crumbs, Tomato, Onion, Green Bell Pepper, Garlic, Ginger, Cashew Nuts, Salt, Ghee Clarified Butter, Garam Masala Powder, Red Chilli Powder, Water, Tomato Ketchup, Homemade Tomato Puree, Milk",29,20,40,60,2,Kashmiri,Lunch,Vegetarian
Peanut Rice With Coconut Recipe,"Basmati Rice, Water, Sunflower Oil, Ghee, Mustard Seeds, Cumin Seeds, Raw Peanuts, Salt, Raw Peanuts, Dry Red Chilli, Sesame Seeds, Fresh Coconut",12,20,5,25,2,Kashmiri,Lunch,Vegetarian
Green Peas Nimona Recipe,"Green Peas, Badi, Onion, Ginger Garlic Paste, Tomato, Salt, Red Chilli Powder, Turmeric Powder, Coriander Powder, Garam Masala Powder, Asafoetida, Ghee, Sunflower Oil, Green Chilli, Ginger, Cumin Seeds, Coriander",17,15,45,60,3,Awadhi,Lunch,Vegetarian
Uttarakhand Style Black Gram Chainsoo Recipe,"Arhar Dal, Coriander Powder, Cumin Powder, Red Chilli Powder, Turmeric Powder, Whole Black Peppercorns, Sunflower Oil, Water, Dry Red Chilli, Salt",10,15,40,55,4,North Indian Recipes,Lunch,High Protein Vegetarian
Sweet Potato Gratin With Fresh Herbs Recipe,"Sweet Potato  Cleaned And Sliced, Fresh Cream, Milk, Butter  Softened, Clove Garlic, Nutmeg, Parsley Leaves, Fresh Thyme Leaves, Dried Oregano, Basil Leaves, Whole Black Peppercorns, Salt, Cheese",13,11,60,71,4,French,Dinner,Vegetarian
Konkani Style Pomfret Fry Recipe - South Indian Fish Fry Recipe,"Pomfret Fish, Turmeric Powder, Salt, Sunflower Oil, Fresh Coconut, Dry Red Chilli, Garlic, Ginger, Green Chilli, Cumin Seeds, Cardamom, Kokum",12,10,25,35,2,Konkan,Appetizer,High Protein Non Vegetarian
Rice Sizzler With Tomato Coulis Recipe,"Sunflower Oil, Cloves, Bay Leaf, Cinnamon Stick, Cardamom, Black Cardamom, Whole Black Peppercorns, Cumin Seeds, Onion, Green Chilli, Carrot, Green Peas, Basmati Rice, Tomato, Sunflower Oil, Garlic, Salt, Black Pepper Powder, Butter, Carrot, Green Bell Pepper, Potato, Coriander, Butter, Sunflower Oil",25,10,45,55,2,Continental,Dinner,Vegetarian
Aloo Matar Paneer Curry Recipe,"Paneer, Potato, Green Peas, Homemade Tomato Puree, Cumin Seeds, Green Chilli, Coriander Powder, Garam Masala Powder, Turmeric Powder, Red Chilli Powder, Kasuri Methi, Fresh Cream, Salt, Sunflower Oil, Onion, Garlic, Ginger, Homemade Tomato Puree",18,10,45,55,4,North Indian Recipes,Lunch,Vegetarian
Sprouted Mung Bean and Spinach Soup Recipe,"Green Moong Sprouts, Spinach Leaves, Onion, Tomato, Ginger, Garlic  Minced, Cumin Powder, Red Chilli Powder Flakes, Salt And Pepper, Sunflower Oil Gheebutter, Lime Wedges, S Coriander",12,10,15,25,4,Continental,Appetizer,High Protein Vegetarian
Foxtail Millet Idli Recipe - Healthy Indian Diabetic Idli Recipe,"Foxtail Millet, White Urad Dal, Methi Seeds, Salt",4,480,25,505,4,South Indian Recipes,South Indian Breakfast,Diabetic Friendly
Konkani Style Cabbage Sanna Polo Recipe - Savory Cabbage Dosa,"Dosa Rice, Red Cabbage, Onion, Fresh Coconut, Dry Red Chilli, Tamarind, Salt, Sunflower Oil",8,10,15,25,2,Konkan,South Indian Breakfast,Vegetarian
Healthy Rose Cookies Recipe With Persian Twist,"Whole Wheat Flour, Sooji, Gram Flour, Dessicated Coconut, Rose Petals, Dates, Pistachios, Butter, Baking Powder, Sugar, Rose Petals, Water",12,30,30,60,4,Continental,Dessert,Vegetarian
Sakkare Millet Pongal Recipe,"Foxtail Millet, Milk, Water, Jaggery, Cardamom, Mixed Dry Fruits, Ghee, Dry Coconut",8,10,30,40,4,South Indian Recipes,Dessert,Vegetarian
Patra Ni Machi Recipe - Fish Cooked In Banana Leaf,"Pomfret Fish, Salt, Banana Leaf Wrap The Fish, Coriander, Mint Leaves, Green Chilli, Garlic, Cumin Seeds, Fresh Coconut, Salt, Sugar, Lemon Juice",12,15,15,30,3,Parsi Recipes,Lunch,Non Vegeterian
Maddur Vada Recipe  |  Maddur Vade,"Rice Flour, Sooji, All Purpose Flour, Onion, Green Chilli, Curry Leaves, Asafoetida, Red Chilli Powder, Sunflower Oil, Salt, Sunflower Oil Deep Fry",11,10,20,30,4,Karnataka,Snack,Vegetarian
Kerala Style Karamani Thoran Recipe - Yard Beans Stir Fry With Coconut,"Green Chawli Beans, Coconut Oil, Mustard Seeds, Cumin Seeds, Curry Leaves, Turmeric Powder, Fresh Coconut, Green Chilli, Curry Leaves, Salt",10,10,30,40,4,Kerala Recipes,Side Dish,Vegetarian
Baked Mini Bread Cups Recipe,"Whole Wheat Brown Bread, Sweet Corn, Potato, Red Bell Pepper, Green Bell Pepper, Onion, Garlic, Red Chilli Powder, Tomato Ketchup, Salt, Butter, Cheddar Cheese Cheese Slices",12,10,25,35,4,Indian,Snack,Vegetarian
Multigrain Crepe Recipe Filled With Spicy Mashed Potatoes,"Whole Wheat Flour, Ragi Flour, Bajra Flour, Salt, Whole Black Peppercorns, Potato, Red Chilli Powder, Green Chilli, Coriander, Cumin Seeds, Sunflower Oil",11,10,30,40,4,Indian,Lunch,Vegetarian
Thai Style Kai Jeow Moo Sab Recipe - Omelette with minced Chicken,"Whole Eggs, Chicken, Soy Sauce, Stalk Spring Onion, Salt Season, Sunflower Oil",6,5,15,20,2,Thai,World Breakfast,Non Vegeterian
Palak Dhania Dosa Recipe With Figaro Olive Oil,"Spinach, Coriander, Onion, Green Chilli, Whole Wheat Flour, Instant Oats, Sooji, Whole Black Peppercorns, Figaro Pure Olive Oil",9,10,45,55,4,South Indian Recipes,South Indian Breakfast,High Protein Vegetarian
Date and Tamarind Chutney Recipe - Khajur Imli Chutney,"Dates, Tamarind, Jaggery, Water, Red Chilli Powder, Cumin Powder, Dry Ginger Powder, Black Salt, Salt",9,10,20,30,4,Indian,Side Dish,Vegetarian
Methi Corn Dal Vada Recipe,"Chana Dal, Arhar Dal, Methi Leaves, Sweet Corn, Green Chilli, Red Chilli Powder, Turmeric Powder, Cumin Seeds, Salt, Asafoetida, Curry Leaves, Sunflower Oil Fry",12,30,45,75,5,Indian,Snack,Vegetarian
Sindhi Sai Bhaji Recipe - Wholesome Sindhi Dal With Vegetables,"Spinach Leaves, Methi Leaves, Dill Leaves, Chana Dal, Green Moong Dal, Carrots, Bottle Gourd, Green Beans, Onion, Tomato, Ginger, Ghee, Salt, Turmeric Powder, Coriander Powder, Garlic, Red Chilli Powder, Garlic, Red Chilli Powder, Ghee, Ghee",21,25,20,45,4,Sindhi,One Pot Dish,Diabetic Friendly
Oats Carrot Cake Cookies Recipe,"Instant Oats, Whole Wheat Flour, Cinnamon Powder, Baking Powder, Sea Salt, Walnuts, Raisins, Ginger, Carrot, Whole Egg, Honey, Coconut Oil",12,30,18,48,4,Continental,Snack,Vegetarian
Red Capsicum Poriyal Recipe - Red Bell Pepper Stir Fry,"Red Bell Pepper, Chana Dal, Mustard Seeds, Curry Leaves, Fresh Coconut, Asafoetida, Ginger, Green Chilli, Sunflower Oil, Salt",10,5,15,20,4,South Indian Recipes,Lunch,Vegetarian
Khatte Pudina Aloo Recipe,"Potato, Mint, Coriander, Green Chilli, , Red Chilli Powder, Turmeric Powder, Salt, Ghee Oil As Per",9,10,15,25,2,Indian,Lunch,Vegetarian
Sweet Corn Spring Onion Momo Recipe - Sweet Corn Dumplings,"Sweet Corn, Spring Onion, Sriracha Sauce, Black Pepper Powder, Salt, All Purpose Flour, Salt, Water Knead",8,25,25,50,4,Chinese,Appetizer,Non Vegeterian
Eggless Apple Strudel Recipe With Homemade Pastry Sheet,"Pastry Dough, Jam, Apples, Whole Wheat Bread Crumbs, Cinnamon Powder, Caster Sugar, Badam, Raisins, Butter, Cinnamon Powder, Caster Sugar",11,20,40,60,4,Continental,Dessert,Vegetarian
Wheat Pizza Pockets Recipe Baked with Chicken Filling,"Whole Wheat Flour, Lukewarm Water, Active Dry Yeast, Sugar, Salt, Extra Virgin Olive Oil, Boneless Chicken, Green Bell Pepper, Red Bell Pepper, Yellow Bell Pepper, Onion, Garlic, Salt, Black Pepper Powder, Mozzarella Cheese, Ricotta Cheese, Extra Virgin Olive Oil, Milk, Homemade Pizza And Pasta Sauce",19,120,20,140,4,Continental,Appetizer,Non Vegeterian
Chilli Capsicum Macaroni Recipe,"Macaroni Pasta, Green Bell Pepper, Onion, Green Chilli, Sunflower Oil, Garlic   Finely, Tomato, Tomato Ketchup, Red Chilli Sauce, Soy Sauce, Salt, Red Chilli Flakes, Coriander",13,10,35,45,4,Fusion,Lunch,Vegetarian
Moong Bean Sprouts Upkari Recipe - Moong Beans Stir Fry,"Green Moong Sprouts, Cumin Seeds, Mustard Seeds, Dry Red Chilli, Asafoetida, Turmeric Powder, Salt, Fresh Coconut, Coconut Oil",9,10,20,30,4,Indian,Dinner,High Protein Vegetarian
Roasted Cauliflower Soup Recipe,"Cauliflower, Celery, Garlic, Extra Virgin Olive Oil, Salt, Milk, Water, Black Pepper Powder, Butter, Whole Black Pepper Corns",10,10,30,40,2,Continental,Side Dish,Vegetarian
Thandai Mousse Cake Recipe With A Delicious Cardamom Sponge,"All Purpose Flour, Curd, Sunflower Oil, Vanilla Extract, Sugar, Cardamom Powder, Baking Powder, Baking Soda, Fresh Cream, White Chocolate, Heavy Whipping Cream, Thandai Syrup, Badam, Pistachios, Saffron Strands",15,10,50,60,4,Indian,Dessert,Vegetarian
Chickpea & Oats Falafel Recipe,"Kabuli Chana, Instant Oats, All Purpose Flour, Garlic, Parsley Leaves, Cumin Powder, Salt, Black Pepper Powder, Sunflower Oil",9,10,40,50,4,Middle Eastern,Lunch,High Protein Vegetarian
Drumstick Dal Soup Recipe,"Drumstick, Green Moong Dal, Water, Onion, Tomato, Garlic, Turmeric Powder, Cumin Powder, Black Pepper Powder, Salt",10,10,30,40,4,South Indian Recipes,Dinner,Vegetarian
Cauliflower Matar Bhurji Recipe,"Cauliflower, Green Peas, Onion, Tomato, Green Chilli, Ginger Garlic Paste, Turmeric Powder, Red Chilli Powder, Garam Masala Powder, Sunflower Oil, Salt, Coriander",12,10,35,45,3,Indian,Dinner,Vegetarian
Homemade Tamarind Water Recipe,"Tamarind, Hot Water",2,10,15,25,240,Continental,Side Dish,Vegetarian
Chicken Yakitori Recipe - Japanese Chicken Skewers,"Chicken Breasts, Garlic, Ginger, Soy Sauce, Black Pepper Powder, Red Wine, Brown Sugar, Vinegar, Sunflower Oil, Garlic, Corn Flour, Water, Red Chilli Sauce",13,30,20,50,4,Japanese,Appetizer,Non Vegeterian
Mixed Sprouts In Chettinad Masala Recipe,"Mixed Sprouts, Onion, Tomato, Green Chilli, Cinnamon Stick, Bay Leaf, Cardamom, Cloves, Fennel Seeds, Garam Masala Powder, Curry Leaves, Sesame, Salt, Whole Black Peppercorns, Cumin Seeds, Fennel Seeds, Coriander, Garlic, Ginger, Fresh Coconut, Sunflower Oil",21,10,30,40,4,Chettinad,Lunch,Vegetarian
Focaccia With Cherry Tomatoes & Caramelized Onion Recipe,"Vivatta Maida, Lukewarm Water, Active Dry Yeast, Sugar Honey, Salt, Extra Virgin Olive Oil, Onion, Cherry Tomato, Rosemary, Parmesan Cheese, Red Chilli Flakes, Salt, Extra Virgin Olive Oil",13,120,20,140,4,Italian Recipes,Side Dish,Vegetarian
"Apple, Kiwi, Pineapple Juice Recipe","Apple, Kiwi, Pineapple",3,15,0,15,4,World Breakfast,Sugar Free Diet,Vegetarian
Tamil Nadu Style Coconut Chutney Recipe - For Idli And Dosa,"Fresh Coconut  Grated, Green Chilli, Ginger, Lukewarm Water, Salt, Mustard Seeds, White Urad Dal, Sunflower Oil, Curry Leaves, Dry Red Chilli",10,10,10,20,4,South Indian Recipes,Side Dish,Vegetarian
Indian Spicy Masala Cookie Recipe (Khara Biscuit),"All Purpose Flour, Butter, Curd, Red Chilli Powder, Ginger, Sugar, Salt, Cumin Seeds, Green Chilli, Curry Leaves, Baking Powder, Asafoetida",12,30,45,75,6,Indian,Snack,Vegetarian
Sweet Corn & Peas Upma Recipe For Babies and Toddlers,"Sweet Corn, Green Peas, Ghee, Mustard Seeds, White Urad Dal, Onion, Salt, Sooji, Hot Water",9,10,10,20,2,South Indian Recipes,South Indian Breakfast,Vegetarian
Cold Sesame Noodles Recipe,"Sichuan Peppercorns, Red Chilli Flakes, Spring Onion Greens, Bay Leaves, Star Anise, Cumin Seeds, Coriander Powder, Garlic, Soy Sauce, Sesame, Chilli Oil, Sesame Seeds, Vinegar, Soy Sauce, Peanut Butter, Veg Hakka Noodles, Cucumber, Mooli Mullangi, Spring Onion Greens, Raw Peanuts, Sesame Seeds",21,10,20,30,4,Chinese,Main Course,Vegetarian
Homemade Rice Cereal Recipe (Babies-4 months onward),"Basmati Rice, Water",2,10,60,70,1,Indian,Dinner,Vegetarian
Bhutte Ka Kees Recipe,"Sweet Corn  Steamed And Groundpaste, Ghee, Milk, Cumin Seeds, Mustard Seeds, Green Chilli, Ginger, Turmeric Powder, Red Chilli Powder, Asafoetida, Sugar, Lemon Juice, Coriander, Salt",14,10,15,25,2,Rajasthani,Snack,Vegetarian
Dill Cucumber Raita Recipe,"Cucumber, Curd, Dill Leaves, Mint Leaves, Chaat Masala Powder, Cumin Powder, Black Pepper Powder, Salt",8,10,0,10,4,Indian,Side Dish,Vegetarian
Tindora Ka Salan Recipe,"Tindora, Onion, Green Chilli, Ginger Garlic Paste, Methi Seeds, Cumin Seeds, Mustard Seeds, Curry Leaves, Dry Red Chilli, Cumin Powder, Red Chilli Powder, Coriander Powder, Turmeric Powder, Jaggery, Tamarind Water, Mint Leaves, Coriander, Lemon Juice, Sunflower Oil, Salt, Raw Peanuts, Sesame Seeds, Fresh Coconut",23,10,20,30,4,North Indian Recipes,Side Dish,Vegetarian
Andhra Style Chepa Vepudu Recipe - Andhra Fish Fry Recipe,"Basa Fish, Mustard Seeds, Onion, Ginger, Garlic, Curry Leaves, Red Chilli Powder, Turmeric Powder, Sunflower Oil, Sesame Seeds, White Urad Dal, Chana Dal, Cumin Seeds, Dry Coconut, Dry Red Chilli",15,10,30,40,4,Andhra,Side Dish,High Protein Non Vegetarian
Konkani Style Kalwanche Tonak Recipe - Oyster Curry,"Oysters, Salt, Onion, Garlic, Extra Virgin Olive Oil, Tamarind, Fresh Coconut, Dry Red Chilli, Coriander, Whole Black Peppercorns, Cloves, Fennel Seeds, Turmeric Powder",13,10,25,35,3,Konkan,Dinner,Non Vegeterian
Dry Fruit Halwa Recipe,"Dates, Figs, Pistachios, Cashews, Almonds, Walnuts, Milk, Ghee",8,30,30,60,4,Indian,Dessert,Vegetarian
Baked Roasted Pumpkin Penne Pasta With Tomato Basil Sauce Recipe,"Penne Pasta, Kaddu, Garlic, Mozzarella Cheese, Salt, Tomato, Basil Leaves, Onion, Garlic Parsley, Whole Black Pepper Corns, Sugar, Extra Virgin Olive Oil, Salt",13,10,60,70,4,Italian Recipes,Dinner,Vegetarian
Potato Fenugreek Leaves Stir Fry ,"Potato, Fenugreek, Onion, Tomato, Ginger, Garlic, Turmeric Powder, Garam Masala Powder, Coriander Powder, Salt, Red Chili Powder, Cumin Seeds, Oil",13,10,40,50,4,North Indian Recipes,Lunch,Vegetarian
Soya Granule Samosa Recipe - Perfect Evening Snack,"All Purpose Flour, Whole Wheat Flour, Salt, Ghee, Ajwain, Water, Soy Granules, Onion, Green Chilli, Green Peas, Cumin Seeds, Sunflower Oil, Ginger Garlic Paste, Coriander Powder, Red Chilli Powder, Turmeric Powder, Garam Masala Powder, Sugar, Salt, Sunflower Oil",20,30,60,90,4,North Indian Recipes,Snack,Vegetarian
Sweet Pumpkin Green Smoothie Recipe,"Kaddu, Spinach, Milk Almond Milk, Cinnamon Powder, Dates, Pumpkin Seeds",6,10,60,70,4,Continental,Snack,Vegetarian
Vegetable Yakhni Pulao Recipe,"Ajwain, Coriander, Fennel Seeds, Cloves, Cardamom, Cinnamon Stick, Whole Black Peppercorns, Vegetable Stock Water, Basmati Rice, Onion, Ginger, Garlic, Green Chilli, Bay Leaf, Carrot, Cauliflower, Green Beans, Green Peas, Curd, Mint Leaves, Salt, Ghee, Caramelized Onion, Mint Leaves, Ghee, Cashew Nuts, Raisins",27,20,45,65,4,North Indian Recipes,Dinner,Vegetarian
French Toast Oatmeal Bake Recipe,"Ripe Bananas, Almond Milk, Peanut Butter Any Other Flavoured Cream Preferred, Maple Syrup, Cinnamon Powder, Vanilla Extract, Whole Wheat Brown Bread, Instant Oats, Flax Seed Powder, Sultanas, Walnuts, Coconut Sugar Sprinkle On Top",12,10,30,40,2,Continental,World Breakfast,High Protein Vegetarian
Nutella Filled Hand Pies Recipe,"All Purpose Pie Crust, Walnuts, Nutella Spread, Honey",4,30,60,90,4,Continental,Snack,Vegetarian
Orange Flavored Barbecue Chicken With Fresh Salad Recipe,"Chicken Thigh, Fresh Orange Juice, Red Chilli Sauce, Barbeque Sauce, Date Syrup, Black Pepper Powder, Salt, Spinach Leaves, Orange, Apple, Orange, Lemon Juice, Salt And Pepper, Baby Potato, Butter, Dried Oregano, Salt And Pepper",17,10,45,55,4,Continental,Lunch,Non Vegeterian
Broccoli Puree With Butter and Garlic Recipe (For Babies/toddlers over 7 months),"Broccoli, Water, Salt, Garlic, Butter, Black Pepper Powder",6,15,10,25,6,Indian,Lunch,Vegetarian
Gawar Phali Masala Sabzi Recipe,"Gwar Pods, Onion, Tomato, Garlic, Ginger, Curry Leaves, Teaspoon Turmeric Powder, Red Chili Powder, Cumin Seeds, Mustard, Asafoetida, Coriander Powder, Cumin Powder, Peanuts, Salt, Oil, Coriander",17,15,30,45,4,North Indian Recipes,Lunch,Vegetarian
Saffron Cardamom Creme BrulÃ©e Recipe,"Few Saffron Strands, Cardamom, Double Cream, Egg Yolks, Sugar",5,20,120,140,4,French,Dessert,Eggetarian
Ellu Chutney Recipe - Sesame Seeds Chutney Recipe,"Black Sesame Seeds, White Urad Dal, Fresh Coconut, Dry Red Chilli, Curry Leaves, Tamarind, Salt, Sunflower Oil, Mustard Seeds, Curry Leaves",10,10,10,20,4,Karnataka,Side Dish,Vegetarian
Light And Creamy Broccoli Soup Recipe,"Broccoli, Potato, Extra Virgin Olive Oil, Vegetable Stock Water, Milk, Salt And Pepper",6,20,20,40,4,Continental,Appetizer,Vegetarian
Spinach And Capsicum Pasta Recipe,"Spirali Pasta, Spinach, Green Bell Pepper, Onion, Salt, Black Pepper Powder, Green Chilli, Dried Oregano, Lemon Juice, Extra Virgin Olive Oil",10,10,30,40,3,Italian Recipes,Dinner,Vegetarian
Kuzhal Payasam Recipe- Wheat Noodles Payasam,"Whole Wheat Flour, Jaggery, Water, Rice Flour, Cardamom Powder, Dry Ginger Powder, Coconut Milk, Fresh Coconut, Cashew Nuts, Raisins, Ghee, Sunflower Oil",12,20,25,45,5,South Indian Recipes,Dessert,Vegetarian
Pesto and Tangy Tomato Whirls with Hints of Garlic,"All Purpose Flour, Active Dry Yeast, Sugar, Baking Powder, Salt, Water, Milk, Basil Leaves, Garlic, Extra Virgin Olive Oil, Black Pepper Powder, Salt, Tomato, Garlic, Onion, Tomato Ketchup, Butter, Black Pepper Powder, Salt, Parsley Leaves, Britannia Cheese Block",21,10,150,160,4,Italian Recipes,Appetizer,Vegetarian
"Methi, Mooli Makkai Paratha Recipe","Methi Leaves, Mooli Mullangi, Makki Ka Atta, Green Chilli, Ajwain, Red Chilli Powder, Coriander Powder, Salt, Water Knead The Doughbuttermilk, Ghee Oil",10,10,30,40,4,North Indian Recipes,North Indian Breakfast,Vegetarian
Carrot Methi Pachadi Recipe,"Methi Leaves, Carrot, Tamarind Paste, Green Chilli, Jaggery, Turmeric Powder, Salt, Dry Red Chilli, Sunflower Oil, White Urad Dal, Mustard Seeds, Cumin Seeds",12,10,10,20,4,South Indian Recipes,Dinner,Vegetarian
Palak Makhana Recipe (Navratri Fasting/Vrat Recipe),"Spinach Leaves, Tomato, Phool Makhana, Cumin Seeds, Garam Masala Powder, Red Chilli Powder, Turmeric Powder, Cinnamon Stick, Milk, Ghee, Salt",11,20,30,50,6,North Indian Recipes,Dinner,No Onion No Garlic (Sattvic)
Mavinakayi Gojju Recipe - Mango Curry,"Mango, White Urad Dal, Chana Dal, Cumin Seeds, Methi Seeds, Turmeric Powder, Dry Red Chilli, Fresh Coconut, Jaggery, Salt, Sunflower Oil, Asafoetida, Mustard Seeds, Dry Red Chilli, Curry Leaves",15,15,30,45,4,South Indian Recipes,Lunch,Vegetarian
Sindhi Bhuga Chawal Recipe - Sindhi Style Browned Rice Pulao,"Rice  Washed And Soaked, Ghee, Onion, Bay Leaf, Whole Black Peppercorns, Cloves, Cardamom, Cinnamon Stick, Green Chilli, Garam Masala Powder, Red Chilli Powder",11,20,30,50,4,Sindhi,Main Course,Vegetarian
Gluten-Free Koloocheh Recipe | Persian Date Nut Filled Cookies,"Butter, Sugar, Vanilla Extract, Whole Egg, Rajgira Flour, Buckwheat Flour, Salt, Cinnamon Powder, Baking Powder, Walnuts Almonds, Dates, Fresh Orange Juice, Honey, Salt",14,15,20,35,4,Middle Eastern,Snack,Eggetarian
Tofu Green Pulao Recipe,"Spinach Leaves, Methi Leaves, Coriander, Mint Leaves, Spring Onion Greens, Green Peas, Green Bell Pepper, Green Beans, Tofu, Green Chilli, Cumin Seeds, Ghee, Sunflower Oil, Cinnamon Stick, Black Cardamom, Cardamom, Cloves, Bay Leaves, Cashew Nuts, Basmati Rice, Salt",21,20,40,60,4,Indian,Lunch,Vegetarian
Mosaru Kodubale Recipe - Yogurt-Rice Flour Fritters,"Rice Flour, Fresh Coconut, Hung Curd, Water, Cumin Seeds, Green Chilli, Asafoetida, Salt, Sunflower Oil",9,20,45,65,4,South Indian Recipes,Snack,Vegetarian
Dal Bukhara Recipe (Punjabi Style Black Urad Dal),"Black Urad Dal, Onion, Tomato, Ginger Garlic Paste, Green Chilli, Butter, Cumin Seeds, Kasuri Methi, Salt, Red Chilli Powder, Chaat Masala Powder, Garam Masala Powder, Cumin Powder, Fresh Cream",14,20,60,80,4,Punjabi,Dinner,Vegetarian
Thengai Thogayal Recipe,"Coconut, White Urad Dal, Fenugreek Seeds, Dry Red Chilli, Curry Leaves, Tamarind, As Much As   Rye, Dry Red Chilies, , Oil, As Per",11,10,10,20,5,South Indian Recipes,Side Dish,Vegetarian
Healthy Yogurt Parfait with Oats and Fresh Fruits Recipe,"Instant Oats, Coconut Milk, Honey, Salt, Curd, Honey, Raw Banana, Apple, Prunes, Pistachios",10,30,0,30,2,Continental,World Breakfast,Vegetarian
Thelivu Rasam Recipe,"Arhar Dal, Tamarind, Tomato, Garlic, Green Chilli, Rasam Powder, Mustard Seeds, Asafoetida, Curry Leaves, Coriander, Ghee, Salt",12,10,15,25,4,South Indian Recipes,Side Dish,Vegetarian
Huruli Kaalu Chutney Pudi Recipe (Horse Gram Chutney Podi),"Horse Gram Dal, Byadagi Dried Chilli, Guntur Dried Chilli, Curry Leaves, Tamarind, Asafoetida, Salt",7,10,10,20,4,South Indian Recipes,Side Dish,Vegetarian
Rabodi Ki Sabzi Recipe,"Rabodi, Curd, Onion, Green Chilli, Cumin Seeds, Red Chilli Powder, Turmeric Powder, Coriander Powder, Salt, Sunflower Oil, Water",11,10,20,30,2,Rajasthani,Lunch,Vegetarian
Homemade Harissa Paste Recipe,"Red Bell Pepper, Garlic, Sun Dried Tomato, Coriander, Cumin Seeds, Dry Red Chilli, Extra Virgin Olive Oil, Sugar, Salt",9,15,20,35,10,Continental,Side Dish,Vegetarian
Raw Mango Thokku Recipe - Tamil Nadu Style Raw Manga Thokku,"Mango, Methi Seeds, Sesame, Mustard Seeds, Turmeric Powder, Red Chilli Powder, Asafoetida, Salt",8,20,10,30,400,South Indian Recipes,Appetizer,Vegetarian
Karnataka Style Haalbai Recipe,"Coconut Milk, Jaggery, Rice Flour, Cardamom, Ghee Coconut Oil",5,5,45,50,20,Karnataka,Dessert,Vegetarian
Andhra Gongura Pulihora Recipe | Gongura Puliyodharai | Spicy Red Roselle Leaves Rice,"Rice, Gongura Leaves, Salt, Sesame, Mustard Seeds, Asafoetida, White Urad Dal, Chana Dal, Roasted Peanuts, Curry Leaves, Turmeric Powder, Coriander, Sesame Seeds, Chana Dal, Methi Seeds, Dry Red Chilli",16,15,30,45,4,South Indian Recipes,Lunch,Vegetarian
Annanas Ka Muzzafar Recipe,"Basmati Rice, Pineapple, Saffron Strands, Paneer, Cardamom, Sugar, Raisins, Cashew Nuts, Pistachios, Badam, Salt, Ghee",12,5,30,35,4,Awadhi,Dessert,Eggetarian
Moong Dal Idli Recipe,"Yellow Moong Dal, Idli Rice, Methi Seeds, Salt, Water Grind, Ghee",6,400,15,415,4,South Indian Recipes,South Indian Breakfast,High Protein Vegetarian
Herbed Lentil Loaf Recipe Using Horsegram,"Instant Oats, Quinoa Flour Millet Flour, Green Moong Dal, Whole Egg, Soy Sauce, White Wine Vinegar, Extra Virgin Olive Oil, Homemade Tomato Puree, Garlic Powder, Cumin Powder, Red Chilli Powder, Parsley Leaves, Whole Wheat Bread Crumbs, Salt, Black Pepper Powder",15,15,45,60,4,Continental,Snack,Vegetarian
Paneer Biryani Recipe,"Rice, Cottage Cheese, Onion, Tomato, Ginger, Garlic, Green Chilli, Red Chili Powder, Small Teaspoon Turmeric Powder, Coriander Powder, , Cinnamon, Cardamom, Bay Leaves, Whole Pepper, Ghee, Salt, Of Mint, Oil",19,10,45,55,4,Indian,Lunch,High Protein Vegetarian
Wholesome Lentil Salad Recipe with Oven Roasted Tomatoes,"Masoor Dal, Onion, Mint Leaves, Coriander, Capers, Slivered Almonds, Tomato, Extra Virgin Olive Oil, Apple Cider Vinegar, Clove Garlic, Salt, Black Pepper Powder",12,15,40,55,3,Continental,Snack,High Protein Vegetarian
Jalapeno Cheese Samosa Recipe,"All Purpose Flour, Ghee, Ajwain, Salt, Water, Britannia Cheezza, Pickled Jalapenos, Britannia Cheese Spread  Four Pepper Tango  Finely, Coriander",9,15,30,45,8,Fusion,Snack,Vegetarian
Vermicelli Biryani Recipe,"Semiya, Carrot, Green Beans, Green Bell Pepper, Onion, Green Peas, Garam Masala Powder, Coriander Powder, Biryani Masala, Turmeric Powder, Cumin Seeds, Sunflower Oil, Onion, Fennel Seeds, Green Chilli, Coriander, Garlic, Ginger",18,15,15,30,4,Indian,South Indian Breakfast,Vegetarian
Hare Chane Ki Burfi Recipe,"Fresh Green Chickpeas, Khoya, Sugar, Cardamom Powder, Mixed Nuts, Ghee",6,10,45,55,4,Rajasthani,Dessert,Vegetarian
Chicken Spinach And Ricotta Bombs Recipe,"Chicken Thighs, Spinach, Extra Virgin Olive Oil, Ricotta Cheese, Whole Wheat Bread Crumbs, Mixed Herbs, Garlic Powder, Black Pepper Powder, Salt, Sunflower Oil Fry",10,10,20,30,4,Italian Recipes,Appetizer,High Protein Non Vegetarian
Green Tea Coconut Ladoo Recipe - Coconut Energy Balls,"Fresh Coconut, Ghee, Cardamom, Condensed Milk, Tetley Long Leaf Green Tea, Dessicated Coconut",6,10,45,55,4,Indian,Dessert,High Protein Non Vegetarian
Tofu Methi Paratha Recipe,"Whole Wheat Flour, Bajra Flour, Jowar Flour, Salt, Sunflower Oil, Tofu, Cumin Powder, Green Chilli, Onion, Methi Leaves, Salt",11,10,30,40,6,North Indian Recipes,North Indian Breakfast,High Protein Vegetarian
Shredded Chicken Tostadas Recipe,"Tortillas, Sunflower Oil, Boneless Chicken, Black Pepper Powder, Salt, Lemon Juice, Extra Virgin Olive Oil, Refried Beans, Iceberg Lettuce, Red Radish  Sliced, Onion, Guacamole, Tomato Salsa, Sour Cream",14,10,30,40,4,Mexican,Appetizer,Non Vegeterian
Stir Fried Brown Rice And Wild Rice Topped With Honey-Glazed Tofu Recipe,"Brown Rice, Wild Rice, Tofu, Green Bell Pepper, Onion, S Spring Onion Greens, Soy Sauce, Red Chilli Sauce, Green Chilli Sauce, Black Pepper Powder, Salt, Soy Sauce, Honey, Red Chilli Sauce, Salt",15,0,45,45,4,Indo Chinese,Lunch,Vegetarian
Whole Wheat Spaghetti With Avocado Basil Pesto Recipe,"Spaghetti Pasta, Basil Leaves, Avocado, Walnuts, Lemon Juice, Garlic, Extra Virgin Olive Oil, Salt",8,10,30,40,3,Italian Recipes,Dinner,Vegetarian
"Carrot, Radish & Peanut Salad with Lemon Recipe ","Carrot, Mooli Mullangi, Green Chilli, Roasted Peanuts, Cumin Powder, Dry Ginger Powder, Lemon Juice, Coriander",8,30,0,30,4,Indian,Side Dish,Vegetarian
Beans Muttai Poriyal Recipe - Chettinad Egg Scramble with Beans,"Whole Eggs, Green Beans, Onion, Cumin Seeds, Whole Black Peppercorns, Coriander, Sunflower Oil, Salt",8,10,15,25,4,South Indian Recipes,Lunch,Eggetarian
Rice Flour Bhakri Recipe (Maharashtrian Tandalachi Bhakri),"Rice Flour, Salt, Lukewarm Water",3,20,25,45,4,Maharashtrian Recipes,North Indian Breakfast,Vegetarian
Nawabi Mixed Vegetable Gravy ,"Cabbage, Green Beans, Carrots, Green Peas, Bay Leaf, , Lentil Sugar, Onion, Tomato, Green Chili, Coriander Powder, Red Chilli Powder, Garam Masala Powder, Coriander, Ghee, Cashews, Onion, Tomato, Garlic, Ginger, Cumin",21,30,30,60,4,North Indian Recipes,Lunch,Vegetarian
Rose Lassi Recipe,"Curd, Chilled Water, Sugar, Rose Syrup, Ice Cubes, Pistachios",6,5,10,15,4,North Indian Recipes,Snack,Vegetarian
Buckwheat Crepe Recipe with Fruit Compote,"Buckwheat Flour, Whole Wheat Flour, Baking Powder, Baking Soda, Whole Eggs, Buttermilk, Butter, Salt, Plum, Strawberries, Brown Sugar, Cinnamon Powder, Dried Thyme Leaves",13,15,45,60,6,Continental,World Breakfast,Gluten Free
Lachedar Kakdi Pyaz Kachumber Recipe - Onion Cucumber Salad,"Onion, Cucumber, Lemon Juice, Salt, Red Chilli Powder, Cumin Powder, Chaat Masala Powder",7,15,0,15,4,Indian,Side Dish,Vegetarian
Moong Dal Methi Ki Sabzi Recipe,"Green Moong Dal, Methi Leaves, Tomato, Onion, Green Chilli, Cumin Seeds, Ginger, Cumin Seeds, Turmeric Powder, Coriander Powder, Cumin Powder, Asafoetida, Sunflower Oil, Water",14,10,30,40,4,Indian,Lunch,Vegetarian
Sweet And Sour Vegetables With Paneer Curry Recipe,"Cauliflower, Carrot, Paneer, Garlic, Ginger, Green Chilli, Spring Onion Greens, Sunflower Oil, Tomato Ketchup, Green Chilli Sauce, Soy Sauce, Corn Flour, Instant Oats, Button Mushrooms, Milk, Mixed Herbs, Sunflower Oil, Salt, Red Chilli Flakes",19,10,30,40,4,Asian,Dinner,Vegetarian
Mughlai Style Eggplant Simmered In Rich Tomato Curry ,"Eggplant, Tomato Puree, Turmeric Powder, Garam Masala Powder, Bay Leaf, Red Chilli Powder, Coriander Powder, Cream, Raisins, Cast Coriander, Salt, Oil, Onion, Pieces Garlic, Ginger",15,20,30,50,4,Hyderabadi,Lunch,Vegetarian
Pudina Shavige Recipe - Pudina Semiya Upma Recipe,"Semiya, Raw Peanuts, Mustard Seeds, White Urad Dal, Curry Leaves, Salt, Ghee, Onion, Garlic, Ginger, Green Chilli, Cumin Seeds, Mint Leaves, Coriander, Salt",15,10,30,40,4,Karnataka,South Indian Breakfast,Diabetic Friendly
Gujarati Lasaniya Batata Recipe,"G Small Potato, Garlic, Oil, Cumin, Flour, Coriander Powder, Garam Masala Powder, Red Chilli Powder, Turmeric Powder, Yogurt, Salt, Green Coriander",12,20,25,45,2,Gujarati Recipesï»¿,Side Dish,Vegetarian
Baked Gobi Manchurian Recipe - Healthy Cauliflower Manchurian Recipe,"Cauliflower, Spring Onion Greens, Garlic, Green Chilli, Ginger, Corn Flour, Water Vegetable Stock, Homemade Tomato Puree, Soy Sauce, Tomato Ketchup, Red Chilli Sauce, Sunflower Oil, Sunflower Oil",13,20,20,40,4,Indo Chinese,Appetizer,Vegetarian
Hidden Banana Cupcake Recipe,"Vivatta Maida, Mango, Sugar, Sunflower Oil, Baking Powder, Baking Soda, Milk, Ripe Bananas, Sugar, Butter, Butter, Caster Sugar, Milk, Vanilla Extract, Mango Pulp",15,30,60,90,12,Continental,Dessert,Vegetarian
Andhra Style Patoli Recipe (Dal Usli/ Crumbled Dal Recipe),"Chana Dal, Green Chilli, Mustard Seeds, White Urad Dal, Cumin Seeds, Curry Leaves, Asafoetida, Onion, Ginger Garlic Paste, Red Chilli Powder, Turmeric Powder, Salt, Sunflower Oil",13,60,30,90,4,Andhra,Side Dish,Vegetarian
Slow Oven Roasted Tomatoes With Pasta And Goat Cheese Recipe,"Pasta  Fusilli, Garlic, Cherry Tomato, Onion, Balsamic Vinegar, Extra Virgin Olive Oil, Red Chilli Flakes, Black Pepper Powder, Goat Cheese, Basil Leaves",10,15,30,45,2,Italian Recipes,Dinner,Vegetarian
Cottage Cheese Pancake Recipe Stuffed With Chocolate - Russian Syrniki Recipe,"Paneer, Whole Eggs, Honey, Salt, Vanilla Extract, All Purpose Flour, Baking Powder, Chocolate Bar, All Purpose Flour, Butter",10,10,40,50,2,Continental,World Breakfast,Vegetarian
Hyderabad Style Kuska Recipe (Biryani Rice Recipe),"Basmati Rice, Stone Flower, Star Anise, Fennel Seeds, Mace, Cloves, Ginger, Onion, Tomato, Hung Curd, Mint Leaves, Coriander, Biryani Masala Powder, Turmeric Powder, Salt",15,10,45,55,4,Hyderabadi,Lunch,Vegetarian
Kakka Orotti Recipe - Steamed Mini Rice Balls in Chicken Gravy,"Basmati Rice, Fresh Coconut, Fennel Seeds, Onion, Water, Rice Flour, Salt, Sunflower Oil, Rice, Fennel Seeds, Cardamom, Cloves, Cinnamon Stick, Fresh Coconut, Water, Sunflower Oil Coconut Oil, Onion, Ginger Garlic Paste, Tomato, Kashmiri Red Chilli Powder, Coriander Powder, Turmeric Powder, Chicken Breasts, Water, Fresh Coconut, Garam Masala Powder, Curry Leaves",27,0,0,0,3,Malabar,Side Dish,High Protein Non Vegetarian
3 Ingredients Banana Ice Cream Recipe - Healthy Version,"Ripe Bananas, Honey, White Chocolate White Chocolate Chips",3,300,190,490,4,Continental,Dessert,Vegetarian
Nadan Tomato Curry Recipe (Kerala Style Tomato Curry),"Tomato, Green Chilli, Turmeric Powder, Red Chilli Powder, Salt, Coconut Oil, Mustard Seeds, Curry Leaves, Fresh Coconut, Cumin Seeds, Pearl Onion",11,10,20,30,4,Kerala Recipes,Side Dish,Vegetarian
Whole Wheat Sunflower Seed Bread Recipe,"Sunflower Seeds, Whole Wheat Flour, Oats Flour, All Purpose Flour, Active Dry Yeast  Active Dry Yeast, Honey, Salt, Curd, Water, Extra Virgin Olive Oil",10,15,240,255,6,Continental,Side Dish,Vegetarian
Spinach And Sweet Potato Bombs Recipe,"Sweet Potato, Spinach, Onion, Garlic, Dried Thyme Leaves, Dried Oregano, Red Chilli Flakes, Black Pepper Powder, Lemon Juice, Salt, Sunflower Oil",11,10,30,40,4,Continental,Appetizer,Vegetarian
Italian Ricotta Crostini with Olives and Cherry Tomatoes Recipe,"Ciabatta Bread, Cherry Tomato, Del Monte Black Olives, Ricotta Cheese, Basil Leaves Oregano, Extra Virgin Olive Oil, Salt, Fresh Thyme Leaves, Rosemary",9,5,15,20,4,Italian Recipes,Appetizer,Vegetarian
Allam Pachadi | Ginger Chutney Recipe,"Ginger, Jaggery, Tamarind, White Urad Dal, Kala Jeera, Methi Seeds, Dry Red Chilli, Mustard Seeds, Whole Black Peppercorns, Sesame Seeds, Asafoetida, Curry Leaves, Salt, Sunflower Oil",14,15,15,30,6,South Indian Recipes,Side Dish,Vegan
Uttarakhand Mooli Thechua Recipe (Radish Salad),"Mooli Mullangi, Coriander, Green Chilli, Salt",4,15,5,20,2,North Indian Recipes,Side Dish,Vegetarian
Mexican Quinoa Bean Salad Recipe,"Black Beans, Quinoa, Onion, Red Bell Pepper, Green Bell Pepper, Tomato, Coriander, Pickled Jalapenos, Sweet Corn, Iceberg Lettuce, Avocado, Red Wine Vinaigrette, Lemon Juice, Cumin Powder, Parsley Leaves, Dried Oregano, Extra Virgin Olive Oil, Clove Garlic, Black Pepper Powder, Honey, Salt, Avocado",22,10,25,35,4,Mediterranean,Appetizer,Vegetarian
Palak Tambuli ,"Spinach, Cumin Seeds, Whole Black Pepper, Green Chilli, Coconut, Yogurt, Ghee, Salt, Ghee, Mustard, Cumin Seeds, Curry Leaves, Dry Red Chili",13,10,20,30,4,Karnataka,Lunch,High Protein Vegetarian
Keerai Sambar ,"G Spinach, Asafoetida, Salt",3,20,30,50,4,South Indian Recipes,Dinner,Diabetic Friendly
Munthiri Masala Kurma Recipe - Kaju Masala Kurma Recipe,"Whole Cashews, Ghee, Homemade Tomato Puree, Onion, Garlic, Ginger, Curry Leaves, Red Chilli Powder, Turmeric Powder, Sambar Powder, Garam Masala Powder, Salt",12,10,30,40,2,South Indian Recipes,Lunch,Vegetarian
Sweet Potato Brownie Recipe,"Sweet Potato, Brown Sugar, Badam, Rice Flour Buckwheat Flour, Cocoa Powder, Honey Maple Syrup, Salt",7,25,40,65,4,Continental,Dessert,Gluten Free
Amla Rasam Recipe,"Amla, Turmeric Powder, Salt, Tomato, Ginger, , Green Coriander, Green Chilli, Cumin Seeds, Black Pepper Powder, Ghee, Mustard, Dry Red Chili, Asafoetida",14,10,30,40,4,South Indian Recipes,Lunch,Vegetarian
Mini Bread Pizza Recipe - Cheesy Canapes,"Whole Wheat Brown Bread, Tomato, Butter, Green Bell Pepper, Onion, Paneer, Cheese, Coriander, Dried Oregano, Roasted Tomato Pasta Sauce, Black Pepper Powder, Salt",12,10,25,35,4,Fusion,Appetizer,Vegetarian
Achari Masala Recipe For Fresh Pickles - Sambharo Masala,"Red Chilli Powder, Split Methi Seeds, Split Mustard Seeds, Turmeric Powder, Asafoetida, Salt",6,20,15,35,4,Gujarati Recipesï»¿,Side Dish,Vegetarian
Sabsige Soppina Idli Recipe (Dill Leaves Idli),"Idli Dosa Batter, Dill Leaves, Chana Dal, Sunflower Oil, Mustard Seeds, Cumin Seeds, Asafoetida, Curry Leaves, Black Pepper Powder, Turmeric Powder, Dry Ginger Powder, Salt",12,10,15,25,2,South Indian Recipes,South Indian Breakfast,Vegetarian
Chocolate Dipped Eggless Coconut Macaroon Recipe,"Dessicated Coconut, Condensed Milk, Cardamom, Milk Chocolate Dark Chocolate Based On Your Preference, Extra Virgin Olive Oil Butter",5,20,50,70,6,Fusion,Snack,Vegetarian
Rajasthani Dana Methi & Papad Ka Saag Recipe,"Methi Seeds, Papads, Curd, Salt, Red Chilli Powder, Turmeric Powder, Cumin Powder, Coriander Powder, Sunflower Oil, Kasuri Methi, Raisins, Mustard Seeds, Cumin Seeds, Asafoetida",14,15,10,25,4,Rajasthani,Side Dish,Vegetarian
Handi Biryani Recipe With Chicken,"Chicken, Rice, Onion, Ginger Juice, Ginger Garlic Paste, Ghee Cook, Curd, Turmeric Powder, Cloves, Cardamom, Black Cardamom, Cinnamon Stick, Mace, Nutmeg Powder, Whole Black Peppercorns, Red Chilli Powder, Bay Leaf, Black Pepper Powder, Dry Red Chilli, Hot Water, Salt, Whole Egg",22,30,40,70,4,Assamese,Main Course,Non Vegeterian
Kerala Special Vegetable Stew Recipe,"Potato, Carrot, Green Beans, Green Peas, Onion, Garlic, Ginger, Coconut Milk, Coconut Milk, Salt, Cinnamon Stick, Bay Leaf, Whole Black Peppercorns, Cardamom, Curry Leaves, Coconut Oil",16,15,30,45,4,Kerala Recipes,Lunch,Vegetarian
Dum Ka Murgh (Lagan Ka Murgh) Recipe,"Chicken, Onion, Ginger, Garlic, Poppy Seeds, Cashew Nuts, Green Chilli, Sunflower Oil, Coriander, Curd, Turmeric Powder, Red Chilli Powder, Coriander Powder, Mustard Oil, Lemon Juice, Salt, Ginger Garlic Paste, Bay Leaf, Cardamom, Black Cardamom, Cinnamon Stick, Ajwain, Mace, Cloves, Whole Black Peppercorns",25,10,120,130,6,North Indian Recipes,Lunch,Non Vegeterian
Telangana Style Barada Palya Recipe - Chana Dal Dry Sabzi,"Chana Dal, Green Chilli, Ginger, Coriander, Salt, Turmeric Powder, Sunflower Oil, Mustard Seeds, Cumin Seeds, Curry Leaves",10,60,20,80,4,Andhra,Side Dish,High Protein Vegetarian
Bihari Style Aloo Ka Chokha Recipe,"Potato, Green Chilli, Onion, Red Chili Powder, Mustard Oil, Salt, Coriander",7,10,45,55,4,Bihari,Lunch,Vegetarian
Homemade Idli Dosa Batter Recipe,"Idli Rice, White Urad Dal, Methi Seeds, Water",4,360,90,450,6,Indian,Indian Breakfast,Vegetarian
Beetroot Carrot Raita ,"Carrots, Spoon, Yogurt, Cumin Powder, Red Chili Powder, Chaat Masala Powder, Peppermint, Salt",8,15,10,25,4,Indian,Side Dish,Vegetarian
Fresh Homemade Basil Pesto recipe,"Basil Leaves, Walnuts, Garlic, Salt, Cumin Powder, Red Chilli Powder Black Pepper Corns, Extra Virgin Olive Oil, Parmesan Cheese",8,10,20,30,10,Continental,Side Dish,Vegetarian
Apple Cucumber Salad Recipe,"Apples, Cucumbers, Mint Leaves, Salt, Black Pepper Corns, Honey, Lemon Juice",7,15,0,15,4,Continental,Appetizer,Vegetarian
Mixed Millet And Lentils Adai Recipe,"Kodo Millet, Bajra Flour, Jowar Seeds, Seeraga, Yellow Moong Dal, Green Moong Dal, Chana Dal, White Urad Dal, Arhar Dal, Masoor Dal, Onion, Dry Red Chilli, Asafoetida, Curry Leaves, Cumin Seeds, Salt, Water, Sunflower Oil, Coriander",19,10,40,50,3,South Indian Recipes,South Indian Breakfast,High Protein Vegetarian
Masala Paniyaram With Leftover Idli/Dosa Batter Recipe,"Idli Dosa Batter, Mustard Seeds, Curry Leaves, Asafoetida, Shallots, Green Chilli  Finely, Coriander, Sunflower Oil, Salt",9,10,20,30,4,South Indian Recipes,Snack,Vegetarian
Grilled Cheese Sandwich Recipe With Scrambled Eggs,"Whole Egg, Dill Leaves Mintcoriander Leaves, Britannia Cheese Spread, Britannia Cheese Slice, Whole Wheat Brown Bread, Butter",6,10,10,20,4,Continental,World Breakfast,Eggetarian
Amritsari Sookhi Dal Recipe,"Black Urad Dal, Onion, Tomato, Green Chilli, Ginger, Coriander Leaves Finely  Salt, Coriander Powder, Turmeric Powder, Oil, Celery, Teaspoon Cumin, Asafetida, Coriander",13,30,20,50,4,Punjabi,Dinner,Vegetarian
Karnataka Style Moolangi Chutney ,"Radish, Onion, White Urad Dal, Chana Dal, Dry Red Chilli, Turmeric Powder, Asafetida, Tamarind, Salt, Oil, Mustard, Curry Leaves, Oil",13,10,10,20,4,Karnataka,Side Dish,Vegetarian
Spicy Chicken Curry Recipe In Naga Style,"Chicken Thigh, Tomato, Green Chilli, Garlic, Red Chilli Powder, Salt",6,5,45,50,4,Nagaland,Side Dish,High Protein Non Vegetarian
Senai Kizhangu Poriyal Recipe-Yam Poriyal Recipe,"Elephant Yam, Mustard Seeds, White Urad Dal, Dry Red Chilli, Asafoetida, Curry Leaves, Turmeric Powder, Coconut Oil, Chana Dal, White Urad Dal, Coriander, Dry Red Chilli, Tamarind",13,10,15,25,4,South Indian Recipes,Lunch,Diabetic Friendly
Crispy Corn Chaat Recipe,"Sweet Corn, All Purpose Flour, Red Chili Powder, Mango Powder, Oil, Salt, Onion, Lemon, Coriander",9,15,30,45,2,Indian,Snack,Vegetarian
Achari Masala Puri Recipe,"Whole Wheat Flour, Achari Masala, Ajwain, Red Chilli Powder, Black Pepper Powder, Salt, Sunflower Oil",7,20,20,40,4,Indian,Indian Breakfast,Vegetarian
Aam Pudina Ka Panna Recipe,"Mango, Mint Leaves, Lemon, Water, Cumin Powder, Black Salt, Jaggery, Ghee, Cumin Seeds, Asafoetida",10,10,10,20,4,Indian,Snack,Vegetarian
Spicy Raisins And Walnut Cake Recipe,"Water, Raisins, Butter, All Purpose Flour, Sugar, Baking Soda, Baking Powder, Salt, Cinnamon Powder, Nutmeg, Cloves, Whole Eggs, Walnuts, Caramel Sauce",14,30,35,65,4,Continental,Dessert,Vegetarian
Dal Palak ,"Yellow Moong Dal, Masoor Dal, Spinach, Tomato, Ginger, Turmeric Powder, Small Spoon Cumin Powder, Garam Masala Powder, Salt, Ghee, Cumin Seeds, Dry Red Chilli",12,10,40,50,2,North Indian Recipes,Dinner,Vegetarian
Baingan Bharta Recipe - Smoked Roasted Eggplant with Green Chillies and Ginger,"Brinjal, Ginger, Onion, Tomato, Green Chilli, Turmeric Powder, Garam Masala Powder, Coriander Powder, Ghee, Red Chilli Powder, Salt, Coriander",12,25,35,60,4,North Indian Recipes,Dinner,Vegetarian
Zucchini and Carrot Pasta Recipe,"Spirali Pasta, Onion, Tomato, Green Zucchini, Carrot, Green Chilli, Dried Oregano, Dried Basil Leaves, Black Pepper Powder, Salt, Extra Virgin Olive Oil, Sugar",12,10,30,40,2,Italian Recipes,Dinner,Vegetarian
Stuffed Chicken Pockets Recipe With Mint Mayo Recipe,"Boneless Chicken, Del Monte Mint Mayo, Ginger, Garlic, Whole Black Peppercorns, Mint Leaves, Coriander, Vinegar, Salt, Sunflower Oil, All Purpose Flour, Ghee, Salt, Lukewarm Water, Sunflower Oil",15,20,20,40,2,Continental,Appetizer,Non Vegeterian
Makhana Ka Raita Recipe,"Curd, Phool Makhana, Red Chilli Powder, Cumin Powder, Garam Masala Powder, Coriander, Salt, Ghee",8,5,5,10,4,Awadhi,Side Dish,Vegetarian
Corn & Paneer Baked Samosa Recipe,"All Purpose Flour, Ghee, Salt, Ajwain, Water Knead, All Purpose Flour, Paneer, Sweet Corn, Black Pepper Powder, Salt, Coriander",11,30,15,45,4,North Indian Recipes,Snack,Vegetarian
Baked Homemade Croutons Recipe With Herbs,"Whole Wheat Brown Bread, Extra Virgin Olive Oil, Garlic Powder, Mixed Herbs, Salt",5,10,20,30,4,Continental,Side Dish,Vegetarian
Vagharela Rotli Recipe,"Roti, Rye, Cumin Seeds, Curry Leaves, Red Chilli Powder, Turmeric Powder, Asafoetida, Oil, Salt",9,20,10,30,4,North Indian Recipes,Snack,Vegetarian
Fruit Custard ,"Milk, Custard Powder, Sugar, Apple, Bananas, Cherries, Fresh Cherries",7,10,20,30,4,Indian,Dessert,Vegetarian
Creamy Spaghetti Pasta Flavored With Cheesy Dip Recipe,"Del Monte Spaghetti Pasta, Del Monte Cheesy Dip, Red Yellowgreen Bell Pepper, Onion, Green Peas, Salt, Extra Virgin Olive Oil, Red Chilli Flakes Garnish, Fresh Herbs Garnish",9,20,20,40,4,Italian Recipes,Dinner,Vegetarian
Badanekaayi Gojju (Brinjal Curry) Recipe,"Small Brinjal, Onion, Mustard Seeds, Salt, Sunflower Oil, Coriander, Roasted Peanuts, Fresh Coconut, Raw Peanuts, Tamarind Paste, Dry Red Chilli, Cumin Seeds, Red Chilli Powder, Turmeric Powder, Salt",15,15,60,75,4,South Karnataka,Lunch,Vegetarian
Assamese Bhendir Sorsori Recipe (Okra In Mustard Sauce),"Bhindi, Sunflower Oil, Panch Phoran Masala, Dry Red Chilli, Bay Leaf, Salt, Turmeric Powder, Red Chilli Powder, Green Chilli, Mustard Seeds, Water, Turmeric Powder, Ginger",13,10,20,30,2,Assamese,Side Dish,Vegetarian
Pudalangai Milagu Kootu Recipe (South Indian Snake Gourd Curry),"Masoor Dal, Chana Dal, Snake Gourd, Turmeric Powder, Asafoetida, Salt, Dry Red Chilli, Coriander, Cumin Seeds, Whole Black Peppercorns, Chana Dal, White Urad Dal, Fresh Coconut, Sunflower Oil, Sunflower Oil, Mustard Seeds, White Urad Dal, Dry Red Chilli, Curry Leaves",19,20,30,50,4,South Indian Recipes,Side Dish,Diabetic Friendly
Spiced Cabbage Rice ,"Rice, Cabbage, Soya Chunks, Cumin Seeds, Bay Leaves, Lentil Sugar, Mess, Turmeric Powder, Red Chilli Powder, Black Pepper Powder, Onion, Ginger, Clove Garlic, Green Chilli, Green Coriander, Ghee, Oil, Salt",18,15,45,60,4,Indian,Lunch,Vegetarian
Bengali Style Cholar Dal ,"Chana Dal, Coconut, Ghee, Turmeric Powder, Sugar, Salt, Ghee, Dry Red Chilies, , Cinnamon, Bay Leaf, Cumin Seeds, Green Chilli, Ginger",14,15,45,60,4,Bengali Recipes,Dinner,Vegetarian
Lemon Cucumber Detox Water Recipe,"Chilled Water, Cucumber, Lemon, Mint Leaves",4,0,10,10,4,Continental,Appetizer,Vegetarian
Sweet Ragi Malt Recipe - Healthy Ragi Kanji/ Porridge Recipe,"Ragi Flour, Water, Milk, Jaggery, Almond Meal, Cardamom Powder, Dry Ginger Powder, Saffron Strands  A   Optional, Ghee Butter",9,5,15,20,2,South Indian Recipes,South Indian Breakfast,High Protein Vegetarian
Kashmiri Style Al Rogan Josh Recipe- Pumpkin In Red Curry,"Kaddu, Curd, Cardamom, Black Cardamom, Cloves, Cinnamon Stick, Bay Leaf, Whole Black Peppercorns, Fennel Powder, Asafoetida, Kashmiri Red Chilli Powder, Ratan Jot, Salt, Mustard Oil",14,10,25,35,4,Kashmiri,Lunch,Vegetarian
Mini Idli Upma Recipe (Steamed Rice Cake Stir Fry),"Idli, Onion, Mustard Seeds, White Urad Dal, Green Chilli, Ginger, Curry Leaves, Turmeric Powder, Sesame, Coriander, Salt",11,10,15,25,4,South Indian Recipes,South Indian Breakfast,Vegetarian
Mushroom And Scrambled Egg Bagel Sandwich Recipe,"Bagel, Butter, Button Mushrooms, Rosemary, Salt And Pepper, Whole Egg, Milk, Broccoli, Dried Oregano, Salt And Pepper, Fresh Cream",11,5,20,25,1,Continental,World Breakfast,Eggetarian
Italian Baked Eggplant in Tomato & Parmesan - Melanzane alla Parmigiana Recipe,"Brinjal, Garlic, Homemade Pizza And Pasta Sauce, Basil Leaves, Parmesan Cheese, Extra Virgin Olive Oil",6,10,90,100,4,Italian Recipes,Dinner,Vegetarian
Sarson Ka Saag Recipe - Classic North Indian Saag Recipe,"Mustard Greens, Spinach Leaves, Bathua Leaves, Makki Ka Atta, Ginger, Garlic, Onion, Green Chilli, Red Chilli Powder, Garam Masala Powder, Coriander Powder, Salt, Ghee",13,25,30,55,4,Punjabi,Side Dish,High Protein Vegetarian
Cheesy Stuffed Mushrooms With Spinach Recipe,"Button Mushrooms, Spinach, Garlic, Britannia Cheese Spread, Britannia Cheezza, Extra Virgin Olive Oil",6,10,35,45,4,Continental,Appetizer,High Protein Vegetarian
Chicken with Creamy Mushroom Sauce Recipe,"Button Mushrooms, Chicken Breasts, Mixed Herbs, Whole Black Pepper Corns, Red Chilli Powder, Onion, Garlic, Extra Virgin Olive Oil, Parsley Leaves, Fresh Cream, Cheese Spread, Salt",12,10,20,30,2,Continental,Main Course,High Protein Non Vegetarian
Tomato Dosa ,"Rice, White Urad Dal, Tomato, Fenugreek Seeds, Salt, Cooking Soda, Water, Oil Ghee",8,260,25,285,8,South Indian Recipes,South Indian Breakfast,Vegetarian
Beet and Avocado Chapati Recipe,"Beetroot, Avocado, Coriander, Mint Leaves, Whole Wheat Flour, Sesame Seeds, Cumin Powder, Green Chilli, Ginger, Salt, Extra Virgin Olive Oil",11,30,30,60,4,Indian,Indian Breakfast,Vegetarian
Karigadabu â Karnataka Style Karanji/ Gujiya recipe,"Whole Wheat Flour All Purpose Flour, Sooji, Handful Rice Flour, Ghee, Sunflower Oil Deep Fry, Roasted Gram Dal, Dessicated Coconut, Sugar, Cardamom",9,40,50,90,8,South Indian Recipes,Dessert,Vegetarian
Gobi and Soya Keema Recipe,"Gobi, Soy Chunks, Small Potato, Green Peas, Onion, Green Chili, Ginger, Buds Garlic, Salt, Ghee, Red Chilli Powder, Garam Masala Powder, Turmeric Powder, Coriander Powder, Bay Leaf, Of Green Coriander, Lemon Juice",17,10,30,40,4,North Indian Recipes,Lunch,Vegetarian
Turkish Pide Recipe - Crusty Bread with Sesame Seeds,"Whole Wheat Flour, All Purpose Flour, Active Dry Yeast, Caster Sugar, Salt, Extra Virgin Olive Oil, Black Sesame Seeds, Sesame Seeds",8,65,20,85,2,Middle Eastern,Side Dish,Vegetarian
Spinach & Corn Quesadilla Recipe,"Whole Wheat Flour, Salt, Extra Virgin Olive Oil, Water Knead, Spinach Leaves, Sweet Corn, Del Monte Cheesy Garlic Mayo, Extra Virgin Olive Oil",8,20,30,50,4,Mexican,Dinner,Vegetarian
Moroccan Spiced Millet And Lentil Salad Recipe,"Foxtail Millet, Mixed Lentils, Onion, Carrot, Tomato, Cucumber, Dates, Orange, Anardana Powder, Parsley Leaves, Mint Leaves, Extra Virgin Olive Oil, Fresh Orange Juice, Lemon Juice, Ras El Hanout Spice Blend, Kosher Salt",16,10,20,30,4,African,Dinner,Vegetarian
Apple Cinnamon Modak Recipe,"All Purpose Flour, Sooji, Rice Flour, Milk, Ghee, Salt, Sunflower Oil, Apples, Brown Sugar, Cinnamon Powder",10,15,40,55,4,Maharashtrian Recipes,Dessert,Vegetarian
"Roasted Apple, Onions and Cheese Focaccia Recipe","Active Dry Yeast, Sugar, Whole Wheat Flour, All Purpose Flour, Apples, Onion, Black Pepper Powder, Nutmeg Powder, Fresh Thyme Leaves, Feta Cheese, Salt",11,10,60,70,4,Italian Recipes,Side Dish,Vegetarian
Fried Barnyard Millet Recipe -Fried Samvat Rice,"Samvat Rice Vrat Ke Chawal, Ghee, Cumin Seeds, Whole Black Peppercorns, Green Chilli, Potato, Tomato, Coriander, Paneer, Lemon Juice, Cashew Nuts, Rock Salt Sendha Namak As Required",12,20,30,50,2,North Indian Recipes,Dinner,Vegetarian
Dahi Vada With Sweet & Spicy Chutney Recipe,"White Urad Dal, Cooking Soda, Salt, Tamarind Sauce  Red Chili Powder    Cumin Powder, As Per Use, Black Saltrock Salt, Chaat Masala Powder",7,30,45,75,4,South Indian Recipes,Snack,Vegetarian
Grilled Paneer Methi Tikki Recipe,"Paneer, Sunflower Oil, Red Chilli Powder, Coriander Powder, Turmeric Powder, Lemon Juice, Salt, Methi Leaves, Mint Leaves, Green Chilli, Garlic, Ginger, Onion, Kasuri Methi",14,180,20,200,6,Indian,Appetizer,High Protein Vegetarian
Futi Kadi Recipe,"Lukewarm Water, Kokum, Coriander, Asafoetida, Green Chilli, Sugar, Salt",7,10,30,40,2,Konkan,Snack,Vegetarian
Mirchicha Chatka (Fire Roasted Chillies With Yogurt Recipe),"Green Chilli, Cumin Seeds, Curd, Sugar, Salt, Coriander",6,10,15,25,4,Maharashtrian Recipes,Side Dish,Vegetarian
Dum Murgh Aatishi Recipe - Spicy Smoked Chicken Recipe,"Chicken, Anardana Powder, Red Chilli Powder, Cumin Powder, Lemon Juice, Salt, Ginger Garlic Paste, Whole Cashews, Poppy Seeds, Char Magaz, Fennel Seeds, Onion, Garlic, Ginger, Homemade Tomato Puree, Ghee, Dry Red Chilli, Garam Masala Powder, Red Chilli Powder, Coal, Fresh Cream",21,40,20,60,4,North Indian Recipes,Dinner,Non Vegeterian
Assamese Bilahir Tok Recipe,"Tomato, Turmeric Powder, Red Chilli Powder, Sugar, Salt, Mustard Oil, Panchon Masala, Leaf, Dry Red Chili",9,10,15,25,4,Assamese,Side Dish,Vegetarian
Baby Potato Salad with Onion & Cheese Recipe,"Baby Potato, Onion, Garlic, Mozzarella Cheese, Paprika Powder, Mixed Herbs, Red Chilli Flakes, Salt, Coriander",9,5,20,25,2,Continental,Appetizer,Vegetarian
Lemon Sevai Recipe,"Idli Rice, Lemon Juice, Turmeric Powder, Mustard, Green Chilli, Curry Leaves, Asafetida, Sesame Oil",8,120,40,160,2,South Indian Recipes,South Indian Breakfast,Vegetarian
Thotakura Pappu Recipe (Toor Dal with Amaranth Leaves),"Arhar Dal, Green Amaranth Leaves, Onion, Tomato, Garlic, Turmeric Powder, Salt, Mustard Seeds, White Urad Dal, Asafoetida, Curry Leaves, Dry Red Chilli, Sunflower Oil",13,10,25,35,4,Andhra,Lunch,High Protein Vegetarian
Egg Lifafa Paratha Recipe,"Whole Eggs, Sugar, Sunflower Oil, Onion, Tomato, Green Chilli, Red Chilli Powder, Chaat Masala Powder, Cumin Powder, Coriander, Salt, Mozzarella Cheese",12,30,10,40,2,Indian,North Indian Breakfast,Eggetarian
Chicken Kofta Curry Recipe,"Chicken Breasts, Onion, Garlic, Turmeric Powder, Red Chilli Powder, Garam Masala Powder, Coriander, Onion, Garlic, Ginger, Homemade Tomato Puree, Turmeric Powder, Red Chilli Powder, Garam Masala Powder, Coriander Powder, Salt, Fresh Cream, Honey, Coriander, Turmeric Powder, Salt, Sunflower Oil",22,10,45,55,4,Indian,Lunch,Non Vegeterian
Attirachi Kuzhambu Recipe - Spicy Mutton Gravy,"Mutton, Tomato, Sambar Powder, Garam Masala Powder, Bay Leaf, Coriander, Water, Salt, Sunflower Oil, Ginger, Garlic, Shallots, Cinnamon Stick, Cardamom, Star Anise, Fennel Seeds, Poppy Seeds, Mace, Stone Flower, Fresh Coconut, Mustard Seeds, Shallots, Curry Leaves, Curry Leaves",24,10,30,40,4,South Indian Recipes,Lunch,Non Vegeterian
Seer Fish Fry Recipe,"Seer Fish, Turmeric Powder, Red Chilli Powder, Salt, Ginger Garlic Paste, Corn Flour, Lemon, Tomato Ketchup, Sunflower Oil, Coriander",10,10,15,25,4,Indian,Side Dish,High Protein Non Vegetarian
Murunga Keerai Urula Poriyal Recipe - Moringa Aloo Sabzi,"Potato, Drumstick Leaves, Onion, Ginger, Turmeric Powder, Red Chilli Powder, Sambar Powder, Mustard Seeds, Sunflower Oil, Salt",10,15,40,55,4,South Indian Recipes,Lunch,Vegetarian
Masala Lemonade Recipe,"Lemons, Sugar, Water, Ginger, Cumin Powder, Black Pepper Powder, Black Salt, Mint Leaves, Cooking Soda",9,10,0,10,4,Indian,Snack,Vegetarian
Goan Style Maskachi Bhaji Recipe-Moringa Leaves Stir Fry With Jackfruit Seeds,"Drumstick Leaves, Jackfruit Seeds, Dry Red Chilli, Onion, Fresh Coconut, Jaggery, Turmeric Powder, Salt",8,10,30,40,4,Goan Recipes,Side Dish,Vegetarian
Homemade Mole Sauce Recipe,"Chipotle Peppers, Onion, Garlic, Tomato, Raw Peanuts, Star Anise, Cinnamon Stick, Cloves, Dark Chocolate, Dried Oregano, Black Pepper Powder, Raisins, Makki Ka Atta, Butter, Chicken Stock, Salt",16,10,60,70,4,Mexican,Side Dish,Vegetarian
Vazhaithandu Lemon Rasam Recipe - Banana Stem Lemon Rasam,"Plantain Stem, Curd, Water, Salt, Tomato, Garlic, Ginger, Coriander Powder, Cumin Powder, Red Chilli Powder, Turmeric Powder, Black Pepper Powder, Lemon Juice, Arhar Dal, Curry Leaves, Ghee, Mustard Seeds, Cumin Seeds, Ssp Asafoetida, Coriander",20,10,30,40,4,South Indian Recipes,Lunch,Vegetarian
Spinach and Banana Smoothie With Chia Seeds Recipe,"Spinach, Ripe Bananas, Badam, Coconut Milk, Chia Seeds",5,10,0,10,4,Continental,World Breakfast,Vegetarian
Carrot Custard Pudding Recipe,"Milk, Carrot, Custard Powder, Sugar",4,10,15,25,3,Indian,Dessert,Vegetarian
Hesarukaalu Upittu Recipe - Moong Dal Upma,"Yellow Moong Dal, Onion, Green Chilli, Asafoetida, Coriander, Green Peas, Dry Red Chilli, Mustard Seeds, White Urad Dal, Chana Dal, Turmeric Powder, Cashew Nuts, Enos Fruit Salt, Lemon, Ginger, Sunflower Oil, Salt, Fresh Coconut",18,20,30,50,4,Karnataka,Snack,Diabetic Friendly
Ajwain Besan Ka Paratha Recipe (Masala Paratha),"Whole Wheat Flour, Salt, Water, Sunflower Oil, Ajwain, Gram Flour, Red Chilli Powder, Turmeric Powder, Coriander, Cumin Seeds",10,20,20,40,4,Indian,Indian Breakfast,Vegetarian
Nutty Chocolate Banana Smoothie Recipe,"Ripe Bananas, Milk, Peanut Butter, Dates, Instant Oats, Cocoa Powder, Chia Seeds Nuts",7,10,0,10,2,Continental,World Breakfast,Vegetarian
High Protein Soya Idli Recipe,"Idli Rice, Soybeans, White Urad Dal, Methi Seeds, Chana Dal, Salt, Water",7,480,20,500,4,South Indian Recipes,South Indian Breakfast,High Protein Vegetarian
Varutharacha Mutta Curry Recipe,"Whole Eggs, Sunflower Oil, Mustard Seeds, Curry Leaves, Onion, Ginger, Garlic, Tomato, Dry Red Chilli, Cinnamon Stick, Cardamom, Cloves, Coriander, Whole Black Peppercorns, Shallots, Fresh Coconut, Fennel Seeds",17,10,30,40,2,Kerala Recipes,Side Dish,Eggetarian
Quick Honeyed Paneer Recipe,"Paneer, , Cream Milk, , Cumin Seeds, Cardamom Powder, Coriander Powder, Turmeric Powder, Red Chilli Powder, Kasuri Methi, Honey, Oil, Salt",13,25,40,65,4,Indian,Side Dish,High Protein Vegetarian
Spicy Sweet Potato Hash Brown Waffles Recipe,"Sweet Potato, Whole Eggs, Milk, Onion, Red Chilli Powder, Black Pepper Powder, Cumin Powder, Dried Oregano, Dried Thyme Leaves, Salt",10,15,30,45,4,Continental,World Breakfast,Eggetarian
Banana Bread With Chocolate Chips And Walnut Recipe,"All Purpose Flour, Baking Powder, Whole Eggs, Butter, Sunflower Oil, Brown Sugar, Sugar, Vanilla Extract, Ripe Bananas, Chocolate Chips, Walnuts, Walnuts",12,25,45,70,4,Continental,Snack,Eggetarian
Rustic Rosemary Garlic Zucchini Bread Recipe,"Whole Wheat Flour, All Purpose Flour, Lukewarm Water, Active Dry Yeast, Sugar, Salt, Garlic, Rosemary, Green Zucchini, Sunflower Seeds, Water Addthe Dough",11,40,60,100,4,Continental,Dinner,Eggetarian
Puri for Pani Puri Recipe -Golgappa/ Puchka Puri Recipe,"Sooji, All Purpose Flour, Salt, Sunflower Oil, Lukewarm Water, Sunflower Oil",6,5,45,50,40,North Indian Recipes,Snack,Vegetarian
Khamang Kakdi Recipe - Maharashtrian Cucumber Salad,"Cucumber, Fresh Coconut, Coriander, Roasted Peanuts, Curd, Salt, Sunflower Oil, Mustard Seeds, Asafoetida, Green Chilli, Curry Leaves",11,10,2,12,4,Maharashtrian Recipes,Side Dish,Vegetarian
Ajwaini Kache Kele Ki Sabzi Recipe -Plantains Cooked With Caraway Seeds,"Raw Banana, Cumin Seeds, Ajwain, Coriander Powder, Red Chilli Powder, Turmeric Powder, Amchur, Sunflower Oil, Coriander, Salt",10,10,20,30,4,Indian,Side Dish,Vegetarian
Almond Milk Chia Seeds Pudding With Fresh Fruits Recipe,"Chia Seeds, Almond Milk, Raisins, Walnuts, Vanilla Extract, Cinnamon Powder, Honey, Fresh Fruits",8,0,10,10,4,Continental,Dessert,Vegetarian
Lehsun Amla Chutney Recipe - Garlic Gooseberry Chutney,"Amla, Pearl Onion, Garlic, Green Chilli, Mint Leaves, Coriander, Salt, Sunflower Oil, Sunflower Oil, Mustard Seeds, White Urad Dal, Chana Dal, Curry Leaves, Cashew Nuts",14,5,10,15,3,Tamil Nadu,Side Dish,Vegetarian
Jwarichya Lahyancha Chivda Recipe - Maharashtrian Style Popped Jowar Chivda,"Jowar Seeds, Roasted Peanuts, Sunflower Oil, Mustard Seeds, Cumin Seeds, Curry Leaves, Maharashtrian Goda Masala, Asafoetida, Sugar, Red Chilli Powder, Turmeric Powder, Salt",12,10,10,20,4,Maharashtrian Recipes,Snack,Vegetarian
Aluchi Bhaji ,"Gm Arabic Leaves, Peanuts, Chana Dal, Oil, Cumin Seeds, Rye, Asafoetida, Dry Coconut, Amchur, Turmeric Powder, Jaggery, Green Chili, Salt",13,10,20,30,4,Maharashtrian Recipes,Lunch,High Protein Vegetarian
Mustard Vegetable Curry Recipe,"Sunflower Oil, Cumin Seeds, Garlic, Onion, Red Chilli Powder, Turmeric Powder, Coconut Milk, Vegetable Stock, Dijon Mustard, Carrots, Green Beans, Green Peas, Potato, Salt",14,20,30,50,4,Indian,Side Dish,Vegetarian
Shallow Fried Oysters Recipe,"Oysters  Wellrinsed And Drained In Colander, Sooji, Rice Flour, Sunflower Oil, Garam Masala Powder, Red Chilli Powder, Turmeric Powder, Salt",8,15,20,35,6,Indian,Appetizer,Non Vegeterian
Cabbage Thoran ,"Cabbage, Curry Leaves, Mustard, Red Chili, White Urad Dal, Turmeric Powder, Salt, Oil   Coconut  As Per Use, Tighten It, Small Onion, Garlic, Green Chilli, Curry Leaves, Green Chilli, Curry Leaves",15,15,30,45,4,Kerala Recipes,Lunch,Vegetarian
Thandai Nectarine Mini Galette Recipe,"Orange Nectarine, Butter, Whole Wheat Flour, Salt, Sugar, Butter, Curd, Cashew Nuts, Melon Seeds, Saffron Strands, Cinnamon Powder, Nutmeg Powder, Fennel Seeds, Badam, Pistachios, Poppy Seeds, Whole Black Peppercorns, Rose Petals, Sugar, Cardamom Powder",20,30,45,75,4,Fusion,Dessert,Vegetarian
Andhra Style Vankaya Kothimeera Karam Recipe,"Eggplant, Rye, White Urad Dal, Sprig Curry Leaf, Dry Red Chilli, Oil, Salt, Green Coriander, Green Chilli, Ginger, Cumin Seeds",11,10,20,30,4,Andhra,Lunch,Vegetarian
Karnataka Style Menthe Kadubu Recipe (Fenugreek Leaves Wheat Dumpling Recipe),"Whole Wheat Flour, Red Chilli Powder, Turmeric Powder, Ajwain, Salt, Methi Leaves, Onion, Cumin Seeds, Mustard Seeds, Red Chilli Powder, Turmeric Powder, Salt, Sunflower Oil",13,10,25,35,4,North Karnataka,South Indian Breakfast,Vegetarian
Dragon Chicken Sizzler Recipe,"Chicken, Baby Corn, Onion, Green Bell Pepper, Carrot, Whole Egg, Salt, Red Chilli Flakes, Corn Flour, White Pepper Powder, Schezwan Sauce, Tomato Ketchup, Sunflower Oil, Sugar, Button Mushrooms, Asparagus, Carrot, Onion, Ginger, Garlic, Fresh Red Chilli, Sunflower Oil, Teriyaki Sauce, White Pepper Powder, Salt, Fried Rice, French Fries",27,30,40,70,5,Indo Chinese,Dinner,Non Vegeterian
Decadent Chocolate Truffles Recipe,"Bitter Sweet Chocolate, Heavy Whipping Cream, Cinnamon Powder, Dark Chocolate, Butter, Cocoa Powder",6,20,240,260,4,Continental,Dessert,Vegetarian
Mushroom Tikka Masala Recipe (Mushroom & Bell Peppers In Spicy Tomato Gravy),"Curd, Kashmiri Red Chilli Powder, Garam Masala Powder Kitchen King Masala, Ginger Garlic Paste, Turmeric Powder, Gram Flour, Lemon Juice, Chaat Masala Powder, Button Mushrooms, Sunflower Oil, Green Bell Pepper, Cumin Seeds, Cloves, Cinnamon Powder, Cardamom, Clove Garlic, Ginger, Onion, Green Chilli Jalapenos, Cashew Nuts, Tomato, Bay Leaf, Garam Masala Powder, Sunflower Oil Ghee, Salt, Sunflower Oil Ghee, Kasuri Methi",27,40,25,65,3,North Indian Recipes,Side Dish,High Protein Vegetarian
Chicken Korma Recipe - Mughlai Style Chicken Curry,"Chicken, Black Pepper Powder, Kashmiri Red Chilli Powder, Sunflower Oil, Ginger Garlic Paste, Salt, Onion, Ginger, Garlic, Water, Sunflower Oil, Green Chilli, Cardamom, Curd, Ajwain, Garam Masala Powder, Coriander, Sunflower Oil",18,45,30,75,3,Mughlai,Dinner,High Protein Non Vegetarian
Cabbage Pachadi ,"Til Oil, White Urad Dal, Roasted Chana Dal, Cabbage, Green Chilli, Curry Leaves, Salt, As Per  Tamarind Paste, Water, Mustard, Asafetida, Dry Red Chilli, Oil",13,10,25,35,4,South Indian Recipes,Side Dish,Vegetarian
Basil & Cherry Tomato Omelette Recipe,"Whole Eggs, Basil Leaves, Cherry Tomato, Black Pepper Powder, Salt, Extra Virgin Olive Oil Drizzle",6,10,5,15,1,Continental,World Breakfast,Eggetarian
Bengali Phool Gobhir Paturi ,"Potato, Cabbage, Cumin Seeds, Poppy Seeds, Turmeric Powder, Green Chilies, Oil, Teaspoon Salt",8,10,30,40,4,Bengali Recipes,Lunch,Vegetarian
Carrot And Coriander Soup Recipe,"Carrot, Onion, Coriander, Green Chilli, Garlic, Cloves, Lemon, Salt, Black Pepper Powder, Coriander, Ghee Butter",11,10,15,25,2,Indian,Dinner,Vegetarian
Moong Cheese Kachori ,"Wheat Flour, Maida, Oats, Oil, Salt, Sprouted Moong, Sweet Potato, Mozzarella Cheese, Salt, Chilly Flax, Mixed Herbs",11,20,20,40,4,North Indian Recipes,Snack,Vegetarian
Warm Roasted Beet Salad Recipe - Roz Ka Khana With Figaro Olive Oil,"Garlic, Red Wine Vinaigrette, Extra Virgin Olive Oil, Honey, Beetroots, Feta Cheese, Pickled Jalapenos, Onion, Walnuts, Basil Leaves, Salt",11,10,20,30,4,Indian,Lunch,Eggetarian
Goan Shepeche Polle Recipe,"Rice, Black Urad Dal, Dill Leaves, Coconut, Jaggery, Salt, Ghee",7,240,30,270,4,Goan Recipes,South Indian Breakfast,Vegetarian
Goan Tendli Bhaji Recipe,"Tindora, Onion, Sunflower Oil, Mustard Seeds, Cumin Seeds, Red Chilli Powder, Coriander Powder, Turmeric Powder, Fresh Coconut, Curry Leaves, Salt",11,10,15,25,4,Goan Recipes,Lunch,Vegetarian
Bengali Style Urad Dal Vada Recipe,"White Urad Dal  Soaked Overnight, Onion, Green Chilli, , Salt, Oil",6,10,20,30,4,Bengali Recipes,Snack,Vegetarian
Milagu Kozhambu Recipe,"Pearl Onion, Garlic, Methi Seeds, Mustard Seeds, Gingelly Oil, Tamarind, Salt, Curry Leaves, Jaggery, Whole Black Peppercorns, Coriander, Arhar Dal, Dry Red Chilli, White Urad Dal, Asafoetida, Curry Leaves",16,15,25,40,3,Chettinad,Lunch,Vegetarian
Pappu Chekkalu Recipe - Andhra Style Spiced Rice Cracker,"Rice Flour, Chana Dal, Roasted Peanuts, Green Chilli, Ginger, Sunflower Oil, Curry Leaves, Salt",8,30,30,60,4,Andhra,Snack,Vegetarian
Kondakadalai Vazhathandu Puli Thengai Kuzhambu Recipe (Banana Stem Curry with Black Chickpeas Recipe),"Kala Chana, Banana Stem, Salt, Turmeric Powder, Methi Seeds, White Urad Dal, Dry Red Chilli, Coriander, Fresh Coconut, Tamarind Water, Sesame, Mustard Seeds, Curry Leaves",13,500,30,530,4,Tamil Nadu,Main Course,Diabetic Friendly
Vegetarian Sushi Recipe,"Seaweed Sheets, Cooked Rice, Carrot, Cucumber, Avocado, Rice Vinegar, Sugar, Salt",8,10,35,45,4,Japanese,Appetizer,Vegetarian
Ragi Murungai Keerai Adai Recipe-Finger Millet Flour & Drumstick Leaves Savory Flatbread,"Ragi Flour, Drumstick Leaves, Onion, Green Chilli, Cumin Seeds, Sunflower Oil, Salt, Lukewarm Water",8,20,30,50,4,South Indian Recipes,South Indian Breakfast,Diabetic Friendly
Shrewsbury Cookies Recipe (Butter Cookies),"All Purpose Flour, Butter, Sugar, Whole Eggs, Milk, Baking Soda, Salt",7,10,20,30,4,Continental,Snack,Vegetarian
"Beetroot, Aloo & Amaranth Leaves Sabzi Recipe","Beetroot, Baby Potato, Green Amaranth Leaves, Onion, Garlic, Green Chilli, Mustard Seeds, Cumin Seeds, Ssp Asafoetida, Turmeric Powder, Red Chilli Powder, Coriander Powder, Garam Masala Powder, Salt, Mustard Oil",15,10,35,45,4,North Indian Recipes,Side Dish,Vegetarian
Calamari Roast Recipe (Kerala Style Squid),"Squid, Shallots, Tomato, Ginger, Garlic, Curry Leaves, Coriander Powder, Red Chilli Powder, Turmeric Powder, Fennel Seeds, Whole Black Peppercorns, Meat Masala, Mustard Seeds, Coconut Oil",14,15,30,45,4,Kerala Recipes,Side Dish,Non Vegeterian
Roasted Tomato & Tortellini Soup Recipe,"Tomato, Onion, Garlic, Garlic, Whole Wheat Flour, Extra Virgin Olive Oil, Black Pepper Powder, Ricotta Cheese, Fresh Herbs, Vegetable Stock, Sugar, Salt, Parmesan Cheese",13,60,15,75,2,Italian Recipes,Dinner,Vegetarian
Watermelon Ice Popsicles Recipe,"Watermelon, Sugar, Lemon Juice",3,20,5,25,5,Continental,Dessert,Vegetarian
Matar Karanji /Gujiya Recipe (Maharashtrian Deep Fried Savoury Pastry),"All Purpose Flour, Sooji, Salt, Ghee, Water, Green Peas, Fresh Coconut, Green Chilli, Cumin Seeds, Asafoetida, Ajwain, Coriander, Mint Leaves, Lemon Juice, Salt, Sunflower Oil",16,15,45,60,4,Maharashtrian Recipes,Snack,Vegetarian
Diabetic Friendly Moong Sprout Cutlet Recipe,"Green Moong Sprouts, Spring Onion Greens, Instant Oats, Ginger, Green Chilli, Coriander Powder, Garam Masala Powder, Sunflower Oil Shallow Fry The Tikkis, Salt",9,10,20,30,4,Indian,Snack,Diabetic Friendly
Thai Red Curry with Chicken and Brinjal Recipe,"Chicken, Coconut Milk, Garlic, Stalk Lemon Grass, Thai Red Curry Paste, Brinjal, Broccoli, Vegetable Stock Water, Date Syrup, Salt, Sunflower Oil, Basil Leaves",12,5,30,35,4,Thai,Lunch,Non Vegeterian
No Onion No Garlic Cabbage Kofta Curry,"Cabbage, Flour, Green Chili, Coriander, Cumin Powder, Red Chilli Powder, Turmeric Powder, Garam Masala Powder, Salt, Oil, Make  Tomato, Ginger, Cream, Flour, Yogurt, , Red Chilli Powder, Turmeric Powder, Cumin Powder, Hot Masala Powder, Bay Leaves, Cardamom, Salt, Oil, Of Green Coriander",25,20,45,65,4,Indian,Dinner,Vegetarian
Konkani Style Pathravade/Pathrode Recipe-Colocasia Leaves Snack,"Colocasia Leaves, Basmati Rice, Green Moong Dal, Chana Dal, Coriander, Cumin Seeds, Fresh Coconut, Turmeric Powder, Tamarind, Jaggery, Dry Red Chilli, Salt, Coconut Oil",13,30,20,50,4,Konkan,Snack,Vegetarian
Rajma Saagwala (Dry Kidney Beans And Spinach Stir Fry) Recipe,"Rajma, Spinach Leaves, Sunflower Oil, Cumin Seeds, Onion, Garlic, Green Chilli, Turmeric Powder, Garam Masala Powder, Asafoetida, Salt",11,15,20,35,4,North Indian Recipes,Lunch,Vegetarian
Pakodi Koora ,"Brinjal, Cauliflower, Potato, Onion, Onion, Large Tablespoon Sesame, Peanuts, Red Chilli Powder, Coriander Powder, Coriander Seeds, Curry Leaves, Ginger Garlic Paste, Turmeric Powder, Flour, Rice Flour, Green Chilli, S Of Coriander, Salt, Oil",19,20,40,60,4,Indian,Dinner,Vegetarian
Beetroot Thoran Recipe,"Beetroot, Fresh Coconut, Mustard Seeds, Dry Red Chilli, Green Chilli, White Urad Dal, Curry Leaves, Salt, Red Chilli Powder, Turmeric Powder, Coriander Powder, Coconut Oil, Water",13,10,40,50,4,South Indian Recipes,Lunch,Vegetarian
Keerai Vadai Recipe (Spinach & Bengal Gram Fritters),"Chana Dal, Spinach, Green Chilli, Cumin Seeds, Salt, Ginger, Sunflower Oil",7,10,140,150,3,South Indian Recipes,Snack,Vegetarian
Baingan Ki Lonje Recipe - Uttar Pradesh Style Brinjal Sabzi,"Brinjal, Onion, Cloves, Ginger, Sugar, Ghee, Lemon Juice, Salt, Dry Red Chilli, Cinnamon Stick, Cardamom, Whole Black Peppercorns, Cloves",13,20,20,40,4,Uttar Pradesh,Side Dish,Vegetarian
Restaurant Style Phool Gobhi Masala Recipe,"Cauliflower, Turmeric Powder, Mustard Oil, Cumin Seeds, Bay Leaf, Ginger Garlic Paste, Water, Onion, Water, Garam Masala Powder, Kashmiri Red Chilli Powder, Homemade Tomato Puree, Fresh Cream, Ghee, Green Chilli, Cashew Nuts, Salt",17,15,25,40,2,Indian,Side Dish,Vegetarian
Adrak Chai Recipe,"Water, Milk, Tea Leaves, Ginger, Sugar",5,0,15,15,2,Indian,Side Dish,Vegetarian
Eggless French Rosy Apple Tart Recipe,"Butter, All Purpose Flour, Caster Sugar, Cinnamon Powder, Water, Apple, Water, Sugar, Cinnamon Powder, Butter",10,30,40,70,4,French,Dessert,Vegetarian
Korean Style Gochujang Recipe (Hot Pepper Paste Recipe),"Barley, Rice Flour, Red Chilli Powder, Jaggery, Soy Sauce, Salt",6,120,30,150,12,Korean,Vegetarian,Vegetarian
Chicken In Curry Leaves Gravy Recipe,"Boneless Chicken, Curry Leaves, Coriander, Mint Leaves, Green Chilli, White Pepper Powder, Salt, Lemon, Sunflower Oil Cook, Ginger Garlic Paste, Onion, Cherry Tomato Garnish",12,10,20,30,4,Indian,Side Dish,Non Vegeterian
Boondi And Spring Onion Greens Sabzi ,"Green Onion Leaves, Boondi, Green Chilli, Oil, Cumin Seeds, Asafoetida, Garlic, Turmeric Powder, Coriander Powder, Red Chilli Powder, Garam Masala Powder, Coconut Powder, Salt, Tomato, Water, Dry Mango Powder",16,10,10,20,4,North Indian Recipes,Lunch,Vegetarian
Coorg Koli Curry Recipe - Coorgi Chicken Curry,"Chicken, Red Chilli Powder, Turmeric Powder, Coriander, Cumin Seeds, Cinnamon Stick, Cloves, Poppy Seeds, Garlic, Ginger, Green Chilli, Salt, Sunflower Oil, Onion, Fresh Coconut, Tamarind Paste, Coriander",17,30,30,60,2,Coorg,Side Dish,Non Vegeterian
Kolambi Bhaath Recipe (Maharashtrian Prawn Rice),"Prawns, Rice, Tomato, Onion, Garlic, Ginger, Green Chilli, Curry Leaves, Kashmiri Red Chilli Powder, Salt, Turmeric Powder, Cloves, Cinnamon Stick, Cardamom, Bay Leaves, Sugar, Maharashtrian Goda Masala, Asafoetida, Cumin Seeds, Sunflower Oil",20,20,30,50,4,Maharashtrian Recipes,Lunch,Non Vegeterian
Grilled Pineapple and Chicken Salad Recipe- Tangy Summer Salad,"Chicken Breasts, Pineapple, Arugula Leaves, Thai Red Chilli, Extra Virgin Olive Oil, Extra Virgin Olive Oil, Garlic, Honey, Tabasco Original, Salt And Pepper",10,15,15,30,4,Continental,Appetizer,High Protein Non Vegetarian
Soya Chunk And Green Peas Sabzi Recipe,"Soybeans, Green Peas, Bay Leaf, Cumin Seeds, Red Chilli Powder, Turmeric Powder, Garam Masala Powder, Coriander Powder, Salt, Sunflower Oil, Tomato, Green Chilli, Ginger",13,10,30,40,4,Indian,Lunch,Vegetarian
Low Fat Apple Crumble with Muesli Recipe,"Apples, Milk, Corn Flour, Nutmeg Powder, Salt, Muesli, Whole Wheat Flour, Butter",8,10,35,45,4,Continental,Dessert,Sugar Free Diet
Jal Jeera Recipe - Indian Spiced Lemonade,"Cumin Seeds, Black Salt, Mint Leaves, Lemon Juice, Salt",5,10,0,10,2,Indian,Snack,Vegetarian
Oriya Style Parval Sabzi ,"Parwal, Cumin Seeds, Tomato Puree, Turmeric Powder, Red Chilli Powder, Cashews, Salt, Oil, Ginger, Cardamom, Cinnamon, , Green Chilli, Coconut, Poppy Seeds   Cheese  Grated, Coriander, Black Pepper Powder, Green Chili, Chisemis, Salt, Coriander",21,30,50,80,4,Oriya Recipes,Lunch,Vegetarian
Chicken Curry With Sweet Potatoes Recipe,"Chicken, Sweet Potato, Coriander, Curd, Salt, Turmeric Powder, Red Chilli Powder, Sunflower Oil, Onion, Garlic, Ginger, Green Chilli, Homemade Tomato Puree, Whole Black Peppercorns, Cloves, Cinnamon Stick, Cumin Seeds, Coriander, Byadagi Dried Chilli",19,10,60,70,3,North Indian Recipes,Dinner,Non Vegeterian
Haryali Seekh Kebab Recipe,"Potato, Broccoli, Chana Dal, Spinach Leaves, Mint Leaves, Coriander, Cloves, Cardamom, Ginger, Black Pepper Powder, Lemon Juice, Cashew Nuts, Green Chilli Paste, Onion, Green Chutney, Curd, Chaat Masala Powder",17,20,60,80,6,Indian,Appetizer,Vegetarian
Pineapple Gojju Recipe (Karnataka Style Tangy And Spicy Pineapple Curry),"Pineapple, Fresh Coconut, White Urad Dal, Tamarind Paste, Dry Red Chilli, Jaggery, Salt, Mustard Seeds, Curry Leaves, Sunflower Oil",10,15,30,45,4,North Karnataka,Lunch,Vegetarian
Ragi Halbai Recipe - Karnataka Style Ragi Halwa Recipe,"Ragi Flour, Fresh Coconut  Grated, Jaggery  Organic, Ghee",4,20,45,65,10,Karnataka,Dessert,Vegetarian
Chicken Kathi Roll Recipe,"Wheat Flour, Oil Knead, Salt, Oil, Chicken Breast, Hung Curd, Tandoori Masala, Lemon Juice, Turmeric Powder, Salt, Ginger, Garlic, Onion, Capsicum, Onion, Chaat Masala Powder Pour Over, Eggs",17,15,25,40,4,Indian,Main Course,Non Vegeterian
Beetroot and Fig Chutney Recipe,"Fresh Figs, Beetroot, Ajwain, Nutmeg, Red Chilli Powder, Garlic, Green Chilli",7,10,25,35,4,North Indian Recipes,Side Dish,Vegetarian
Achari Paneer Recipe -Spicy Pickled Paneer Gravy,"Paneer, Sunflower Oil, Onion, Garlic, Ginger, Pachranga Pickle, Fennel Seeds, Red Chilli Powder, Turmeric Powder, Coriander Powder, Garam Masala Powder, Water, Homemade Tomato Puree, Honey, Salt, Fresh Cream, Kasuri Methi",17,30,30,60,4,North Indian Recipes,Lunch,High Protein Vegetarian
Sev Puri Recipe (Papdi Chaat) - Indian Street Food Evening Snack,"Papdi Puris, Sweet Chutney, Green Chutney, Potato, Onion, Green Moong Sprouts, Sev, Curd, Chaat Masala Powder, Cumin Powder, Red Chilli Powder, Coriander",12,30,5,35,4,North Indian Recipes,Snack,Vegetarian
Fresh Fig Compote Recipe For Desserts,"Fresh Figs, Butter, Nutmeg, Brown Sugar, Honey",5,5,10,15,4,Continental,Dessert,Vegetarian
Vellai Seedai Recipe - Krishna Janmashtami | Gokulashtami Recipe,"Rice, White Urad Dal, Roasted Gram Dal, Sesame Seeds, Fresh Coconut, Jaggery, Water, Cardamom Powder, Ghee, Sunflower Oil",10,700,20,720,40,South Indian Recipes,Snack,Vegetarian
Mixed Vegetable Handvo Recipe - Savory Rice & Lentil Cake,"Basmati Rice, White Urad Dal, Green Moong Dal, Chana Dal, Curd, Bottle Gourd, Carrots, Onion, Enos Fruit Salt, Lemon Juice, Caster Sugar, Red Chilli Powder, Turmeric Powder, Green Chilli, Ginger Garlic Paste, Salt, Sunflower Oil, Mustard Seeds, Curry Leaves, Dry Red Chilli, Black Sesame Seeds, Sesame Seeds",22,15,35,50,6,Gujarati Recipesï»¿,Indian Breakfast,Vegetarian
Spinach Yogurt Salad ,"Curd, Spinach, Red Chili Powder, Cumin Powder, Sugar, Whole Pepper, Salt, Oil, Mustard, White Urad Dal, Curry Leaves",11,135,15,150,4,Indian,Side Dish,Vegetarian
Nawabi Kofta Curry Recipe,"Potato, Of Cottage Cheese, Cashews, Raisins, Green Chilli, Coriander, Salt, Oil, Tomato Puree, Onion, Garlic, Ginger, Fennel Seeds, Coriander Seeds, , Cinnamon, Cardamom, Turmeric Powder, Teaspoon Red Chilli Powder, Cream, Sugar, Salt, S Of Coriander",23,30,45,75,4,Kashmiri,Dinner,Vegetarian
Kothamalli Rava Upma Recipe - Coriander Semolina Pudding,"Sooji, Onion, Green Chilli, Mustard Seeds, Black Urad Dal, Curry Leaves, Salt, Sugar, Hot Water, Lemon Juice, Coriander, Ginger, Green Chilli",13,10,30,40,4,Tamil Nadu,South Indian Breakfast,Vegetarian
Fresh Mango Salsa Recipe,"Mango, Extra Virgin Olive Oil, Green Chilli, Onion, Cumin Powder, Salt, Lemon Juice, Coriander",8,10,20,30,4,Mexican,Snack,Vegetarian
Besan & Atta Ki Roti Recipe (Chickpea Flatbread),"Gram Flour, Whole Wheat Flour, Salt, Red Chilli Powder, Turmeric Powder, Ajwain, Coriander Powder, Onion, Green Chilli, Coriander, Ghee Oil For Cooking",11,20,20,40,4,Indian,Dinner,Vegetarian
Instant Tindora And Carrot Pickle Recipe,"Carrot, Tindora, Turmeric Powder, Sesame, Salt, Garlic, Green Chilli, Curry Leaves, Asafoetida, Mustard Seeds, Methi Seeds, Coriander, Dry Red Chilli",13,10,30,40,4,Indian,Side Dish,Vegetarian
Stuffed Cabbage Rolls Recipe,"Cabbage, Cooked Rice, Button Mushrooms, Carrot, Onion, Garlic, Black Pepper Powder, Mixed Herbs, Sunflower Oil, Salt, Tomato, Onion, Garlic, Black Pepper Powder, Red Chilli Powder, Sunflower Oil, P Sugar, Salt",18,10,60,70,4,Continental,Appetizer,Vegetarian
Cheesy Chinese Banana Toffee Fritters Recipe,"All Purpose Flour, Rice Flour, Corn Flour, Cheddar Cheese, Ripe Bananas, Sunflower Oil Deep Fry, Sugar, Sesame Seeds, Chilled Water",9,20,15,35,4,Chinese,Dessert,Vegetarian
Ingi Mangai Sadam Recipe,"Mustard Seeds, White Urad Dal, Green Chilli, Curry Leaves, Ginger, Mango, Turmeric Powder, Cooked Rice, Coriander, Salt",10,10,30,40,4,South Indian Recipes,Lunch,Vegetarian
Makki Ki Puri Recipe,"Maize Flour, Wheat Flour, Oil, Celery, Salt",5,20,30,50,4,Indian,Indian Breakfast,Vegetarian
Korean Stew Recipe With Tofu & Vegetables,"Sesame, Red Chilli Flakes, Onion, Clove Garlic, Soy Sauce, Vegetable Stock, Tofu, Green Zucchini, Spinach, Green Bell Pepper, Spring Onion, Salt And Pepper",12,20,30,50,2,Korean,Dinner,Vegetarian
Vadu Mangai Pickle Recipe - Tender Small Raw Mango Pickle,"Mango, Red Chilli Powder, Mustard Seeds, Rock Salt",4,30,45,75,15,South Indian Recipes,Side Dish,Vegetarian
Kesar Pista Lassi Recipe - Saffron & Pista Lassi Recipe,"Curd, Sugar Honey, Fresh Cream, Saffron Strands, Pistachios, Ice Cubes",6,15,10,25,2,Indian,Side Dish,Vegetarian
Gular Ki Sabzi Recipe/ Shallow Fried Cluster Fig,"Cluster Fig, Rice, Salt, Red Chilli Powder, Turmeric Powder, Coriander Powder, Lemon Juice, Ginger, Garlic, Onion, Green Chilli Paste, Sunflower Oil Shallow Fry",12,45,20,65,4,Lucknowi,Side Dish,Vegetarian
Multani Kaali Arbi ,"Gm Arabic, Oil, Salt, Red Chilli Powder, Of Green Coriander",5,10,30,40,4,North Indian Recipes,Lunch,Vegetarian
Methi Malai Paneer Recipe,"Methi Leaves, Paneer, Kasuri Methi, Milk, Fresh Cream, Butter Gheeoil, Cumin Seeds, Bay Leaf, Red Chilli Powder, Turmeric Powder, Coriander Powder, Salt, Garam Masala Powder, Onion, Garlic, Tomato, Green Chilli, Cashew Nuts",18,20,20,40,4,North Indian Recipes,Lunch,High Protein Vegetarian
Brahmi Chutney ,"Brahmi Leaves, Coconut  Tightly Tamarind  A Little, Salt, Coconut Oil",4,10,5,15,4,South Indian Recipes,Side Dish,Vegetarian
Sweet & Spicy Pineapple Pani Puri Recipe,"Pani Puris, Green Moong Sprouts, Potato, Salt, Chaat Masala Powder, Cumin Powder, Red Chilli Powder, Pineapple, Green Chilli, Chaat Masala Powder, Cumin Powder, Sugar, Black Salt, Lemon Juice",14,15,0,15,4,North Indian Recipes,Appetizer,Vegetarian
Egg Curry Masala Recipe With Sunny Side Up Eggs,"Whole Eggs, Sunflower Oil, Onion, Homemade Tomato Puree, Red Chilli Powder, Turmeric Powder, Coriander Powder, Coconut Milk, Coriander, Salt",10,20,15,35,4,Indian,Dinner,Eggetarian
Bhindi Gosht Recipe-Okra With Meat In Coconut Gravy,"Mutton, Bhindi, Onion, Ginger Garlic Paste, Curry Leaves, Coconut Milk, Salt, Red Chilli Powder, Cumin Powder, Coriander Powder, Tamarind Paste, Sunflower Oil, Turmeric Powder",13,10,30,40,8,Indian,Lunch,Non Vegeterian
Masala Ulundu Vadai Recipe,"White Urad Dal, Mustard Seeds, Shallots, Carrot, Green Chilli, Mint Leaves, Curry Leaves, Whole Black Peppercorns, Sunflower Oil",9,150,20,170,20,South Indian Recipes,South Indian Breakfast,Vegetarian
Eggless Thandai Mini Cheesecake Recipe,"Marie Biscuit Any Digestive Cookies, Butter, Britannia Cream Cheese, Condensed Milk, Vanilla Extract, Rose Water, Thandai Masala, Badam, Cashew Nuts, Poppy Seeds, Fennel Seeds, Cardamom Powder, Black Pepper Powder, Melon Seeds",14,10,90,100,2,Fusion,Dessert,Vegetarian
Carrot Beans Thoran Recipe - Kerala Thoran For Onam Sadya,"Fresh Coconut, Green Chilli, Cumin Seeds, Carrots, Green Beans, Coconut Oil Regular Oil, Mustard Seeds, White Urad Dal, Pearl Onion, Curry Leaves, Turmeric Powder, Salt",12,15,35,50,4,Kerala Recipes,Dinner,Vegetarian
Aloo Methi Masala Recipe - Potato & Fenugreek Leaves Gravy,"Potato, Methi Leaves, Tomato, Onion, Whole Black Peppercorns, Dry Red Chilli, Cloves, Bay Leaf, Sunflower Oil, Salt, Red Chilli Powder, Turmeric Powder, Garam Masala Powder, Coriander Powder, Asafoetida, Cumin, Coriander",17,15,35,50,4,Indian,Lunch,Vegetarian
Srilankan Style Sambol Recipe,"Onion, Sugar, Curry Leaves, Cinnamon Stick, Cloves, Cardamom, Red Chilli Flakes, Tamarind Water, Salt And Pepper",9,5,30,35,4,Sri Lankan,Side Dish,Vegetarian
Mooga Gathi ,"Sprouts, Coconut, Whole Black Peppers, Dry Red Chilli, Coriander Seeds, Turmeric Powder, Tamarind Paste, Rye, , Asafoetida, Jaggery, Oil",12,540,40,580,4,Goan Recipes,Lunch,High Protein Vegetarian
Parwal Masala Recipe,"Gm Parwal, Tomato, Watermelon, Ginger, Red Chilli Powder, Coriander Powder, Cumin Powder, Garam Masala Powder, Bay Leaf, Salt, Oil",11,10,20,30,4,North Indian Recipes,Lunch,Vegetarian
Whole Wheat Vegetarian Stromboli Recipe,"Whole Wheat Flour, Active Dry Yeast, Honey, Extra Virgin Olive Oil, Salt, Lukewarm Water, Onion, Tomato Basil Pasta Sauce, Red Bell Pepper, Button Mushrooms, Black Olives, Mozzarella Cheese, Whole Eggs",13,120,80,200,6,Italian Recipes,Dinner,Vegetarian
Bhaat Na Rasawala Muthia Dhokla Recipe | Gujarati Rasiya Dhokla,"Cooked Rice, Gram Flour, Red Chilli Powder, Turmeric Powder, Salt, Gram Flour, Curd, Water, Turmeric Powder, Red Chilli Powder, Salt, Green Chilli, Ginger, Bay Leaf, Cinnamon Stick, Ghee, Cumin Seeds, Cinnamon Stick, Curry Leaves",19,20,20,40,6,Gujarati Recipesï»¿,Dinner,Vegetarian
Broccoli Paratha Recipe,"Broccoli, Onion, Coriander Powder, Salt, Red Chilli Powder, Garam Masala Powder, Cumin Powder, Sunflower Oil, Whole Wheat Flour, Salt, Water, Sunflower Oil Ghee For Frying Paratha",12,30,30,60,3,North Indian Recipes,Lunch,Vegetarian
Pudina Dahi Chutney Recipe- Mint Yoghurt Dip,"Curd, Coriander, Mint Leaves, Green Chilli, Ginger, Salt, Sunflower Oil",7,15,0,15,4,North Indian Recipes,Side Dish,Vegetarian
Gulab Sandesh Recipe - Cottage Cheese Flavored with Rose Water,"Chenna, Sugar, Rose Water, Pistachios, Fresh Rose Petals",5,5,30,35,4,North Indian Recipes,Dessert,Vegetarian
Pudina Chutney Recipe,"Mint Leaves, Fresh Coconut, Coriander, Dry Red Chilli, Tamarind Paste, White Urad Dal, Jaggery, Turmeric Powder, Salt, Sunflower Oil, Mustard Seeds, White Urad Dal, Curry Leaves, Dry Red Chilli, Asafoetida",15,10,20,30,4,North Indian Recipes,Side Dish,Vegetarian
Drumstick Leaves Kadhi Pakora Recipe - Moringa Kadhi Pakora,"Drumstick Leaves, Gram Flour, Red Chilli Powder, Turmeric Powder, Enos Fruit Salt Baking Powder, Ajwain, Asafoetida, Sunflower Oil, Curd, Gram Flour, Turmeric Powder, Salt, Ghee, Mustard Seeds, Fresh Red Chilli, Cinnamon Stick, Curry Leaves, Coriander",18,30,20,50,4,North Indian Recipes,Lunch,Vegetarian
Banana Sheera Recipe - Sweet Banana Halwa/ Pudding,"Ripe Bananas, Cardamom, Sooji, Milk, Hot Water, Jaggery, Ghee, Cashew Nuts, Raisins, Saffron Strands",10,5,20,25,4,Maharashtrian Recipes,Dessert,Vegetarian
Bandhakopir Ghonto Recipe (Bengali Style Cabbage Fry),"Cabbage, Potato, Green Peas, Tomato, Green Chilli, Ginger, Mustard Oil Fry Potato, Red Chilli Powder, Turmeric Powder, Coriander Powder, Garam Masala Powder, Sugar, Salt, Mustard Oil, Cumin Seeds, Bay Leaf, Dry Red Chilli",17,10,20,30,4,Bengali Recipes,Lunch,Vegetarian
Okra Bamia ,"Okra, Tomato, Peel And Then Grind, Onion, Garlic, Coriander Powder, Red Chili Powder, Lemon Juice, Tablespoon Olive Oil, Salt",10,20,25,45,4,Middle Eastern,Lunch,Vegetarian
Mithi Mathri Recipe (Crispy Fried Sweet Fritters),"All Purpose Flour, Chiroti Rava, Salt, Ghee, Lukewarm Water, Water, Sugar, Cardamom Powder",8,30,45,75,4,Indian,Snack,Vegetarian
Pumpkin Kofta Curry Recipe,"Kaddu, Potato, Red Chilli Powder, Fennel Seeds, Coriander Powder, Corn Flour, Gram Flour, Coriander, Onion, Tomato, Ginger, Garlic, Green Chilli, Turmeric Powder, Garam Masala Powder, Amchur, Cardamom, Cloves, Curd",19,10,35,45,4,Indian,Lunch,Diabetic Friendly
Simple Mutton Curry With Coconut Recipe,"Mutton, Onion, Ginger Garlic Paste, Tomato, Cloves, Whole Black Peppercorns, Cinnamon Stick, Fennel Seeds, Black Cardamom, Bay Leaves, Green Chilli, Red Chilli Powder, Turmeric Powder, Curry Leaves, Extra Virgin Olive Oil, Water, Curd, Red Chilli Powder, Turmeric Powder, Salt, Fresh Coconut, Ginger, Garlic, Water",24,30,50,80,4,South Indian Recipes,Dinner,Non Vegeterian
"Sun Dried Tomato, Sprouts And Cream Cheese Bagel Sandwich Recipe","Britannia Cream Cheese, Bean Sprouts, Sun Dried Tomato, Parsley Leaves, Dried Figs, Lemon Juice, Salt, Bagel",8,20,0,20,4,Continental,World Breakfast,Vegetarian
Suran Ki Sabzi Recipe - Jimikand Masala Sabzi Recipe,"Elephant Yam, Green Peas, Ginger, Homemade Tomato Puree, Turmeric Powder, Kashmiri Red Chilli Powder, Garam Masala Powder, Curd, Cinnamon Stick, Cloves, Black Cardamom, Coriander, Ghee, Salt",14,15,30,45,3,North Indian Recipes,Main Course,Vegetarian
Rajma Kofta In Milk And Poppy Seed Gravy Recipe,"Rajma, Cashew Nuts, Raisins, Asafoetida, Cumin Seeds, Gram Flour, Red Chilli Powder, Coriander, Ghee, Poppy Seeds, Fresh Cream, Milk, Garam Masala Powder, Water, Salt, Saffron Strands",16,20,30,50,6,North Indian Recipes,Side Dish,High Protein Vegetarian
Andhra Style Mukkala Pulusu Recipe-Sweet Tangy Vegetable Stew,"Potato, Drumstick, Bottle Gourd, Pearl Onion, Green Chilli, Jaggery, Tamarind Water, Turmeric Powder, Salt, Coriander, Methi Seeds, Dry Red Chilli, Chana Dal, White Urad Dal, Cumin Seeds, Mustard Seeds, Curry Leaves, White Urad Dal, Red Chilli Powder, Asafoetida",20,10,20,30,4,Andhra,Lunch,Vegetarian
Tomato Chutney Recipe,"Onion, Tomato, Fresh Coconut, Green Chilli, Dry Red Chilli, Kashmiri Dry Red Chilli, Chana Dal, Coriander, Sunflower Oil, Salt, Sunflower Oil, Mustard Seeds, Curry Leaves, Asafoetida, Dry Red Chilli",15,20,15,35,8,South Indian Recipes,South Indian Breakfast,Vegetarian
Instant Bengali Aam Doi Recipe  - No Cook Sweet Mango Yogurt,"Heavy Whipping Cream, Condensed Milk, Mango, Curd, Saffron Strands",5,15,0,15,4,Bengali Recipes,Dessert,Vegetarian
Sabudana Khichdi Recipe With Vegetables (No Onion No Garlic Fasting/Vrat Recipes),"Sabudana, Carrot, Green Beans, Green Peas, Green Chilli, Cloves, Cardamom, Bay Leaves, Badam, Cashew Nuts  Toasted, Salt, Ghee",12,15,30,45,2,Indian,North Indian Breakfast,Vegetarian
Badanekaayi Gojju Recipe,"Eggplants, Onion, Rye, Salt, Oil, Green Coriander, Peanuts, Coconut, Spoon Peanuts, Tamarind Paste, Dry Red Chilli, Cumin Seeds, Red Chilli Powder, Turmeric Powder, Salt",15,15,60,75,4,South Karnataka,Lunch,Vegetarian
Papad Raita Recipe,"Curd, Papad, Cumin Powder, Paprika Powder, Coriander, Rock Salt",6,10,10,20,4,Indian,Side Dish,Vegetarian
Arbi Ka Saag ,"Arabica, Oil, Mustard, Asafoetida, Green Chili, Ginger Garlic Paste, Onion, Yogurt, Red Chilli Powder, Turmeric Powder, Coriander Powder, Salt, Water, Coriander",14,10,10,20,2,North Indian Recipes,Lunch,Vegetarian
Corn Chilli Cheese Momos Recipe,"All Purpose Flour, Salt, Water, Garlic, Ginger, Green Chilli, Sweet Corn, Black Pepper Powder, Red Chilli Flakes, Britannia Cheezza, Britannia Cheese Spread, Sriracha Sauce, Veeba Sweet Chilli Sauce, Soy Sauce",14,30,20,50,4,Indo Chinese,Appetizer,Vegetarian
Methi Pakoda Kadhi Recipe - Punjabi Kadhi Pakora,"Methi Leaves, Onion, Gram Flour, Red Chilli Powder, Turmeric Powder, Enos Fruit Salt Baking Powder, Ajwain, Asafoetida, Sunflower Oil, Curd, Gram Flour, Turmeric Powder, Red Chilli Powder, Coriander Powder, Salt, Ghee, Cumin Seeds, Dry Red Chilli, Cinnamon Stick, Coriander",20,10,25,35,4,North Indian Recipes,Lunch,Vegetarian
Hurali Saaru Recipe - Healthy Horse Gram and Coconut Curry,"Horse Gram Dal, Onion, Tomato, Potato, Cup Tamarind Water, Onion, Tomato, Fresh Coconut, Cloves, Cinnamon Stick, Ginger, Garlic, Sambar Powder, Onion, Mustard Seeds, Dry Red Chilli, Curry Leaves, Asafoetida, Ghee",19,10,30,40,2,Tamil Nadu,Dinner,High Protein Vegetarian
Punjabi Style Spicy Arbi Sabji Recipe,"Colocasia Root, Onion, Green Chilli  Slit Lengthwise, Ghee, Cumin Seeds, Salt, Red Chilli Powder, Garam Masala Powder, Amchur, Turmeric Powder, Coriander",11,10,45,55,4,Punjabi,Lunch,Vegetarian
Veggie Rava Idli Recipe- Healthy Breakfast Idli,"Sooji, Curd, Ginger, Sweet Corn, Green Peas, Carrot, Coriander, Green Chilli, Mustard Seeds, Chana Dal, Curry Leaves, Sunflower Oil, Salt, Enos Fruit Salt, Water, Water",16,10,30,40,4,South Indian Recipes,South Indian Breakfast,Vegetarian
Kerala Style Konju Curry With Thengakothu Recipe (Kerala Style Prawn Curry),"Prawns, Onion, Ginger, Garlic, Red Chilli Powder, Coriander Powder, Turmeric Powder, Fresh Coconut, Kokum, Kokum, Curry Leaves, Water, Salt, Coconut Oil, Mustard Seeds, Methi Powder, Curry Leaves",17,10,30,40,4,Kerala Recipes,Lunch,Non Vegeterian
Healthy Kabuli Chana Pakora Recipe,"Kabuli Chana, Onion, Green Chilli, Garlic, Coriander, Mint Leaves, Red Chilli Powder, Fennel Seeds, Salt",9,300,30,330,6,North Indian Recipes,Snack,Vegetarian
Caramelized Coconut Cake Recipe,"Whole Wheat Flour, All Purpose Flour, Baking Powder, Baking Soda, Sugar, Coconut Milk, Sunflower Oil, Whole Eggs, Fresh Coconut, Vanilla Extract, Salt, Water, Butter",13,30,35,65,10,Continental,Dessert,Eggetarian
"Rava Upma Recipe With Peanuts, Peas & Corn","Cup Sooji, Mustard Seeds, Ghee, Raw Peanuts, Cumin Seeds, Onion, Ginger, P Asafoetida, White Urad Dal, Green Chilli, Curry Leaves, Carrot, Green Bell Pepper, Tomato, Green Peas, Sweet Corn, Coriander, Lemon Juice, Salt, Red Chilli Powder, Coriander Powder, Anardana Powder",22,10,20,30,4,South Indian Recipes,South Indian Breakfast,Diabetic Friendly
Mint Vegetables Moilee Recipe (Mixed Vegetables Cooked In Minty Coconut Milk),"Mixed Vegetables, Onion, Tomato, Green Chilli, Ginger, Garlic, Curry Leaves, Coconut Milk, Coconut Milk, Mustard Seeds, Black Pepper Powder, Sunflower Oil, Coconut Oil, Lemon Juice, Mint Leaves, Salt",16,15,20,35,4,Kerala Recipes,Lunch,Vegetarian
Dhungare Baingan Recipe,"Brinjal, Curd, Green Chilli, Cumin Powder, Kashmiri Red Chilli Powder, Garam Masala Powder, Onion, Salt, Ghee, Coriander",10,5,20,25,4,Lucknowi,Side Dish,Vegetarian
Chatpate Aloo Recipe With Sesame Seeds,"Baby Potato, Sesame Seeds, Sunflower Oil, Salt, Red Chilli Powder, Coriander Powder, Turmeric Powder, Cumin Powder, Amchur, Garam Masala Powder, Coriander",11,15,15,30,4,Punjabi,Side Dish,Vegetarian
Thai Spicy Green Papaya Salad Recipe With Sweet Corn - Som Tum Khao Pod,"Raw Papaya, Carrots, Sweet Corn, Tomato, Thai Red Chilli, Roasted Peanuts, Ginger, Garlic, Light Soy Sauce, Palm Sugar Honey, Salt",11,15,20,35,2,Thai,Side Dish,Vegetarian
Super Easy Eggless Banana Clafoutis Recipe,"Ripe Bananas, Sugar, Custard Powder, Butter, Milk, Confectioners Sugar",6,15,35,50,2,French,Dessert,Vegetarian
Japanese Cotton Cheesecake Recipe,"Milk, Cardamom Powder, Saffron Strands, Sugar, Rabdi, Whole Eggs, Britannia Cream Cheese, Butter, All Purpose Flour, Corn Flour, Sugar",11,30,40,70,2,Asian,Dessert,Vegetarian
Amla Achaar Recipe | Hot & Sweet Indian Gooseberry Pickle,"Amla, Cup Kashmiri Red Chilli Powder, Salt, Mustard Seeds, Jaggery, Turmeric Powder, Methi Seeds, Asafoetida, Cup Peanut Oil",9,20,25,45,2,Indian,Appetizer,Vegetarian
Chana Dal Chutney ,"Roasted Chana Dal, Coconut, Dry Red Chilli, Curry Leaves, Asafetida, Mustard, Tamarind Paste, Oil, Salt",9,15,10,25,5,South Indian Recipes,Side Dish,Vegetarian
Watermelon Cranberry Mocktail Recipe,"Watermelon, Cranberry Juice, Rose Water A Drop Of Rose Essence, Palm Sugar, Ice Cubes Serve",5,10,10,20,4,Continental,Snack,Vegetarian
Mushroom Thoran Recipe-Kerala Style Mushroom Sabzi,"Button Mushrooms, Turmeric Powder, Sunflower Oil, Salt, Fresh Coconut, Shallots, Green Chilli, Curry Leaves, Cumin Seeds, Mustard Seeds, Cumin Seeds, Curry Leaves, Dry Red Chilli",13,10,30,40,4,Kerala Recipes,Lunch,Vegetarian
Coorg Style Kaad Manga Curry Recipe -Sweet & Spicy Mango Curry,"Mango, Green Chilli, Jaggery, Salt, Coconut Oil, Mustard Seeds, Dry Red Chilli, Asafoetida, Curry Leaves",9,15,15,30,4,Coorg,Side Dish,Vegetarian
Ripe Guava Chutney Recipe (Amrood Ki Chutney),"Guava, Green Chilli, Roasted Peanuts, Parsley Leaves, Garlic, Lemon Juice, Jaggery, Salt, Sunflower Oil, White Urad Dal, Curry Leaves",11,20,25,45,4,Indian,Side Dish,Vegetarian
Whole Wheat Lachha Paratha Recipe,"Wheat Flour, Salt, Oil, Ghee",4,30,40,70,3,Indian,Dinner,Diabetic Friendly
Stuffed Mussels Recipe,"Mussels, Onion, Green Chilli, Garlic, Tablespoon Tomato Ketchup, Red Chilli Powder, Turmeric Powder, Dried Thyme Leaves, Parmesan Cheese, Tablespoon Sunflower Oil, Salt",11,20,10,30,3,Indian,Appetizer,Non Vegeterian
Moong Dal Rasam/Pesara Pappu Charu Recipe (Lemon Infused Indian Lentil Soup),"Yellow Moong Dal, Turmeric Powder, Green Chilli, Ginger, Curry Leaves, Salt, Lemon Juice, Coriander, Ghee, Mustard Seeds, Cumin Seeds, Dry Red Chilli, Asafoetida, Curry Leaves",14,10,25,35,2,South Indian Recipes,Lunch,High Protein Vegetarian
Hurali Kalu Chutney Recipe - Horse Gram Chutney Recipe,"Horse Gram Dal, Pearl Onion, Garlic, Curry Leaves, Dry Red Chilli, Ajwain, Coriander, Jaggery, Fresh Coconut, Tamarind Water, Sunflower Oil, Salt, Sunflower Oil, Curry Leaves, Dry Red Chilli, White Urad Dal, Mustard Seeds, Asafoetida",18,10,10,20,4,Karnataka,South Indian Breakfast,Diabetic Friendly
Instant Kalakand Recipe -Indian Festive Sweet Recipe,"Condensed Milk, Paneer, Cardamom Powder, Rose Water, Ghee Grease The Pan, Handful Mixed Nuts",6,20,30,50,8,Indian,Dessert,Vegetarian
Sattu Ka Paratha Recipe (Stuffed Channa Dal Flour Paratha),"Whole Wheat Flour, Lukewarm Water, Roasted Gram Flour, Onion, Green Chilli, Garlic, Ginger, Kala Jeera, Coriander, Mustard Oil, Mango Pickle, Ghee Oil For Frying The Parathas",12,15,30,45,4,Bihari,North Indian Breakfast,Vegetarian
Stir Fried Water Chestnuts Recipe,"Singhade, Garlic, Paprika Powder, Black Pepper Powder, Red Chilli Flakes, Salt, Extra Virgin Olive Oil, Coriander",8,15,10,25,2,Asian,Side Dish,Vegetarian
Thai Style Sweet And Sour Cucumber & Carrot Salad Recipe,"Cucumber, Carrot, Sugar, Rice Vinegar, Sesame, Red Chilli Flakes, Honey, Raw Peanuts, Stalks Spring Onion, Salt",10,10,0,10,4,Thai,Appetizer,Vegetarian
Quick and Easy Bread Upma ,"Whole Wheat Brown Bread, Tomato, Onion, Green Chilli, Sambar Powder, Turmeric Powder, Mustard Seeds, Curry Leaves, Salt, Butter, Coriander",11,15,30,45,4,Indian,South Indian Breakfast,Vegetarian
Ãbleskivers Recipe- Danish Chocolate Pancake Puffs,"All Purpose Flour, Instant Oats, Cocoa Powder, Dark Chocolate Chips, Whole Egg, Sea Salt, Vanilla Extract, Cinnamon Powder, Cayenne Pepper, Sugar, Butter, Milk, Butter Grease The Pan, Caster Sugar",14,10,20,30,4,European,Snack,Vegetarian
Chinese Tacos (Salad Taco with Hot and Sweet Vegetables) -Fusion Recipe,"Lettuce Leaves, Button Mushrooms, Tofu, Baby Corn, Cauliflower, Carrot, Onion, Green Bell Pepper, Dry Red Chilli, Garlic, Ginger, Soy Sauce, Red Chilli Sauce, Honey, Sesame, Salt, Tomato, Green Chilli, Garlic, Sesame, Salt, Onion, Green Bell Pepper, Spring Onion Greens",24,10,45,55,4,Fusion,Dinner,Vegetarian
Homemade Chikoo Ice Cream Recipe,"Chikoo, Fresh Cream, Milk, Milk Powder, Sugar",5,15,30,45,2,Indian,Dessert,Vegetarian
Besan Burji Recipe-Chickpea Flour Scramble Recipe,"Gram Flour, Flax Seed Powder, Curd, Cumin Seeds, Onion, Red Bell Pepper, Button Mushrooms, Green Chilli, Turmeric Powder, Red Chilli Powder, Cumin Powder, Salt, Coriander",13,15,30,45,4,Indian,North Indian Breakfast,Vegan
Methi Matar Malai ,"Fenugreek, Green Peas, Salt, Make  Cumin Seeds, Tomatopuree, Hung Curd, Sugar, Teaspoon Garam Masala Powder, Turmeric Powder, Black Pepper Powder, Onion, Green Chilli, Bud Garlic, Ginger, Almonds, Poppy Poppy",16,15,30,45,4,North Indian Recipes,Side Dish,Vegetarian
Karnataka Style Avarekalu Sagu Recipe-Hyacinth Beans/ Mochai Kurma,"Avarekalu  Lilva Beans, Potato, Onion, Tomato, Mustard Seeds, Curry Leaves, Coriander, Lemon Juice, Sunflower Oil, Salt, Fresh Coconut, Roasted Gram Dal, Garlic, Green Chilli, Poppy Seeds, Coriander, Cinnamon Stick, Cardamom, Cloves",19,15,30,45,4,Karnataka,Lunch,Vegetarian
Chap Badami Recipe (Lamb Ribs Cooked In Almond Paste),"Lamb, White Vinegar, Curd, Raw Papaya, Red Chilli Powder, Cardamom, Cloves, Whole Black Peppercorns, Nutmeg, Ghee, Badam, Cardamom, Cloves, Cinnamon Stick, Bay Leaves, Garlic, Ginger, Onion, Red Chilli Powder, Kewra Essence, Salt, Coriander",22,120,60,180,4,Awadhi,Dinner,Non Vegeterian
Sindhi Toor Dal Recipe With Aam Papad - Aam Papad Dal Recipe,"Arhar Dal, Tomato, Green Chilli, Ginger, Aam Papad, Turmeric Powder, Coriander, Salt, Ghee, Cumin Seeds, Methi Seeds, Garlic, Red Chilli Powder",13,10,20,30,4,Sindhi,Lunch,Vegetarian
"Chettinad Fish Fry With Roasted Corn, Onions And Carrots With French Beans Recipe","Fish, Red Chilli Powder, Coriander Powder, Turmeric Powder, Lemon, Black Pepper Powder, Dry Red Chilli, Mustard Seeds, Chana Dal, Curry Leaves, Sunflower Oil, Salt, Green Beans, Corn Kernels, Carrot, Onion, Garlic, Black Pepper Powder, Butter, Extra Virgin Olive Oil, Parmesan Cheese, Honey, Balsamic Vinegar",23,10,120,130,4,Chettinad,Lunch,High Protein Non Vegetarian
Maharashtrian Style Bhogichi Bhaji Recipe - Mixed Vegetable Curry,"Brinjal, Drumstick, Avarekalu  Lilva Beans, Potato, Onion, Tomato, Turmeric Powder, Red Chilli Powder, Coriander Powder, Jaggery, Salt, Fresh Coconut, Coriander, Sunflower Oil, Mustard Seeds, Asafoetida, Methi Seeds, Curry Leaves, Green Chilli, Green Chilli",20,30,30,60,4,Maharashtrian Recipes,Lunch,Vegetarian
Goan Masoorchi Usali Recipe (Black Lentil Stir Fry),"Masoor Dal, Onion, Tomato, Fresh Coconut, Sunflower Oil, Salt, Green Chilli, Mustard Seeds, Cumin Seeds, Asafoetida, Turmeric Powder, Curry Leaves, Coriander",13,10,35,45,2,Goan Recipes,Lunch,High Protein Vegetarian
Rajasthani Sweet & Spicy Ker Sangri Sabzi Recipe,"Sangri, Ker, Dry Red Chilli, Ajwain, Asafoetida, Turmeric Powder, Red Chilli Powder, Amchur, Coriander Powder, Jaggery, Raisins, Coriander, Sunflower Oil",13,10,45,55,4,Rajasthani,Lunch,Vegetarian
Maharashtrian Bakar Bhaji Recipe,"Kaddu, Poppy Seeds, Chironji, Sesame Seeds, Dessicated Coconut, Sunflower Oil, Curry Leaves, Dry Red Chilli, Methi Seeds, Mustard Seeds, Asafoetida, Turmeric Powder, Tamarind Paste, Red Chilli Powder, Salt, Maharashtrian Goda Masala, Jaggery, Water, Coriander",19,10,10,20,4,Maharashtrian Recipes,Side Dish,Vegetarian
Healthy Oatmeal Energy Bar With Dates & Nuts Recipe,"Instant Oats, Dates, Honey, Peanut Butter, Badam, Pistachios, Pecans",7,10,40,50,2,Continental,Snack,Vegetarian
Badusha Recipe | Balushahi Recipe - Sweet Indian Doughnut,"All Purpose Flour, Baking Soda, Salt, Ghee, Curd, Sunflower Oil, Pistachios, Sugar, Water, Cardamom Powder",10,45,25,70,12,Indian,Dessert,Vegetarian
Chana Dal Pulao Recipe,"Basmati Rice, Chana Dal, Onion, Tomato, Dry Red Chilli, Green Chilli, Garam Masala Powder, Turmeric Powder, Lemon Juice, Cumin Seeds, Sunflower Oil, Salt",12,35,30,65,3,Indian,Lunch,Vegetarian
Ellu Kuzhambu Recipe- Sesame Seeds Kuzhambu,"Pearl Onion, Potato, Tomato, Red Chilli Powder, Turmeric Powder, Salt, Tamarind, Sesame, Mustard Seeds, Cumin Seeds, Methi Seeds, Sesame Seeds, Black Sesame Seeds, White Urad Dal, Chana Dal, Cumin Seeds, Black Pepper Powder",17,10,25,35,3,South Indian Recipes,Dinner,High Protein Vegetarian
Vanilla Choco Mousse Recipe With Chocolate Chips,"Chocolate Cake, Chocolate Ganache, Heavy Whipping Cream, Vanilla Extract, Instant Coffee Powder, Chocolate Chips, Water, Sugar",8,60,85,145,4,Continental,Dessert,Vegetarian
Sabakki Upittu Recipe (South Indian Style Sabudana Khichdi),"Yellow Moong Dal, Nylon Sabakki, Buttermilk, Onion, Green Peas, Green Chilli, Dry Red Chilli, Ghee, Sunflower Oil, Curry Leaves, Mustard Seeds, Asafoetida, Chana Dal, Black Urad Dal, Lemon Juice, Cashew Nuts, Coriander, Fresh Coconut",18,10,30,40,2,South Indian Recipes,Indian Breakfast,Vegetarian
Kumbakonam Kadappa Recipe - South Indian Style Lentil and Potato Stew,"Green Moong Dal, Potato, Onion, Tomato, Green Chilli, Lemon Juice, Mustard Seeds, Cumin Seeds, Bay Leaf, Cinnamon Stick, Curry Leaves, Sunflower Oil, Salt, Fresh Coconut, Garlic, Fennel Seeds, Green Chilli",17,10,20,30,4,South Indian Recipes,Lunch,Vegetarian
Spicy Arrabbiata Pasta Recipe With Sun Dried Tomatoes,"Spaghetti Pasta, Garlic, Tomato, Dried Oregano, Red Chilli Powder, Sun Dried Tomato, Salt, Extra Virgin Olive Oil, Basil Leaves",9,10,60,70,4,Italian Recipes,Dinner,Vegetarian
Zarda Pulav Recipe (Rice Flavoured With Nuts And Saffron),"Saffron Strands, Milk, Basmati Rice, Bay Leaf, Black Cardamom, Ghee, Cloves, Cardamom, Cinnamon Stick, Cardamom Powder, Nutmeg Powder, Whole Cashews, Badam, Pistachios, Sugar, Raisins, Dry Coconut",17,30,20,50,4,North Indian Recipes,Dessert,Vegetarian
Potala Rasa Recipe (Oriya Style Parval Sabzi),"Pointed Gourd, Bay Leaf, Cumin Seeds, Homemade Tomato Puree, Turmeric Powder, Red Chilli Powder, Cashew Nuts, Salt, Sunflower Oil, Ginger, Cardamom, Cinnamon Stick, Cloves, Green Chilli, Fresh Coconut, Poppy Seeds, Chenna, Coriander, Whole Black Peppercorns, Green Chilli, Raisins, Salt, Coriander",23,30,50,80,4,Oriya Recipes,Lunch,Vegetarian
Poha Buttermilk Idli Recipe,"Buttermilk, Poha, Sooji, Rice Flour, Coriander, Green Chilli, Ginger, Garlic, Curry Leaves, Mustard Seeds, Salt, Sunflower Oil",12,10,30,40,4,South Indian Recipes,South Indian Breakfast,Vegetarian
Murungai Keerai Puttu - Drumstick Leaves Puttu Recipe,"Ragi Flour, Bajra Flour, Rice Flour, Drumstick Leaves, Salt, Water, Ghee, Fresh Coconut",8,10,10,20,2,Kerala Recipes,South Indian Breakfast,Vegetarian
Spicy Marinara Sauce Recipe,"Tomato, Red Onion, Garlic, Homemade Tomato Puree, Extra Virgin Olive Oil, Red Chilli Flakes, Cumin Powder, Red Chilli Powder, Dried Oregano, Salt",10,0,20,20,1,Italian Recipes,Snack,Vegetarian
Homemade Crisp Ghee Roast Dosa ,"Idli Dosa Mixture, Ghee",2,15,30,45,4,South Indian Recipes,South Indian Breakfast,Vegetarian
Besan Halwa Recipe,"Gram Flour, Ghee, Sugar, Water, Cardamom Powder, Badam",6,10,30,40,4,North Indian Recipes,Dessert,Vegetarian
Chatpata Baby Potato Recipe,"Baby Potato, Coriander, Cumin Seeds, Fennel Seeds, Whole Black Peppercorns, Dry Red Chilli, Sunflower Oil, Ginger Garlic Paste, Tamarind Paste, Sugar, Water, Salt, Coriander",13,10,15,25,4,North Indian Recipes,Lunch,Vegetarian
Egg Salad Recipe With Sun Dried Tomatoes And Scallions,"Whole Eggs, Classic Mayonnaise, Extra Virgin Olive Oil, Spring Onion Greens, Sun Dried Tomato, Lemon Juice, Fresh Thyme Leaves, Salt And Pepper",8,15,10,25,3,Continental,Dinner,Eggetarian
Crispy Paneer Pakora Recipe With Garlic Chutney,"Paneer, Garlic, Dry Red Chilli, Cumin, Lemon, Water, Salt, Gram Flour, Rice Flour, Turmeric Powder, Red Chilli Powder, Asafoetida, Enos Fruit Salt, Salt, Water",15,10,15,25,3,Indian,Snack,Vegetarian
Potato And Pointed Gourd Sabzi ,"Parwal, Potato, Peanut, Turmeric Powder, Red Chili Powder, Coriander Powder, Green Coriander, Rye, Salt  Wise, Oilwise",10,10,40,50,2,Bengali Recipes,Lunch,Vegetarian
Biuli Dal Er Boda Recipe - Bengali Style Urad Dal Vada,"White Urad Dal, Onion, Green Chilli, Sooji, Salt, Sunflower Oil Deep Fry",6,10,20,30,4,Bengali Recipes,Snack,Vegetarian
Kerala Style Whole Wheat Parotta Recipe,"Whole Wheat Flour, Ghee, Milk, Sugar, Water, Ghee, Salt",7,30,10,40,4,Kerala Recipes,Lunch,Vegetarian
Hariyali Pav Bhaji Recipe,"Pav Buns, Sunflower Oil, Mustard Seeds, Cumin Seeds, Curry Leaves, Asafoetida, Green Chilli, Ginger Garlic Paste, Onion, Tomato, Potato, Green Peas, Bottle Gourd, Spinach Leaves, Red Chilli Powder, Turmeric Powder, Pav Bhaji Masala, Garam Masala Powder, Green Chutney, Butter, Coriander",21,15,60,75,4,Punjabi,Snack,Vegetarian
Hunan stir fried Chinese Leaf cabbage with Tofu & Chilies Recipe,"Chinese Cabbage, Red Bell Pepper, Onion, Tofu, Garlic, Onion, Dry Red Chilli, Soy Sauce, Homemade Hoisin Sauce, Red Chilli Sauce, Honey, Salt, Black Pepper Powder",13,10,15,25,4,Hunan,Side Dish,Vegetarian
Masaura And Potato Tarkari Recipe,"Masauras, Potato, Onion, Tomato, Cumin Seeds, Ginger, Garlic, Green Chilli, Turmeric Powder, Cumin Powder, Fresh Cream, Water, Sunflower Oil, Salt, Black Pepper Powder",15,15,20,35,2,Indian,Lunch,Vegetarian
Caramelized Ripe Plantains Without Added Sugar Recipe (Caramelized Nendran),"Nendra Pazham Banana, Sunflower Oil Caramelize",2,20,20,40,4,South Indian Recipes,Snack,Vegetarian
Classic South Indian Rava Idli Recipe,"Sooji, Curd, Salt, Coriander, Cashew Nuts, Carrot, Enos Fruit Salt, Sunflower Oil, Mustard Seeds, White Urad Dal, Asafoetida, Green Chilli, Ginger, Curry Leaves",14,25,10,35,2,South Indian Recipes,South Indian Breakfast,Vegetarian
Oven Baked Rice Casserole Recipe,"Extra Virgin Olive Oil, Garlic, Onion, Salt, Rosemary, Rice, Extra Virgin Olive Oil, Red Chilli Flakes, Red Bell Pepper, Yellow Bell Pepper, Salt, Green Bell Pepper, Mixed Herbs, Parsley Leaves, Extra Virgin Olive Oil, Carrots, Yellow Zucchini, Green Zucchini, Baby Corn, Dry Mix Herbs, Salt, Extra Virgin Olive Oil, Garlic, Basil Leaves, Salt, Homemade Tomato Puree, Sugar, Tabasco Original, Paprika Powder, Fresh Cream, Milk, Mozzarella Cheese",32,25,45,70,6,Continental,Main Course,Vegetarian
Bengali Style Pomfret Shorshe Recipe - Pomfret In Mustard Gravy,"Pomfret Fish, Mustard Oil, Mustard Oil, Clove Garlic, Green Chilli, Kalonji, Mustard Seeds  Ground Into Paste, Turmeric Powder, Salt",9,15,30,45,4,Bengali Recipes,Lunch,High Protein Non Vegetarian
Mint And Pomegranate Raita Recipe,"Hung Curd, Anardana Powder, Mint Leaves, Coriander, Garlic, Green Chilli, Salt, Sugar, Cumin Powder, Chaat Masala Powder",10,20,30,50,3,Indian,Side Dish,Vegetarian
Semiya Kesari Recipe,"Hot Water, Semiya, Sugar, Cashew Nuts, Raisins, Cardamom Powder, Saffron Strands, Ghee",8,0,30,30,4,North Indian Recipes,Dessert,Vegetarian
Soya Chunks And Beetroot Biryani Recipe,"Basmati Rice  Soaked In Enough Water For  Minutes, Beetroot, Soy Chunks, Onion, Tomato, Green Chilli, Ginger Garlic Paste, Mint Leaves, Coriander, Turmeric Powder, Red Chilli Powder, Coriander Powder, Salt, Lemon Juice, Coconut Milk, Sunflower Oil, Cloves, Cinnamon Stick, Bay Leaf, Ajwain",20,20,50,70,4,Indian,Dinner,Vegetarian
Kollu Puli Kuzhambu Recipe - Horsegram In A Tangy Gravy,"Horse Gram Dal, Shallots, Tomato, Fresh Coconut, Coriander, Dry Red Chilli, Garlic, Curry Leaves, Cumin Seeds, Whole Black Peppercorns, Salt, Asafoetida, Turmeric Powder, Tamarind Water, Gingelly Oil, Mustard Seeds",16,40,40,80,6,Tamil Nadu,Lunch,Diabetic Friendly
Thai Chicken Green Curry With Vegetables Recipe,"Chicken, Carrots, Baby Corn, Broccoli, Green Beans, Button Mushrooms, Coconut Milk, Instant Oats, Basil Leaves, Palm Sugar, Salt, Sunflower Oil, Green Chilli, Stalks Spring Onion, Coriander, Galangal Ginger Roughly, Garlic, Stalks Lemon Grass, Coriander, Whole Black Peppercorns, Cumin Seeds, Nutmeg",22,10,60,70,4,Thai,Lunch,Non Vegeterian
Mushroom Cutlet Vegetarian Sizzler Recipe,"Mixed Vegetables, Cabbage, Salt, Black Pepper Powder, Sunflower Oil, Cooked Rice, Garlic, Black Pepper Powder, Chilli Vinegar, Soy Sauce, Salt, Sunflower Oil, Potato, Button Mushrooms, Salt, Red Chilli Powder, Whole Wheat Bread Crumbs, Sunflower Oil, Sunflower Oil, Black Pepper Powder, Garlic, Red Chilli Sauce, Chilli Vinegar, Soy Sauce, Tomato Ketchup, Water",26,30,45,75,1,Continental,Main Course,Vegetarian
Poached Eggs Recipe With Arugula Fig Walnut Salad,"Arugula Leaves, Onion, Black Olives, Walnuts, Dried Figs, Honey, Soy Sauce, Red Chilli Flakes, Red Wine Vinaigrette, Whole Eggs, Salt And Pepper Sprinkle, Apple Cider Vinegar",12,10,15,25,2,Continental,World Breakfast,Eggetarian
Paneer Masala Dosa Recipe-Paneer Bhurji Dosa,"Paneer, Green Bell Pepper, Onion, Green Chilli, Tomato, Turmeric Powder, Cumin Powder, Red Chilli Powder, Sambar Powder, Salt, Mint Leaves, Herb Butter, Ragi Dosa Battter, Ghee Oil For Making Dosa",14,10,30,40,4,South Indian Recipes,South Indian Breakfast,High Protein Vegetarian
Khatta Meetha Tamatar Sabzi Recipe - A Chutney Style Dry Sabzi,"Mustard Oil, Mustard Seeds, Fennel Seeds, Cumin Seeds, Kalonji, Methi Seeds, Ginger, Garlic, Green Chilli, Onion, Tomato, Amchur, Cumin Powder, Garam Masala Powder, Red Chilli Powder, Jaggery, Coriander, Mint Leaves",18,10,15,25,2,North Indian Recipes,Lunch,Vegetarian
Haryanvi Saag Gosht Recipe,"Chicken, Mustard Seeds, Cumin Seeds, Dry Red Chilli, Onion, Tomato, Green Chilli, Garlic, Ginger, Turmeric Powder, Red Chilli Powder, Coriander Powder, Cumin Powder, Spinach, Salt, Sunflower Oil",16,20,40,60,4,Haryana,Dinner,High Protein Non Vegetarian
Acorn Squash Sambal Recipe,"Acorn Squash, Sambal Paste, Turmeric Powder, Ginger, Garlic, Groundnut Oil, Salt",7,10,30,40,4,Asian,Side Dish,Non Vegeterian
Chicken Dimsums Recipe - Steamed Chicken Dumplings,"Chicken, Spring Onion, Garlic, Soy Sauce, Salt, All Purpose Flour, Sunflower Oil, Salt",8,20,20,40,4,Asian,Appetizer,High Protein Vegetarian
Aloo Paneer Kebab Recipe,"Paneer, Potato, Cumin Powder, Turmeric Powder, Red Chilli Powder, Ginger Garlic Paste, Whole Wheat Bread Crumbs, Salt, Sunflower Oil, Whole Wheat Bread Crumbs, Sesame Seeds",11,30,30,60,5,Indian,Appetizer,High Protein Vegetarian
Orange Apple Arugula Salad Recipe With Honey Roasted Almonds & Ginger Dressing,"Bunch Arugula Leaves, Orange, Apple, Pickled Onion, Lemon Juice, Fresh Orange Juice, Honey, Ginger, Salt, Extra Virgin Olive Oil, Black Pepper Powder, Poppy Seeds, Badam, Butter, Honey",15,15,0,15,2,Continental,Appetizer,Vegetarian
Thai Style Mango Chicken Coconut Curry Recipe,"Stalks Lemongrass, Galangal, Onion, Dry Red Chilli, Kaffir Lime Leaves Lemon Leaves, Garlic, Coriander, Cumin Powder, Turmeric Powder, Salt, Sunflower Oil, Ginger, Garlic, Onion, Water, Salt, Chicken Breasts, Soy Sauce, Red Bell Pepper, Green Bell Pepper, Dabur Homemade Coconut Milk, Red Chilli Flakes, Mango, Coriander",24,20,25,45,6,Thai,Main Course,Non Vegeterian
Maltesers Butter Cookie Recipe,"Maltesers, Butter, Icing Sugar, Milk, Vanilla Extract, All Purpose Flour, Salt",7,20,30,50,4,Continental,Snack,Vegetarian
Pink Dragon Fruit Kesari Recipe (Sooji Halwa with Dragon fruit),"Pink Flesh Dragon Fruitpitaya, Foxtail Millet, Brown Sugar, Rose Water, Ghee, Cardamom Powder, Cashew Nuts",7,10,30,40,2,South Indian Recipes,Dessert,Vegetarian
Masoor Dal Kebabs Recipe,"Potato, Masoor Dal, Cumin Seeds, Onion, Green Chilli, Garlic, Ginger, Turmeric Powder, Red Chilli Powder, Garam Masala Powder, Salt, Sunflower Oil",12,10,35,45,4,North Indian Recipes,Appetizer,High Protein Vegetarian
Semiya Payasam With Coconut Milk Recipe,"Coconut Milk, Semiya, Cardamom, Jaggery, Water, Cashew Nuts, Saffron Strands",7,5,30,35,4,Tamil Nadu,Dessert,Vegetarian
Pachai Mor Kuzhambu Recipe,"Black Pepper Powder, Cumin Seeds, Coriander, Black Urad Dal, Methi Seeds, Dry Red Chilli, Curry Leaves, Curd, Bhindi, Sunflower Oil, Water, Coriander, Salt, Sunflower Oil, Mustard Seeds, Asafoetida",16,5,12,17,3,South Indian Recipes,Side Dish,Diabetic Friendly
"Pineapple, Onions and Cabbage Slaw with Honey Mustard Recipe","Cabbage, Pineapple, Onion, Mustard Sauce, Honey, Lemon Juice, Fresh Cream, Salt",8,15,0,15,4,Continental,Appetizer,Vegetarian
"Andhra Style Chilakada Dumpa Pulusu Recipe (Sweet Potato in Tangy, Sweet & Spicy Curry Recipe)","Sweet Potato, Pearl Onion, Garlic, Tamarind Water, Jaggery, Tomato, Green Chilli, Curry Leaves, Sambar Powder, Red Chilli Powder, Turmeric Powder, Salt, Mustard Seeds, Cumin Seeds, Asafoetida, Curry Leaves, Coriander",17,10,30,40,4,Andhra,Main Course,Diabetic Friendly
Vegetable Ragi & Oats Uttapam Recipe,"White Urad Dal, Rolled Oats Or Instant Oats, Brown Rice, Ragi Seeds, Methi Seeds, Oats Dosa Batter, Red Bell Pepper, Carrots, Tomato, Green Chilli, Sunflower Oil",11,10,30,40,3,South Indian Recipes,South Indian Breakfast,Vegetarian
Penne Pasta Recipe In Creamy Cauliflower Sauce,"Penne Pasta, Green Zucchini, Garlic, Walnuts, Dried Oregano, Green Chilli, Cauliflower, Milk, Salt, Black Pepper Powder, Sunflower Oil",11,10,45,55,4,Italian Recipes,Dinner,Vegetarian
Kadali Bhanda O Chingudi Tarkari Recipe (Odia Style Banana Blossom & Prawn Curry),"Banana Flower, Prawns, Potato, Onion, Bay Leaf, Cinnamon Stick, Cardamom, Cloves, Dry Red Chilli, Cumin Seeds, Ginger Garlic Paste, Cumin Powder, Sugar, Turmeric Powder, Garam Masala Powder, Red Chilli Powder, Mustard Oil, Salt, Fresh Coconut",19,40,25,65,4,Oriya Recipes,Side Dish,Non Vegeterian
Delicious & Cheesy Spaghetti Sandwich Recipe,"Hot Dog Bread Bagutte, Spaghetti Pasta, Tomato Basil Pasta Sauce, Mozzarella Cheese, Cheddar Cheese, Garlic Butter Spread, Garlic, Extra Virgin Olive Oil, Salt",9,15,15,30,2,Continental,Main Course,Vegetarian
Soya Methi Palak Ki Sabzi Recipe,"Spinach Leaves, Soy Chunks, Methi Leaves, Onion, Homemade Tomato Puree, Garlic, Ginger, Green Chilli, Salt, Cumin Powder, Garam Masala Powder, Butter, Garlic, Dry Red Chilli, Sunflower Oil",15,20,30,50,4,North Indian Recipes,Main Course,High Protein Vegetarian
Bharwa Karela Masala Recipe,"Karela, Salt, Raw Peanuts, Fresh Coconut, Garlic, Cumin Seeds, Jaggery, Turmeric Powder, Red Chilli Powder, Coriander Powder, Cumin Powder, Tamarind Paste, Salt, Sunflower Oil",14,20,50,70,4,Indian,Lunch,Vegetarian
Chicken Masala Fry Recipe,"Boneless Chicken, Salt, Red Chilli Powder, Garlic, Curd, Coriander, Sunflower Oil",7,5,20,25,1,Indian,Appetizer,Non Vegeterian
Moong Dal Pani Recipe- Dal Soup For Babies 6 months & above,"Yellow Moong Dal, Water, Ghee, Turmeric Powder, Asafoetida, Cumin Powder, Salt, Coriander",8,15,20,35,2,Indian,Lunch,High Protein Vegetarian
Healthy Soya Sabudana Kebabs Recipe With Spicy Tomato Chutney,"Cups Soy Chunks, Cup Sabudana, Potato, Poha, Green Chilli, Ginger, Turmeric Powder, Red Chilli Powder, Coriander Powder, Cumin Powder, Garam Masala Powder, Chaat Masala Powder, Salt, Sunflower Oil, Tomato, Green Chilli, Ginger, Salt",18,15,15,30,4,Indian,Appetizer,High Protein Vegetarian
Nargisi Kofta Curry Recipe - Spicy Scotched Egg Curry,"Whole Egg, Mutton, Ginger, Garlic, Coriander Powder, Turmeric Powder, Kashmiri Red Chilli Powder, Garam Masala Powder, Corn Flour, Mustard Oil, Salt, Curd, Onion, Turmeric Powder, Green Chilli Paste, Red Chilli Powder, Garlic, Ginger, Coriander Powder, Cumin Powder, Garam Masala Powder, Homemade Tomato Puree, Kasuri Methi, Bay Leaf, Dry Red Chilli, Salt, Sunflower Oil",27,30,45,75,4,Mughlai,Lunch,Eggetarian
Chettinad Inippu Seeyam Recipe,"Basmati Rice, White Urad Dal, Salt, Sunflower Oil, Chana Dal, Jaggery, Fresh Coconut, Cardamom Powder",8,20,45,65,2,Chettinad,Dessert,Vegetarian
Paneer Bhutuwa Recipe -Nepalese Paneer Curry,"Paneer, Button Mushrooms, Spinach, Onion, Tomato, Garlic, Ginger, Dry Red Chilli, Curd, Soy Sauce, Turmeric Powder, Black Pepper Powder, Sunflower Oil, Salt",14,30,10,40,4,Nepalese,Lunch,High Protein Vegetarian
Broccoli Oats Smoothie Bowl Recipe,"Broccoli, Milk, Curd, Instant Oats, Honey Sugar As Required, Mixed Fruits, Mixed Dry Fruits",7,10,5,15,2,Continental,World Breakfast,High Protein Vegetarian
Gurellu Chutney Podi Recipe,"Kala Jeera, Raw Peanuts, Garlic, Dry Red Chilli, Red Chilli Powder, Curry Leaves, Tamarind, Sunflower Oil",8,10,20,30,10,North Karnataka,Side Dish,Vegetarian
Tandoori Style Soya Chaap Curry Recipe,"Soya Chaap, Tablespoon Ginger Garlic Paste, Curd, Red Bell Pepper, Cheese, Green Chilli, Garam Masala Powder, Tandoori Masala, Red Chilli Powder, Kashmiri Red Chilli Powder, Coriander, Salt, Sunflower Oil",13,30,20,50,2,North Indian Recipes,Lunch,High Protein Vegetarian
Uttaranchal Style Garwhali Kafuli Recipe (Spinach Curry),"Spinach Leaves, Methi Leaves, Green Chilli, Ginger, Cumin Powder, Turmeric Powder, Coriander Powder, Asafoetida, Rice Flour, Curd, Salt, Sunflower Oil",12,5,25,30,4,North Indian Recipes,Side Dish,Diabetic Friendly
Authentic Nimki Recipe - Evening Tea Time Snack,"All Purpose Flour, Salt, Ghee Oil, Ajwain, Ghee, Chaat Masala Powder, Sunflower Oil",7,0,45,45,4,North Indian Recipes,Snack,Vegetarian
Mushroom Pasanda Recipe (Butter Fried Mushrooms in Tomato Almonds and Cream Gravy),"Button Mushrooms, Onion, Tomato, Badam, Garlic, Ginger  Finely, Green Chilli, Cumin Seeds, Cinnamon Stick, Bay Leaf, Whole Black Peppercorns, Turmeric Powder, Coriander Powder, Kashmiri Red Chilli Powder, Garam Masala Powder, Kasuri Methi, Sugar, Fresh Cream, Saffron Strands, Milk, Butter, Sunflower Oil, Salt, Water",24,10,45,55,4,Mughlai,Dinner,Vegetarian
Chatpata Potato Canapes Recipe,"Cumin Seeds, White Urad Dal, Curry Leaves, Red Chilli Powder, Turmeric Powder, Asafoetida, Potato, Garam Masala Powder, Salt, Sugar, Chaat Masala Powder, Sunflower Oil, Coriander, Mint Leaves, Sweet Chutney, Crackers",16,15,10,25,4,Indian,Appetizer,Vegetarian
Eggless Red Velvet Beetroot Muffins Recipe,"All Purpose Flour, Sugar, Baking Powder, Cocoa Powder, Salt, Sunflower Oil, Curd, Beetroot, Lemon Juice Vinegar, Vanilla Extract, Chocolate Chips",11,30,25,55,8,Continental,Dessert,Vegetarian
Achari Gosht Recipe,"Mutton, Curd, Red Chilli Powder, Coriander Powder, Garam Masala Powder, Turmeric Powder, Salt, Sunflower Oil, Tomato, Onion, Green Chilli, Mustard Seeds, Kalonji, Fennel Seeds, Cumin Seeds, Methi Seeds, Dry Red Chilli",17,10,45,55,4,North Indian Recipes,Lunch,Non Vegeterian
Dry Fruit & Nut Modak Recipe,"Dates, Dried Figs, Badam, Pistachios, Cashew Nuts, Cardamom Powder, Poppy Seeds, Ghee",8,30,10,40,4,Indian,Dessert,Vegetarian
Achari Aloo Gobi Recipe - Spicy Indian Cauliflower Stir Fry,"Cauliflower, Potato, Mustard Oil, Green Chilli, Ginger, Onion, Achari Masala, Amchur, Turmeric Powder, Salt, Red Chilli Powder, Dry Red Chilli, Coriander, Kalonji, Fennel Seeds, Mustard Seeds, Cumin Seeds, Methi Seeds",18,10,40,50,4,North Indian Recipes,Lunch,Vegetarian
Kadle Bele Chutney Pudi Recipe,"Chana Dal, White Urad Dal, Dry Coconut, Byadagi Dried Chilli, Jaggery, Tamarind, Asafoetida, Salt",8,10,10,20,4,Karnataka,Side Dish,Vegetarian
Dhania Murgh Makhani Recipe,"Chicken Drumstick, Potato, Cardamom, Cinnamon Stick, Cumin Seeds, Onion, Turmeric Powder, Lemon Juice, Garam Masala Powder, Amchur, Curd, Salt, Onion, Tomato, Coriander, Ginger, Garlic, Green Chilli",18,10,35,45,4,North Indian Recipes,One Pot Dish,Non Vegeterian
Sweet and Spicy Tomato Chutney Recipe,"Tomato  Finely, Mustard Seeds, Cumin Seeds, Curry Leaves, Asafoetida, Green Chilli, Ginger, Turmeric Powder, Red Chilli Powder, Sugar, Sunflower Oil, Salt",12,10,20,30,4,Gujarati Recipesï»¿,Side Dish,Vegetarian
Watermelon & Feta Skewers Recipe,"Watermelon, Feta Cheese, Spinach Leaves, Black Olives, Chaat Masala Powder",5,10,0,10,6,Italian Recipes,Appetizer,High Protein Vegetarian
Green Moong Sprout Salad Recipe With Vegetables- No Onion No Garlic,"Green Moong Sprouts, Carrots, Green Bell Pepper, Tomato, Lemon Juice, Salt, Coriander",7,20,0,20,4,Indian,Side Dish,High Protein Vegetarian
Coorgi Style Chicken Curry Recipe,"Chicken, Turmeric Powder, Red Chilli Powder, Sunflower Oil, Cumin Seeds, Coriander, Whole Black Peppercorns, Cinnamon Stick, Ginger, Garlic, Green Chilli, Fresh Coconut, Curry Leaves, Mustard Seeds, Methi Seeds, Dry Red Chilli, Onion, Tomato, Sugar, Salt, Kachampuli, Sunflower Oil",22,15,30,45,4,Coorg,Lunch,Non Vegeterian
Vegan Carrot Halwa Ice Cream Recipe,"Carrot, Coconut Milk, Water, Cardamom Powder, Cashew Nuts, Pistachios, Sugar, Vanilla Extract, Salt",9,25,300,325,8,Indian,Dessert,Vegan
Mexican Style Frijoles Refritos Recipe-Refried Beans,"Black Eyed Beans, Onion, Coconut Milk, Salt, Butter",5,10,30,40,4,Mexican,Side Dish,Vegetarian
Bengali Bhetki Macher Paturi Recipe (Barramundi Fish Wrapped in Banana Leaf),"Bhetki Fish, Mustard Seeds, Poppy Seeds, Fresh Coconut, Green Chilli, Turmeric Powder, Salt, Banana Leaf, Mustard Oil",9,15,25,40,4,Bengali Recipes,Side Dish,High Protein Non Vegetarian
Mangalorean Style Kayi Vade Recipe (Coconut and Rice Flour Fried Bread Recipe),"Rice Flour, Green Chilli, Curry Leaves, Salt, Fresh Coconut, Dry Red Chilli, Coriander, Ajwain, Sunflower Oil",9,5,25,30,4,Mangalorean,South Indian Breakfast,Vegetarian
Spiced Whole Wheat Cookie Recipe (Atta Biscuit),"Whole Wheat Flour, Sugar, Butter, Flax Seed Powder, Cardamom Powder, Milk",6,20,40,60,4,Continental,Snack,Vegetarian
Til Ke Laddu Recipe (Sesame Seeds Laddu Recipe),"Sesame Seeds, Jaggery, Dessicated Coconut, Roasted Peanuts, Cardamom Powder, Ghee",6,0,60,60,4,North Indian Recipes,Snack,Vegetarian
Baby Corn Butter Masala Recipe,"Baby Corn, Tomato, Red Chilli Powder, Cumin Powder, Garam Masala Powder, Fresh Cream, Butter, Salt, Kasuri Methi, Sunflower Oil Butter Will Also Do, Onion, Ginger, Garlic, Cashew Nuts",14,10,30,40,4,North Indian Recipes,Lunch,Vegetarian
Avarekaalu Obbatu Recipe ( Sweet Paratha stuffed with Field Beans Recipe),"Whole Wheat Flour, Sooji, Hung Curd, Turmeric Powder, Sunflower Oil, Ghee, Avarekalu  Lilva Beans, Chana Dal, Jaggery, Fresh Coconut, Cardamom Powder",11,10,45,55,4,Karnataka,Dessert,Vegetarian
Grilled Paneer Mint Salad Recipe With Pickled Onions & Pomegranates,"Iceberg Lettuce, Paneer, Black Pepper Powder, Cumin Powder, Lemon Juice, Salt, Fresh Pomegranate Fruit Kernels, Mint Leaves, Lemon Wedges Serve, Chaat Masala Powder Sprinkle, Onion, Lemon Juice, Salt, Lemon Juice, Black Pepper Powder, Cumin Powder, Extra Virgin Olive Oil, Garlic, Honey",19,15,10,25,4,Continental,Appetizer,High Protein Vegetarian
Traditional Panakam Recipe,"Water, Jaggery, Whole Black Peppercorns, Cardamom, Ginger, Lemon, Tulsi",7,5,10,15,3,Indian,Appetizer,Vegetarian
Cottage Cheese And Peas Oatmeal Pancakes Recipe,"Green Peas, Paneer, Instant Oats, Sunflower Oil Butter For Making Pancakes, Salt",5,5,10,15,4,Indian,Indian Breakfast,Vegetarian
Kara Kadubu Recipe (Malanad Style Steamed Spiced Rice Dumplings),"Rice Rava Idli Rava, Water, Sunflower Oil, Salt, Cumin Seeds, Butter, Fresh Coconut",7,15,30,45,4,Karnataka,South Indian Breakfast,Vegetarian
Karnataka Style Baledindina Kosambari Recipe (Banana Stem Salad),"Banana Stem, Yellow Moong Dal, Onion, Green Chilli, Lemon, Fresh Coconut, Coriander, Salt, Sunflower Oil, Asafoetida, Mustard Seeds, Green Chilli, Curry Leaves",13,20,0,20,4,Karnataka,Appetizer,Diabetic Friendly
Blueberry Fool Recipe - Quick Dessert with Whipped Cream & Fresh Berries,"Heavy Whipping Cream, Icing Sugar, Orange Zest, Fresh Orange Juice, Orange Liquor, Blueberries Any Other Berry In Season, Salt, Caster Sugar, Blueberries, Shortbread Cookies",10,20,40,60,4,Continental,Dessert,Vegetarian
Sweet Spicy & Tangy Vegetarian Thai Green Curry Recipe With Tamarind,"Stalks Lemongrass, Garlic, Ginger, Green Chilli, S Coriander, S Basil Leaves, Stalks Spring Onion, Coriander, Whole Black Peppercorns, Salt, Dabur Homemade Coconut Milk, Dabur Homemade Tamarind Paste, Thai Green Curry Paste, Broccoli, Small Brinjal, Button Mushrooms, Red Bell Pepper, Green Zucchini, Vegetable Stock, Brown Sugar, Basil Leaves Kaffir Lime Leaves, Salt, Sunflower Oil",23,20,30,50,4,Thai,Dinner,Vegetarian
Uttar Pradesh Style Shir Sewain Recipe,"Milk, Semiya, Khoya, Sugar, Raisins, Cashew Nuts, Pistachios, Badam, Saffron Strands, Ghee",10,10,20,30,5,Uttar Pradesh,Dessert,Vegetarian
Instant Masala Oats Kuzhi Paniyaram Recipe,"Instant Oats, Rice Flour, Curd, Salt, Enos Fruit Salt, Onion, Green Chilli, Cumin Seeds, Mustard Seeds, Coriander, Sunflower Oil",11,20,30,50,4,South Indian Recipes,South Indian Breakfast,Diabetic Friendly
Mexican Style Broccoli Bell Pepper Cheese Quesadilla Recipe,"Broccoli, Yellow Bell Pepper, Pickled Jalapenos, Extra Virgin Olive Oil, Paprika Powder, Salt, Cumin Powder, Black Pepper Powder, Mozzarella Cheese, Tortillas Corn Tortillas",10,10,30,40,4,Mexican,Lunch,Vegetarian
Bihari Style Baingan Ka Chokha Recipe (Smoked & Spiced Eggplant),"Brinjal, Tomato, Green Chilli, Onion, Ginger, Asafoetida, Mustard Oil, Salt",8,10,30,40,3,Bihari,Lunch,Vegetarian
Konkani Style Batata Song Recipe - Dry Red Chili Potatoes Fry,"Potato, Mustard Seeds, Salt, Dry Red Chilli, Tamarind",5,5,25,30,4,Konkan,Side Dish,Vegetarian
Eggless Whole Wheat Banana Muffins Recipe,"Ripe Bananas, Whole Wheat Flour, Milk, Sunflower Oil, Caster Sugar, P Salt, Baking Powder, Cashew Nuts",8,40,20,60,4,Continental,World Breakfast,Vegetarian
Alasande Kaalu Saaru Recipe (Malnad Style Black Eyed Beans Curry),"Black Eyed Beans, Onion, Tomato, Bay Leaf, Cinnamon Stick, Cumin Seeds, Garam Masala Powder, Coriander, Curry Leaves, Sunflower Oil, Salt, Onion, Tomato, Ginger, Fresh Coconut, Garlic, Coriander, Mint Leaves, Green Chilli, Cloves, Cinnamon Stick, Whole Black Peppercorns, Turmeric Powder, Red Chilli Powder, Coriander Powder",25,10,30,40,4,Karnataka,Side Dish,High Protein Vegetarian
Ridge Gourd Chutney Recipe (Beerakaya Pachadi),"Ridge Gourd, Green Chilli, Curry Leaves, Tamarind, Chana Dal, Mustard Seeds, Methi Seeds, Dry Red Chilli, Turmeric Powder, Sunflower Oil, Salt",11,5,15,20,2,South Indian Recipes,Side Dish,Vegetarian
Maharashtrian Gopalkala Recipe (Curd Poha With Fruits),"Poha, Curd, Cucumber, Fresh Coconut, Anardana Powder, Sugar, Raw Peanuts, Green Chilli, Ghee, Cumin Seeds, Curry Leaves, Salt",12,10,2,12,4,Maharashtrian Recipes,Indian Breakfast,Vegetarian
Vegetable Jowar Upma Recipe,"Jowar Seeds, Onion, Carrot, Sweet Corn, Green Peas, Roasted Peanuts, Ginger, Garlic, Green Chilli, Lemon Juice, Turmeric Powder, Salt, Black Pepper Powder, Extra Virgin Olive Oil, Vegetable Stock Water, Coriander",16,15,40,55,4,South Indian Recipes,South Indian Breakfast,Diabetic Friendly
Kadai Vegetable Sabzi Recipe (Mixed Vegetable Saute with Spices),"Cauliflower, Carrots, Green Beans, Onion, Green Bell Pepper, Garlic, Ginger, Homemade Tomato Puree, Cardamom Powder, Turmeric Powder, Coriander Powder, Garam Masala Powder, Red Chilli Powder, Kasuri Methi, Sunflower Oil, Butter, Salt",17,20,30,50,4,North Indian Recipes,Side Dish,Vegetarian
Gawar Phali Methi Ki Sabzi Recipe -Cluster Beans Methi Sabzi,"Methi Leaves, Gawar Phali, Onion, Tomato, Garlic, Ginger, Red Chilli Powder, Turmeric Powder, Coriander Powder, Garam Masala Powder, Salt, Jaggery, Sunflower Oil",13,10,25,35,4,North Indian Recipes,Lunch,Diabetic Friendly
Lemon And Rosemary Shortbread Cookies Recipe,"All Purpose Flour, Butter, Sugar, Rosemary, Lemon, Lemon Juice, Vanilla Extract, Salt",8,20,30,50,4,Continental,Snack,Vegetarian
Lemon Thyme Rasam Recipe,"Tamarind Water, Arhar Dal, Rasam Powder, Turmeric Powder, Tomato, Cumin Powder, Black Pepper Powder, Asafoetida, Fresh Thyme Leaves, Curry Leaves, Salt, Water, Lemon Juice, Ghee, Mustard Seeds, Cumin Seeds, Curry Leaves",17,5,20,25,4,South Indian Recipes,Side Dish,Vegetarian
Barnyard Millet Idli And Dosa Recipe,"Barnyard Millet, Sabudana, White Urad Dal, Poha, Methi Seeds",5,720,10,730,5,South Indian Recipes,Indian Breakfast,Diabetic Friendly
One Pot Aloo Gobi Sabzi Recipe Using Preethi Electric Pressure Cooker,"Potato, Cauliflower, Ginger, Tomato, Cumin Seeds, Turmeric Powder, Garam Masala Powder, Cardamom, Red Chilli Powder, Coriander, Sunflower Oil, Salt",12,10,30,40,4,North Indian Recipes,Main Course,Diabetic Friendly
Nippattu Masala Chaat Recipe- South Indian Style Chaat,"Thattai, Onion, Carrot, Lemon Juice, Salt, Cumin Powder, Red Chilli Powder, Green Chutney, Sweet Chutney, Sev Garnish, Puffed Rice Garnish, Roasted Peanuts",12,15,0,15,2,South Indian Recipes,Appetizer,Vegetarian
Mango Ladoo Recipe,"Mango Pulp, Dessicated Coconut, Condensed Milk, Mixed Nuts, Cardamom Powder",5,10,15,25,4,Indian,Dessert,Vegetarian
Oats Peanut Butter & Chocolate Chip Trail Mix Recipe,"Rolled Oats, Coconut Flakes, Watermelon Seeds, Sesame Seeds, Chocolate Chips, Peanut Butter, Lion Dates Syrup",7,5,20,25,4,Continental,World Breakfast,Vegetarian
Dalia Pakora Recipe - Broken Wheat Pakora,"Broken Wheat, Salt, Sunflower Oil, Gram Flour, Onion, Coriander, Green Chilli, Salt, Turmeric Powder, Cumin Seeds, Ajwain, Sunflower Oil, Water, Enos Fruit Salt, Sunflower Oil",15,10,15,25,4,Indian,Snack,Vegetarian
Whole Wheat Chocolate Cinnamon Cupcakes Recipe,"Whole Wheat Flour, Milk, Sunflower Oil, Caster Sugar, Vanilla Extract, Baking Powder, Baking Soda, Cinnamon Powder, Cocoa Powder, Chocolate Chips, Cinnamon Powder",11,15,20,35,2,Continental,Dessert,Vegetarian
Matta Rice Peas Pulao Recipe,"Red Matta Rice, Green Peas, Cardamom, Cinnamon Stick, Bay Leaf, Cumin Seeds, Salt, Sugar, Ghee",9,30,15,45,4,Indian,Lunch,Vegetarian
Paneer Bhurji Gravy Recipe,"Sunflower Oil, Cumin Seeds, Mustard Seeds, Asafoetida, Bay Leaves, Star Anise, Dry Red Chilli, Cloves, Black Cardamom, Cardamom, Onion, Ginger, Garlic, Homemade Tomato Puree, Tomato, Paneer, Coriander, Red Chilli Powder, Turmeric Powder, Coriander Powder, Garam Masala Powder, Salt, Water",23,20,30,50,4,North Indian Recipes,Dinner,High Protein Vegetarian
Khubani Ka Meetha Recipe (A Rich Hyderabadi Nawabi Dessert),"Apricots, Sugar, Saffron Strands, Mixed Nuts",4,0,60,60,3,Hyderabadi,Dessert,Vegetarian
Homemade Fresh Orange Juice Recipe,"Orange, Salt, Sugar",3,10,0,10,2,Continental,Snack,Vegetarian
Butter Chicken With Tandoori Mayo Recipe,"Boneless Chicken  Cubedbite Size, Butter, Sunflower Oil, Del Monte Tandoori Mayo, Cumin Powder, Coriander Powder, Red Chilli Powder, Turmeric Powder, Ginger, Garlic, Lemon Juice, Curd, Salt, Onion, Tomato, Water, Turmeric Powder, Red Chilli Powder, Coriander Powder, Cumin Powder, Ginger, Green Chilli, Butter, Sugar, Del Monte Tandoori Mayo, Fresh Cream, Sunflower Oil, Coriander, Fresh Cream, Butter",30,120,60,180,4,North Indian Recipes,Lunch,Vegetarian
South Indian Style Vazhaithandu Poriyal Recipe - Banana Stem Curry with No Onion and No Garlic,"Banana Stem, Mustard Seeds, White Urad Dal, Green Chilli, Whole Black Peppercorns, Curry Leaves, Turmeric Powder, Salt, Sunflower Oil",9,30,20,50,4,South Indian Recipes,Lunch,Diabetic Friendly
Corn Korma Recipe,"Sweet Corn, Ghee, Mustard Seeds, Asafoetida, Curry Leaves, Green Chilli, Coconut Milk, Rice Flour, Black Pepper Powder, Few  Coriander, Salt",11,15,20,35,4,Indian,Dinner,Vegetarian
Peach Cobbler Scones Recipe,"All Purpose Flour, Sugar, Baking Powder, Salt, Butter, Whole Eggs, Buttermilk, Vanilla Extract, Peaches, Sugar, Cinnamon Stick",11,20,25,45,8,Continental,Snack,Vegetarian
Spicy and Tangy Mixed Vegetable Poha Recipe With Peanuts,"Poha, Mustard Seeds, Cumin Seeds, Curry Leaves, Onion, Green Chilli, Ginger, Carrot, Green Bell Pepper, Green Peas, Roasted Peanuts, Turmeric Powder, Sugar, Salt, Lemon Juice, Coriander, Figaro Pure Olive Oil",17,10,20,30,4,North Indian Recipes,North Indian Breakfast,Vegetarian
Mangalorean Style Masala Pundi Recipe - Steamed rice dumpling in Onion Gravy,"Dosa Rice, Fresh Coconut, Salt, Onion, Garlic, Mustard Seeds, Curry Leaves, Tamarind Water, Salt, Asafoetida, Coriander, Coriander, Methi Seeds, Cumin Seeds, White Urad Dal, Dry Red Chilli, Fresh Coconut",17,15,45,60,4,Mangalorean,South Indian Breakfast,Vegetarian
Udupi Style Heerekai Bajji Recipe-Ridge Gourd Fritters,"Ridge Gourd, Gram Flour, Rice Flour, Red Chilli Powder, Turmeric Powder, Baking Soda, Salt, Sunflower Oil",8,5,15,20,4,Karnataka,Snack,Vegetarian
Puffed Rice Upma Recipe - Murmura Upma,"Puffed Rice, Sunflower Oil, Mustard Seeds, Cumin Seeds, Curry Leaves, Ginger, Raw Peanuts, Onion, Green Chilli, Green Peas, Turmeric Powder, Tomato, Lemon Juice, Coriander, Salt",15,10,20,30,4,South Indian Recipes,South Indian Breakfast,Vegetarian
Mango Milkshake Recipe,"Mango, Milk, Sugar",3,5,0,5,4,Continental,Snack,Vegetarian
Andhra Style Kandagadda Vepudu Recipe - Yam Stir Fry Recipe,"Elephant Yam, Mustard Seeds, Curry Leaves, Green Chilli, Ginger, Garlic, Turmeric Powder, Red Chilli Powder, Black Pepper Powder, Salt",10,10,30,40,4,Andhra,Appetizer,Vegetarian
"Whole Wheat, Oatmeal and Amaranth Fruitcake Cookie Recipe","Whole Wheat Flour, Whole Wheat Flour, Instant Oats, Rajgira Flour, Flax Seed Powder, Baking Powder, Baking Soda, Brown Sugar, Dry Fruits, Walnuts, Dark Chocolate Chips, Sunflower Oil, Whole Eggs, Milk",14,20,40,60,4,Continental,Snack,Vegetarian
Roasted Bell Pepper Quinoa Recipe,"Quinoa, Water, Salt, Extra Virgin Olive Oil, Rosemary, Green Bell Pepper, Red Bell Pepper, Garlic, Salt, Black Pepper Powder, Lemon Juice, Lemon Juice",12,10,20,30,3,Continental,Main Course,High Protein Vegetarian
Horse Gram Chutney Podi Recipe,"Kulith Dal, Red Chilli, Guntur Red Chilli, Curry Leaves, Tamarind, Asafoetida, Salt",7,10,10,20,4,South Indian Recipes,Side Dish,Vegetarian
Homemade Pizza Sauce Recipe,"Tomato, Onion, Carrots, Celery, Garlic, Homemade Tomato Puree, Dried Oregano, Basil Leaves, Salt, Black Pepper Powder, Sugar, Extra Virgin Olive Oil",12,20,40,60,600,Italian Recipes,Dinner,Vegetarian
Dry Fruit Burfi Recipe With Gulkand,"Dried Figs, Dates, Badam, Cashew Nuts, Walnuts, Pistachios, Raisins, Gulkand, Nutmeg Powder, Ghee, Edible Silver Foilleaf",11,20,50,70,4,North Indian Recipes,Snack,Vegetarian
Kerala Style Prawns & Shrimp Biryani  -Chemmeen Biryani Recipe,"Basmati Rice  Soaked For  Minutes, Cardamom, Cloves, Cinnamon Stick, Coriander, Mint Leaves, Ghee, Lemon Juice, Salt, Prawns, Ginger Garlic Paste, Red Chilli Powder, Whole Black Peppercorns, Salt, Onion, Ginger, Garlic, , Tomato  Finely, Fresh Coconut, Coriander, Mint Leaves, Curd, Cashew Nuts  Soaked In  Water, Garam Masala Powder, Sunflower Oil, Salt, Cashew Nuts, Raisins, Onion, Coriander, Mint Leaves, Mint Leaves",33,180,40,220,4,Kerala Recipes,Lunch,Non Vegeterian
Andhra Style Pindi Miriyam Recipe,"Arhar Dal, Potato, Brinjal, Raw Banana, Bottle Gourd, Tamarind, Jaggery, Curry Leaves, Mustard Seeds, Cumin Seeds, Dry Red Chilli, Sunflower Oil, Salt, Sunflower Oil, White Urad Dal, Fresh Coconut, Coriander, Whole Black Peppercorns, Cumin Seeds, Dry Red Chilli",20,10,20,30,4,Andhra,Side Dish,Vegetarian
Keema Kaleji Recipe- Mutton Liver Mince,"Mutton, Mutton, Onion, Ginger, Garlic  Minced, Green Chilli, Turmeric Powder, Coriander Powder, Red Chilli Powder, Curd, Mustard Oil, Mint Leaves, Salt, Lemon Juice, Coriander, Bay Leaf, Cloves, Whole Black Peppercorns, Black Cardamom, Cardamom, Cinnamon Stick, Mace, Dry Red Chilli",23,15,40,55,4,North Indian Recipes,Dinner,Non Vegeterian
Dulce De Leche Brownie Recipe,"All Purpose Flour, Cocoa Powder, Brown Sugar, Whole Eggs, Butter, Baking Powder, Dark Chocolate, Vanilla Extract, Walnuts Pecans, Dulce De Leche",10,20,40,60,6,Continental,Dessert,Vegetarian
Spinach Corn Sabzi Recipe,"Spinach, Sweet Corn, Sunflower Oil, Cumin Seeds, Ginger Garlic Paste, Green Chilli, Cashew Nuts, Onion, Tomato, Turmeric Powder, Red Chilli Powder, Coriander Powder, Salt, Milk, Garam Masala Powder",15,15,15,30,4,North Indian Recipes,Dinner,High Protein Vegetarian
Vendakkai Vengayam Sambar Recipe (Okra in Tangy Lentil Curry),"Arhar Dal, Tamarind, Shallot, Bhindi, Tomato, Sambar Powder, Salt, Sesame, Mustard Seeds, Dry Red Chilli, Asafoetida, Curry Leaves, Coriander",13,10,45,55,3,South Indian Recipes,Lunch,High Protein Vegetarian
Baked Bitter Gourd Bhajji Recipe - Karela Fritters,"Karela, Gram Flour, Rice Flour, Curry Leaves  Torn, Red Chilli Powder, Asafoetida, Turmeric Powder, Sunflower Oil, Salt, Water",10,25,20,45,4,Indian,Snack,Diabetic Friendly
Strawberry Salsa Recipe,"Strawberries, Yellow Bell Pepper, Onion, Iceberg Lettuce, Mint Leaves, Black Pepper Powder, Lemon Juice, Salt",8,10,0,10,4,Mexican,Snack,Vegetarian
Vegan Soya Aloo Curry Recipe,"Soy Chunks, Potato, Onion, Ginger, Garlic, Green Chilli, Cumin Seeds, Asafoetida, Turmeric Powder, Coriander Powder, Kashmiri Red Chilli Powder, Red Chilli Powder, Garam Masala Powder, Salt, Sunflower Oil, Kasuri Methi, Coriander",17,25,30,55,4,Indian,Dinner,High Protein Vegetarian
Sweet Chili Lime Grilled Chicken Recipe,"Chicken Breasts, Sweet And Spicy Red Chilli Sauce, Date Syrup, Soy Sauce, Lemon Juice, Dried Oregano, Black Pepper Powder, Salt, Green Beans, Butter, Garlic, Salt, Black Pepper Powder, Sweet Corn, Butter, Dried Oregano, Salt, Salt",18,10,45,55,1,Continental,Main Course,Non Vegeterian
Foxtail Millet Paruppu Adai With Keerai Recipe,"Foxtail Millet, Arhar Dal, Pili Moong Dal, Chana Dal, Dry Red Chilli, Spinach, Green Chilli, Fennel, Oil, Salt",10,240,10,250,4,South Indian Recipes,South Indian Breakfast,Vegetarian
WeetBix Halwa Recipe,"Weet Bix, Palm Sugar, Mixed Nuts, Cardamom Powder, Ghee, Water, Saffron Strands",7,10,10,20,2,Indian,Dessert,Vegetarian
Sorakkai Paruppu Kuzhambu Recipe - Tamil Nadu Style Lauki Curry,"Bottle Gourd, Yellow Moong Dal, Onion, Tomato, Dry Red Chilli, Turmeric Powder, Sambar Powder, Mustard Seeds, Cumin Seeds, Salt, Sunflower Oil, Ghee",12,5,15,20,4,Tamil Nadu,Side Dish,Vegetarian
Mysore Style Avarekalu Rasam Recipe,"Avarekalu  Lilva Beans, Tamarind Water, Tomato, Fresh Coconut, Jaggery, Turmeric Powder, Salt, Coriander, Dry Red Chilli, Byadagi Dried Chilli, Cumin Seeds, Whole Black Peppercorns, Mustard Seeds, Methi Seeds, Mustard Seeds, Curry Leaves, Ghee",17,10,30,40,4,Karnataka,Lunch,Vegetarian
Whole Wheat Buttermilk Banana Pancakes Recipes,"Ripe Bananas, Whole Wheat Flour, Baking Powder, Salt, Buttermilk, Whole Egg Flax Meal Egg Replacer, Vanilla Extract, Sunflower Oil, Butter Oil For Cooking Pancakes",9,15,30,45,4,Continental,World Breakfast,Eggetarian
Foxtail Millet Kheer Recipe (Millet Pudding With Saffron & Nuts),"Milk, Foxtail Millet, Saffron Strands, Fresh Coconut, Sugar, Mixed Dry Fruits",6,15,60,75,4,Tamil Nadu,Dessert,Vegetarian
Grilled Stuffed Mushrooms Recipe With Onion Parmesan & Herbs,"Button Mushrooms Portabello Mushrooms, Extra Virgin Olive Oil, Black Pepper Powder, Cheddar Cheese, Onion, Garlic, Coriander, Salt, Extra Virgin Olive Oil Cooking Spray As Needed",9,20,15,35,4,Continental,Appetizer,Vegetarian
Snake Gourd Kootu Recipe (Pudalangai Kootu),"Snake Gourd, Masoor Dal, Mustard Seeds, Cumin Seeds, Dry Red Chilli, Turmeric Powder, Asafoetida, Sambar Powder, Salt, Coconut Oil, Coriander, Fresh Coconut, Coriander, Cumin Seeds, Green Chilli",15,10,20,30,4,Tamil Nadu,Side Dish,Vegetarian
Achari Chicken Tikka Wrap Recipe,"Whole Wheat Tawa Paratha, Lettuce Leaves Spinach Leaves, Tomato, Onion, Achari Mayo, Boneless Chicken, Ginger Garlic Paste, Lemon Juice, Turmeric Powder, Gram Flour, Ajwain, Red Chilli Powder, Garam Masala Powder, Cumin Powder, Coriander Powder, Curd, Salt",17,120,45,165,4,Indian,Snack,High Protein Non Vegetarian
Mooli Aur Kaccha Kela Kofta Recipe (Grated Radish And Raw Banana Dumplings In Gravy),"Raw Banana, Mooli Mullangi, Green Chilli, Ginger, Gram Flour, Ajwain, Red Chilli Powder, Sunflower Oil Cook Koftas, Salt, Onion, Tomato, Ginger Garlic Paste, Green Chilli, Curd, Whole Cashews, Kashmiri Red Chilli Powder, Coriander Powder, Garam Masala Powder, Cumin Seeds, Bay Leaf, Cardamom, Sunflower Oil, Coriander, Salt",24,20,30,50,4,Indian,Side Dish,Vegetarian
Chettinad Idiyappam Recipe,"Idiyappam, Shallots, Fresh Red Chilli, Carrot, Green Bell Pepper, Red Bell Pepper, Cabbage, Garlic, Ginger, Sesame, Salt, Spring Onion Greens",12,10,15,25,4,Chettinad,South Indian Breakfast,Vegan
Mixed Vegetables Ajethna Recipe - Mangalorean Style Mixed Vegetables Sabzi,"Green Beans, Carrots, Potato, Turmeric Powder, Mustard Seeds, White Urad Dal, Asafoetida, Dry Red Chilli, Curry Leaves, Sunflower Oil, Salt, Fresh Coconut, Dry Red Chilli, Mustard Seeds",14,10,20,30,4,Mangalorean,Side Dish,Vegetarian
Green Moong Dal Kootu with Raw Banana Peel Recipe,"Green Moong Dal, Raw Banana Peel, Turmeric Powder, Salt, Poppy Seeds, Fresh Coconut, Roasted Gram Dal, Cinnamon Stick, Green Chilli, Coriander, Ginger, Mustard Seeds, Curry Leaves, Asafoetida, Sunflower Oil",15,30,25,55,4,South Indian Recipes,Lunch,Vegetarian
Broccoli Paneer And Peanut Masala Recipe,"Broccoli, Paneer, Raw Peanuts, Green Chilli, Onion, Tomato, Cumin Seeds, Whole Black Peppercorns, Kashmiri Red Chilli Powder, Garam Masala Powder, Biryani Masala, Turmeric Powder, Butter, Kasuri Methi, Salt",15,15,45,60,4,Indian,Dinner,High Protein Vegetarian
Carrot Cake Recipe for Healthy Heart,"Whole Wheat Flour, Baking Powder, Sugar, Whole Eggs, Vanilla Extract, Extra Virgin Olive Oil, Carrot, Cashew Nuts",8,15,40,55,6,Continental,Snack,Eggetarian
Tofu & Shrimp Salad Recipe With Balsamic Dressing,"Shrimps, Tofu, Iceberg Lettuce, Cabbage, Carrots, Beetroot, Red Baby Radish, Yellow Bell Pepper, Green Chilli, Salt, Whole Black Peppercorns, Lemon Juice, Balsamic Vinegar, Red Chilli Flakes, Sugar, Extra Virgin Olive Oil, Coriander, Mint Leaves, Roasted Peanuts",19,10,15,25,2,Asian,Dinner,High Protein Non Vegetarian
Pineapple Crostini With Honey And Cream Cheese Recipe,"Ciabatta Bread, Pineapple, Britannia Cream Cheese, Honey, Extra Virgin Olive Oil, Coriander",6,15,0,15,4,Italian Recipes,Appetizer,Vegetarian
Sago Yogurt Parfait Recipe (Creamy Tapioca Pearls With Assorted Fruits),"Tapioca Flour, Curd, Ripe Bananas, Apple, Anardana Powder, Honey, Badam",7,10,20,30,4,Continental,World Breakfast,Vegetarian
Andhra Style Nalla Karam Podi Recipe,"Coriander, Black Urad Dal, Roasted Gram Dal, Dry Red Chilli, Curry Leaves, Tamarind, Garlic, Sunflower Oil, Salt",9,10,20,30,10,Andhra,Side Dish,Vegetarian
Banana Apple Porridge Recipe - 6 Months Above For Babies & Toddlers,"Ripe Bananas, Apple, Rice",3,2,10,12,4,Continental,World Breakfast,Vegetarian
French Onion Chicken Recipe,"Chicken Thighs, Onion, Butter, Extra Virgin Olive Oil, Garlic, Dried Thyme Leaves, Chicken Stock, All Purpose Flour, Salt, Black Pepper Powder, Vinegar, Dijon Mustard, Gruyere Cheese",13,10,90,100,3,French,Lunch,Non Vegeterian
Pumpkin Cupcakes Recipe With Finger Millet And Flax Seed,"Vivatta Maida, Ragi Flour, Flax Seed Powder, Pumpkin Puree, Sugar, Butter, Baking Powder, Cinnamon Powder, Whole Egg, Milk",10,15,15,30,15,Continental,Dessert,Eggetarian
French Style Red Sorrel Two Bean Soup Recipe,"Extra Virgin Olive Oil, Butter, Red Onion, Fennel Bulb, Leek, French Beans, Celery, Sorrel Leaves, Vegetable Stock, Salt, Black Pepper Powder, Tarragon, Parsley Leaves, Black Eyed Beans, Fresh Cream",15,10,30,40,4,French,Dinner,High Protein Vegetarian
Southekayi Palya Recipe - Mangalore Cucumber Palya/ Sabzi Recipe,"Mangalorean Cucumber, Mustard Seeds, White Urad Dal, Onion, Garlic, Curry Leaves, Turmeric Powder, Salt, Fresh Coconut, Dry Red Chilli, Cumin Seeds",11,10,20,30,4,Mangalorean,Lunch,Vegetarian
Eggless Nutella Swirl Cupcakes Recipe,"All Purpose Flour, Condensed Milk, Nutella Spread, Butter, Baking Powder, Baking Soda, Milk, Vanilla Extract, Vinegar, Sugar",10,25,10,35,4,Continental,Dessert,Vegetarian
Gajar Methi Sabzi Recipe (Carrot Fenugreek Leaves Stir Fry),"Carrots, Methi Leaves, Onion, Cumin Seeds, Asafoetida, Red Chilli Powder, Coriander Powder, Turmeric Powder, Amchur, Salt, Sunflower Oil",11,10,30,40,4,Indian,Lunch,Vegetarian
Tomato & Beetroot Soup Recipe,"Tomato, Onion, Chakundar, Garlic, Whole Black Pepper, Cinnamon, , Cardamom, Butter, Oil, Water, Milk, Salt",13,10,20,30,4,Continental,Appetizer,Vegetarian
Homemade Alfredo Pasta Sauce Recipe-Creamy White Sauce For Pasta,"Butter, Milk, Garlic, Britannia Cream Cheese, Parmesan Cheese, Salt And Pepper, Fresh Herbs",7,5,30,35,1,Italian Recipes,Vegetarian,Vegetarian
Boondi And Spring Onion Greens Sabzi Recipe,"Spring Onion Greens, Boondi, Green Chilli, Sunflower Oil, Cumin Seeds, Asafoetida, Garlic, Turmeric Powder, Coriander Powder, Red Chilli Powder, Garam Masala Powder, Dessicated Coconut, Salt, Tomato, Water, Amchur",16,10,10,20,4,North Indian Recipes,Lunch,Vegetarian
Corn Methi Malai Gravy Recipe,"Methi Leaves, Sweet Corn, Onion, Tomato, Whole Cashews, Fresh Cream, Turmeric Powder, Red Chilli Powder, Amchur, Sugar, Butter, Cardamom, Cumin Seeds, Cinnamon Stick, Cloves, Whole Black Peppercorns, Whole Black Peppercorns",17,10,20,30,4,Punjabi,Dinner,Vegetarian
Creamy Indian Butter Fish Recipe - Creamy Pabda Fish,"Indian Butter Fish, Mustard Oil, Turmeric Powder, Kashmiri Red Chilli Powder, Dry Red Chilli, Green Chilli, Water, Coriander, Fresh Cream, Panch Phoran Masala, Salt",11,10,10,20,4,Bengali Recipes,Side Dish,High Protein Non Vegetarian
Kadai Baby Corn Paneer Recipe,"Baby Corn, Paneer, Onion, Ginger, Garlic, Tomato, Turmeric Powder, Garam Masala Powder, Cardamom Powder, Kashmiri Red Chilli Powder, Ghee, Kasuri Methi, Sunflower Oil",13,10,35,45,4,North Indian Recipes,Lunch,Vegetarian
Andhra Style Kandi Pachadi Recipe (Masoor Dal Chutney Recipe),"Masoor Dal, Dry Red Chilli, Roasted Gram Dal, Cumin Seeds, Tamarind, Garlic, Salt, Mustard Seeds, White Urad Dal, Dry Red Chilli, Curry Leaves, Asafoetida, Sunflower Oil",13,0,20,20,4,Andhra,South Indian Breakfast,Vegetarian
Bharwa Bhindi And Pyaaz Ki Sabzi Recipe,"Bhindi, Pearl Onion, Sunflower Oil, Water, Coriander, Garlic, Onion, Green Chilli, Red Chilli Powder, Turmeric Powder, Coriander Powder, Salt, Sunflower Oil",13,10,45,55,4,Rajasthani,Lunch,Vegetarian
Andhra Style Vankaya Kothimeera Karam Recipe - Brinjal Cooked With Spicy Coriander Mix Recipe,"Brinjal, Mustard Seeds, White Urad Dal, Curry Leaves, Dry Red Chilli, Sunflower Oil, Salt, Coriander, Green Chilli, Ginger, Cumin Seeds",11,10,20,30,4,Andhra,Lunch,Vegetarian
Karjikai (Karnataka Style Deep Fried Sweet Pastry Recipe),"All Purpose Flour, Sooji, Rice Flour, Ghee, Water, Sunflower Oil Fry, Roasted Gram Dal, Fresh Coconut, Jaggery, Cardamom Powder",10,15,60,75,8,Karnataka,Snack,Vegetarian
Pakistani Chickpeas Pulao Recipe With Sweet Hot Date Onion Chutney,"Basmati Rice, Kabuli Chana, Sunflower Oil, Tomato, Onion, Cardamom, Bay Leaf, Cinnamon Stick, Cloves, Ginger Garlic Paste, Red Chilli Powder, Turmeric Powder, Coriander Powder, Cumin Powder, Salt, Coriander, Onion, Sunflower Oil, Sesame, Dates, Fresh Red Chilli, Salt",22,45,30,75,4,Pakistani,Lunch,Vegetarian
Beetroot Pancake Recipe,"Beetroot, Whole Wheat Flour, Baking Powder, Sugar, Sunflower Oil, Milk, Whole Eggs, Sunflower Oil",8,5,15,20,15,Continental,World Breakfast,Vegetarian
Thouthe Kodel Recipe (Mangalore Southekayi Curry),"Mangalorean Cucumber, Tamarind Water, Arhar Dal, Turmeric Powder, Salt, Sunflower Oil, Coriander, Cumin Seeds, Methi Seeds, White Urad Dal, Whole Black Peppercorns, Fresh Coconut, Dry Red Chilli, Garlic, Sunflower Oil, Mustard Seeds, White Urad Dal, Dry Red Chilli, Garlic, Curry Leaves",20,25,45,70,4,Mangalorean,Side Dish,Vegetarian
Healthy Vegetable Paratha Rolls Recipe,"Tawa Parathas, Onion, Cabbage, Carrots, Green Peas, Potato, Capsicum, Tomato, Ginger, Green Chilli, Green Coriander, Oil, Cumin, Salt, Garam Masala Powder",15,10,30,40,4,North Indian Recipes,Snack,Vegetarian
Peerkangai Thogayal Recipe (Ridge Gourd Chutney),"Ridge Gourd, Black Urad Dal, Chana Dal, Green Chilli, Mustard Seeds, Asafoetida, Turmeric Powder, Salt, Fresh Coconut, Tamarind Paste, Sunflower Oil",11,5,15,20,2,South Indian Recipes,Side Dish,Vegetarian
Karnatak Style Hurigadale Tambittu Recipe - Gram Flour Ladoo,"Gram Flour, Ghee, Jaggery, Dry Coconut, Cardamom Powder",5,0,45,45,4,Karnataka,Dessert,Vegetarian
Cheesy Mushroom & Corn Open Toast,"Sunflower Oil, Button Mushrooms, Sweet Corn, Garlic, Onion, Turmeric Powder, Britannia Cheese Spread, Salt, Whole Wheat Brown Bread, Butter, Parsley Leaves",11,10,30,40,4,Continental,Side Dish,High Protein Vegetarian
Paneer Broccoli Soya Ghee Roast Pockets Recipe,"Paneer, Broccoli, Soy Chunks, Coriander, Cumin Seeds, Mustard Seeds, Methi Seeds, Byadagi Dried Chilli, Whole Black Peppercorns, Fennel Seeds, Curry Leaves, Garlic, Red Chilli Powder, Kashmiri Red Chilli Powder, Tamarind, Curd, Onion, Ghee Roast, Salt, Water, Fennel Seeds, Asafoetida, Whole Wheat Flour, Salt, Sunflower Oil Knead, Water Knead",26,40,40,80,4,Fusion,Snack,High Protein Vegetarian
Chole Pindi ,"Of Chickpea Chickpeachickpeas, Cardamom, Onion, Cinnamon, Ginger, Green Chilli, Tomato Puree, Turmeric Powder, Pomegranate Powder, Coriander Powder, Garam Masala Powder, Amchur, Red Chilli Powder, Oil, Salt, Ginger, Lemon",17,500,120,620,4,North Indian Recipes,Lunch,Vegetarian
Vegan Soya Aloo Curry ,"Soya Chunks, Potato, Onion, Ginger, Garlic, Green Chilli, Cumin Seeds, Asafoetida, Turmeric Powder, Coriander Powder, Kashmiri Red Chilli Powder, Red Chilli Powder, Garam Masala Powder, Salt, Oil, Kasuri Methi, Coriander",17,25,30,55,4,Indian,Dinner,High Protein Vegetarian
Reshmi Kofta Recipe in Rich Cashew Gravy,"Paneer, Cheese, Potato, Gram Flour, Salt, Red Chilli Powder, Onion, Garlic, Ginger, Homemade Tomato Puree, Cashew Nuts, Fresh Cream, Kashmiri Red Chilli Powder, Turmeric Powder, Coriander Powder, Garam Masala Powder, Kasuri Methi, Coriander, Salt",19,30,60,90,4,North Indian Recipes,Dinner,Vegetarian
Kerala Style Vettu Cake Recipe (Eggless Wholewheat Tea Shop Cake),"Whole Wheat Flour, Sugar, Cooking Soda, Butter, Salt, Cardamom Powder, Milk, Water, Sunflower Oil Deep Fry",9,45,20,65,10,Kerala Recipes,Snack,Vegetarian
Andhra Style Karivepaku Pachadi Recipe,"Curry Leaves, Chickpea Lentils, Dried Red Chilli Green Chilli, Ginger, Tamarind Water, Mustard, Dry Red Chili",7,0,20,20,4,Andhra,South Indian Breakfast,Diabetic Friendly
Lentil & Coconut Milk Soup Recipe,"Masoor Dal, Coconut Milk, Extra Virgin Olive Oil, Onion, Garlic, Carrot, Red Bell Pepper, Tomato, Turmeric Powder, Cumin Powder, Green Chilli, Salt And Pepper, Coriander, Kabuli Chana, Sunflower Oil",15,15,35,50,4,Continental,Dinner,Vegetarian
Oriya Badi Chura Recipe | Sundried Lentil Dumpling Crumble,"Badi, Onion, Garlic, Green Chilli, Mustard Oil, Salt",6,10,5,15,2,Oriya Recipes,Snack,Diabetic Friendly
Poshto Phoolkopi Recipe (Cauliflower & Potato In Poppy Seeds Gravy),"Cauliflower, Potato, Poppy Seeds, Green Chilli, Kalonji, Green Chilli, Mustard Oil, Turmeric Powder, Salt, Sugar, Coriander",11,10,20,30,4,Bengali Recipes,Lunch,Vegetarian
Sarson Chole Ka Saag Recipe - Kabuli Chana In Mustard Leaves Gravy,"Kabuli Chana, Makki Ka Atta, Green Chilli, Garlic, Salt, Spinach Leaves, Bathua Leaves, Mustard Greens, Ghee, Ginger, Garlic, Onion, Tomato, Red Chilli Powder, Salt, Cumin Powder, Coriander Powder, Garam Masala Powder, Turmeric Powder, White Butter Serve",20,500,60,560,4,North Indian Recipes,Main Course,High Protein Vegetarian
Bell Pepper & Parsley Rice Recipe,"Olive Oil, Garlic, Onion, Salt, Rosemary, Rice, Olive Oil, Red Chilli Flax, Salt, Capsicum, Mixed Herbs, Capsicum, Capsicum, Parsley",14,15,30,45,4,Continental,Main Course,Vegetarian
Taiwanese Style Gua Bao Recipe - Steamed Bao Buns With Sweet And Spicy Mushroom & Tofu Recipe,"All Purpose Flour, Whole Wheat Flour, Active Dry Yeast, Sugar, Salt, Button Mushrooms, Tofu, Soy Sauce, Homemade Hoisin Sauce, Red Chilli Sauce, Honey, Cucumber, Tomato, Red Bell Pepper",14,200,45,245,4,Appetizer,Snack,High Protein Vegetarian
Cauliflower Paneer Kofta Curry Recipe,"Cauliflower, Paneer, Potato, Corn Flour, Red Chilli Powder, Coriander Powder, Cumin Powder, Garam Masala Powder, Salt, Onion, Tomato, Ajwain, Kashmiri Red Chilli Powder, Coriander Powder, Garam Masala Powder, Salt, Butter Oil, Fresh Cream, Water, Coriander",20,15,35,50,3,North Indian Recipes,Dinner,High Protein Vegetarian
Green Apple Rasam Recipe,"Green Apple, Arhar Dal, Tomato, Asafoetida, Turmeric Powder, Rasam Powder, Water, Curry Leaves, Coriander, Ghee, Mustard Seeds, Cumin Seeds, Garlic, Dry Red Chilli",14,10,20,30,4,South Indian Recipes,Dinner,High Protein Vegetarian
Kerala Style Varutharacha Sambar Recipe - Tangy Coconut Sambar Recipe,"Arhar Dal, Potato, Drumstick, Vellai Poosanikai, Carrots, Bhindi, Tomato, Shallots, Tamarind Water, Turmeric Powder, Green Chilli, Curry Leaves, Coriander, Salt, Fresh Coconut, Coriander, Dry Red Chilli, Black Urad Dal, Chana Dal, Methi Seeds, Asafoetida, Curry Leaves, Coconut Oil, Coconut Oil, Mustard Seeds, Shallots, Dry Red Chilli, Curry Leaves",28,10,30,40,3,Kerala Recipes,Lunch,High Protein Vegetarian
Tomato Dosa Recipe,"Rice, White Urad Dal, Tomato, Methi Seeds, Salt, Cooking Soda, Water, Sunflower Oil Gheecook Dosa",8,260,25,285,8,South Indian Recipes,South Indian Breakfast,Vegetarian
No Onion No Garlic Kadamba Sambar Sadam - Kovil Sadam Recipe,"Rice, Arhar Dal, Dried Green Peas, Kabuli Chana, Black Eyed Beans, Turmeric Powder, Tamarind, Potato, Vellai Poosanikai, Green Beans, Chow Chow, Small Brinjal, Chana Dal, White Urad Dal, Coriander, Methi Seeds, Black Pepper Corns, Dry Red Chilli, Mustard Seeds, Curry Leaves, Asafoetida, Sundakkai, Sesame",23,20,30,50,6,South Indian Recipes,Lunch,Vegetarian
"Cucumber, Red Radish, Tomatoes & Onion Salad Recipe","Tomato, Cucumber, Red Radish, Onion, Green Chilli, Salt And Pepper, Lemon Juice, Coriander",8,15,15,30,4,Indian,Appetizer,Diabetic Friendly
Homemade Baked Donuts Recipe,"All Purpose Flour, Baking Powder, Salt, Curd, Sugar, Milk, Sunflower Oil, Vanilla Extract",8,30,20,50,4,Continental,Snack,Diabetic Friendly
Suran Fodi Recipe - Goan Semolina Crusted Yam,"Elephant Yam, Tamarind Paste, Salt, Red Chilli Powder, Turmeric Powder, Sunflower Oil, Sooji, Rice Flour, Red Chilli Powder, Turmeric Powder, Salt",11,10,90,100,4,Goan Recipes,Side Dish,Vegetarian
Turai Moong Dal Recipe - Turia Mag Ni Dal,"Yellow Moong Dal, Water, Turmeric Powder, Salt, Sunflower Oil, Cumin Seeds, Ginger, Green Chilli, Tomato, Red Chilli Powder, Turmeric Powder, Coriander, Bay Leaf, Cinnamon Stick, Ridge Gourd, Lemon, Salt, Coriander",18,10,20,30,4,Gujarati Recipesï»¿,Side Dish,No Onion No Garlic (Sattvic)
"Homemade Quick Puff Pastry Sheet Recipe | Perfect For Puffs, Tarts & Pies.","All Purpose Flour, Salt, Butter, Chilled Water",4,1440,0,1440,2,Continental,Vegetarian,Diabetic Friendly
Sindhi Karela Bhaji Recipe - Sindhi Style Bitter Gourd Sabzi,"Karela, Onion, Tomato, Curd, Green Chilli, Ginger, Garlic, Cumin Seeds, Kashmiri Red Chilli Powder, Coriander Powder, Cardamom Powder, Turmeric Powder, Anardana Powder, Coriander, Sunflower Oil, Salt",16,10,30,40,4,Sindhi,Lunch,Diabetic Friendly
Osmania Biscuits Recipe,"Butter, Vivatta Maida, Milk Powder, Soy Flour, Salt, Sugar, Baking Powder, Milk Brush Before Baking",8,20,25,45,12,Andhra,Snack,Vegetarian
Udupi Style Bendekayi Palya Recipe - Ladies Finger With Coconut,"Bhindi, Fresh Coconut, Dry Red Chilli, Tamarind, Jaggery, Salt, Sunflower Oil, Mustard Seeds, White Urad Dal, Dry Red Chilli, Curry Leaves",11,10,35,45,3,Udupi,Side Dish,Vegetarian
Kerala Kadala Curry Recipe - Spicy Chickpeas in Coconut Curry,"Kala Chana, Coconut Oil, Mustard Seeds, Curry Leaves, Green Chilli, Pearl Onion, Garlic, Ginger, Homemade Tomato Puree, Turmeric Powder, Red Chilli Powder, Salt, Fresh Coconut, Coriander, Fennel Seeds",15,400,60,460,5,Kerala Recipes,South Indian Breakfast,High Protein Vegetarian
Mac and Cheese On Crostini Recipe,"Baguette, Macaroni Pasta, Mozzarella Cheese, Chilli Garlic Sauce, Salt, Extra Virgin Olive Oil Butter",6,10,30,40,2,Italian Recipes,Appetizer,Vegetarian
Spicy Avocado Scrambled Eggs Recipe,"Avocado, Whole Eggs, Milk, Green Chilli, Black Pepper Powder, Cumin Powder, Onion, Dried Oregano, Garlic, Coriander, Sunflower Oil, Salt",12,10,15,25,2,Continental,World Breakfast,Eggetarian
Mango Smoothie Bowl Recipe,"Mango, Papaya, Curd, Watermelon, Kiwi, Dessicated Coconut, Pumpkin Seeds",7,10,10,20,4,Continental,World Breakfast,Sugar Free Diet
Arbi Dahi Wali Sabzi ,"Arabic, Curd, Celery, , Turmeric Powder, Coriander Powder, Garam Masala Powder, Coriander, Salt, Oil, Of Water Accordinguse",11,15,25,40,4,North Indian Recipes,Lunch,Vegetarian
Raw Mango Masoor Dal Recipe,"Masoor Dal, Raw Mango, Green Chilli, Turmeric Powder, Salt, Mustard Oil, Cumin Seeds, Mustard Seeds, Kalonji Seeds, Fennel Seeds, Fenugreek Seeds, Dry Red Chilli",12,10,20,30,4,North Indian Recipes,Dinner,High Protein Vegetarian
Cold Coffee Recipe,"Instant Coffee Powder, Milk, Sugar, Ice Cream, Ice Cubes",5,5,10,15,2,Continental,Snack,Vegetarian
Baked Samosa Pinwheels Recipe,"Vivatta Maida, Sooji, Salt, Sunflower Oil, Water Make The Dough, Raw Banana, Green Peas, Green Chilli, Coriander, Cumin Seeds, Turmeric Powder, Red Chilli Powder, Garam Masala Powder, Amchur, Salt, Sesame Seeds, Sunflower Oil",17,20,20,40,2,Indian,Snack,Vegetarian
Aloo Aur Mooli Ke Patto Ki Sabzi ,"Radish Leaves, Potato, Garlic, Dry Red Chilli, Mustard Oil, Salt, Cumin Powder, Small Spoon Red Chilli Powder, Turmeric Powder",9,10,30,40,4,Indian,Lunch,Vegetarian
Gulkand Seviyan Kheer Recipe,"Milk  Full Fat, Thin Semiya, Cardamom Powder, Gulkand, Saffron Strands, Pistachios, Rose Water, Dried Rose Petals",8,0,30,30,4,North Indian Recipes,Dessert,Vegetarian
Napa Cabbage Coleslaw with Greek Yogurt Recipe,"Napa Cabbage, Carrot, Cucumber, Sunflower Seeds, Cranberries, Hung Curd, Honey, Salt",8,30,0,30,4,Continental,Appetizer,Vegetarian
One-Pot Stove Top Lasagna Recipe,"Lasagna Sheets, Red Bell Pepper, Yellow Bell Pepper, Broccoli, Feta Cheese, Mozzarella Cheese, Tomato, Garlic  Pound, Onion, Dried Thyme Leaves, Basil Leaves, Salt, Sunflower Oil",13,10,45,55,4,Italian Recipes,Main Course,Vegetarian
Kashmiri Style Rajma Gogji Recipe - Kidney Beans & Turnip Curry,"Kashmiri Rajma, Onion, Tomato, Garlic, Ginger, Turnips, Dry Ginger Powder, Kashmiri Red Chilli Powder, Turmeric Powder, Fennel Powder, Kashmiri Masala Powder, Mustard Oil, Onion, Salt",14,10,80,90,4,Kashmiri,Lunch,Vegetarian
Simple & Luscious Pista Ice Cream Recipe,"Fresh Cream, Condensed Milk, Pistachios, Pistachio Extract",4,480,0,480,4,Continental,Dessert,Vegetarian
Scrambled Eggs With Ridge Gourd Sabzi Recipe,"Ridge Gourd, Whole Eggs, Onion, Ginger, Green Chilli, Coriander Powder, Red Chilli Powder, Turmeric Powder, Curry Leaves, Coriander, Salt",11,10,15,25,4,Indian,Indian Breakfast,Eggetarian
Karnataka Style Aralu Sandige Recipe - Puffed Paddy Fryums,"Puffed Rice, Sabudana, Vellai Poosanikai, Green Chilli, Coriander, Cumin Seeds, Asafoetida, Salt",8,60,5,65,25,Karnataka,Snack,Vegetarian
Goan Sweet Churmo Recipe,"Whole Wheat Flour, Water, Cup Whole Wheat Flour, Cups Sunflower Oil Deep Fry, Jaggery, Water, Red Chilli Powder, Tablespoon Ghee Grease The Plate",8,20,30,50,8,Goan Recipes,Snack,Vegetarian
Thengai Poornam Kozhukattai / Ukadiche Modak Recipe With Rice Flour,"Rice Flour, Water, Sunflower Oil, Salt, Fresh Coconut  Grated, Jaggery, Cardamom Powder",7,10,30,40,12,Maharashtrian Recipes,Snack,Vegetarian
Baked Vermicelli Malpua Recipe,"Semiya, Whole Wheat Flour, Milk Powder, Gulab Jamun Mix, Paneer, Fennel Seeds, Cardamom Powder, Baking Soda, Milk, Sunflower Oil, Ghee, Sugar, Water, Pistachios",14,30,20,50,4,Indian,Dessert,Vegetarian
Heart Shaped Cake Pops Recipe,"Lemon Pound Cake, Condensed Milk, Decorative Sugar, Cocoa Powder, Milk",5,20,40,60,4,Continental,Dessert,Eggetarian
Beet Baba Ganoush Dip Recipe,"Brinjal, Beetroot, Tahini, Salt, Extra Virgin Olive Oil, Garlic, Lemon Juice, Paprika Powder, Coriander",9,10,40,50,4,Mediterranean,Snack,Vegetarian
Indian Misal Bunny Chow Recipe,"Mixed Sprouts, Salt, Turmeric Powder, Tomato, Sunflower Oil, Cumin Seeds, Green Chilli, Onion, Ginger Garlic Paste, Maharashtrian Goda Masala, Curry Leaves, Tamarind Paste, Coriander, Onion, Farsan, Lemon Wedges, Pav Buns",17,15,30,45,3,Maharashtrian Recipes,Snack,High Protein Vegetarian
Varan Bhaat Recipe - Maharashtrian Dal Recipe,"Arhar Dal, Green Chilli, Fresh Coconut, Cumin Seeds, Turmeric Powder, Salt, Ghee, Asafoetida, Cumin Seeds",9,10,30,40,2,Goan Recipes,Lunch,Vegetarian
Karela Besan Sabzi Recipe,"Karela, Onion, Garlic, Ginger, Gram Flour, Turmeric Powder, Coriander, Garam Masala Powder, Red Chilli Powder, Amchur, Ajwain, Mustard Oil, Salt",13,0,0,0,4,Rajasthani,Lunch,Diabetic Friendly
Himachali Style Pahari Khatta Recipe (Boondi In Tangy Yogurt Curry),"Boondi, Asafoetida, Cinnamon Stick, Cardamom Powder, Methi Seeds, Gram Flour, Curd, Turmeric Powder, Coriander Powder, Red Chilli Powder, Salt, Sunflower Oil, Coriander",13,0,15,15,4,Himachal,Lunch,Vegetarian
Soy Chunks Manchurian Recipe In Sweet & Spicy Chinese Sauce,"Soy Chunks, Spring Onion Greens, Green Bell Pepper, Red Bell Pepper, Garlic, Green Chilli, Ginger, Corn Flour, Vegetable Stock, Soy Sauce, Tomato Ketchup, Red Chilli Sauce, Sunflower Oil Sunflower Oil, Salt",14,15,30,45,2,Indo Chinese,Dinner,Vegetarian
Sukhe Methi Chole Recipe,"Kabuli Chana, Methi Leaves, Ghee, Cumin Seeds, Bay Leaf, Onion, Garlic, Ginger, Green Chilli, Salt, Turmeric Powder, Red Chilli Powder, Cumin Powder, Garam Masala Powder, Coriander Powder, Tomato, Tomato, Tomato",18,480,40,520,4,Indian,Main Course,Vegetarian
Chicken Jalfrezi Recipe - Chicken And Bell Peppers In Tomato Gravy,"Chicken Breasts, Onion, Red Bell Pepper, Green Bell Pepper, Carrots, Ginger, Garlic, Tomato, Homemade Tomato Puree, Honey, Turmeric Powder, Garam Masala Powder, Coriander Powder, Stalk Coriander, Butter, Salt, Sunflower Oil",17,20,35,55,4,North Indian Recipes,One Pot Dish,High Protein Non Vegetarian
Stir Fried Honey Parsnip Recipe With Herbs,"Parsnip Carrots, Honey, Sesame, Soy Sauce, Garlic, Dried Thyme Leaves, Dried Oregano, Vegetable Stock, Black Pepper Powder",9,10,20,30,4,Continental,Appetizer,Vegetarian
Eggless Jam-Filled Thumbprint Cookies Recipe,"All Purpose Flour, Butter, Caster Sugar, Vanilla Extract, Salt, Jam",6,20,30,50,4,Continental,Snack,Vegetarian
Murungakkai Vendhaya Keerai Sambar Recipe-Drumstick & Fenugreek Greens Sambar,"Arhar Dal, Tamarind Water, Drumstick, Tomato, Pearl Onion, Sambar Powder, Turmeric Powder, Methi Leaves, Salt, Sesame, Mustard Seeds, Asafoetida, Curry Leaves, Dry Red Chilli, Curry Leaves",15,15,30,45,4,South Indian Recipes,Lunch,Diabetic Friendly
Awadhi Style Sheermal Recipe - Sweet Flat Bread,"All Purpose Flour, Sugar, Baking Powder, Cardamom Powder, Milk, Saffron Strands, Salt, Ghee",8,30,10,40,4,Awadhi,Lunch,Vegetarian
Murmura Jaggery Laddu/ Pori Urundai Recipe,"Puffed Rice, Jaggery, Roasted Gram Dal, Dessicated Coconut, Roasted Peanuts, Cardamom Powder, Water",7,0,45,45,4,Indian,Snack,Vegetarian
"Millet Energy Bites With Almonds, Dates And Coconut Recipe","Ragi Flour, Bajra Flour, Dates, Badam, Dessicated Coconut, Honey",6,20,20,40,4,Continental,Snack,High Protein Vegetarian
Palak Dal ,"Spinach, Of Tur Dal, Coconut, Green Chilli, Coriander Leaves, Salt, Ghee, Rye, Cumin Seeds, Asafoetida, Curry Leaves",11,10,30,40,4,Karnataka,Lunch,High Protein Vegetarian
Spiced Prune Chutney Recipe,"Prunes, Onion, Tomato, Cinnamon Powder, Nutmeg Powder, Ajwain, Red Chilli Flakes, Honey, Vinegar, Salt",10,10,20,30,4,Indian,Side Dish,Vegetarian
Kavuni Arisi Paniyaram Recipe (Black Rice Paniyaram Recipe),"Black Rice, Palm Jaggery, Whole Wheat Flour, Health Mix, Sunflower Oil",5,240,20,260,10,Chettinad,South Indian Breakfast,Vegetarian
Konkani Style Koli Masala Recipe- Spice Mix,"Dry Red Chilli, Byadagi Dried Chilli, Coriander, Fennel Seeds, Cumin Seeds, Ajwain, Whole Black Peppercorns, Mace, Cinnamon Stick, Cloves, Cardamom, Black Cardamom, Poppy Seeds, Mustard Seeds, Bay Leaf, Kalpasi Flower, Star Anise, Nutmeg Powder, Asafoetida",19,50,20,70,4,Konkan,Lunch,Eggetarian
Cauliflower Palak Methi Muthia Recipe,"Cauliflower, Spinach Leaves, Methi Leaves, Gram Flour, Whole Wheat Flour, Red Chilli Powder, Turmeric Powder, Salt, Sunflower Oil, Sugar, Coriander, Sunflower Oil, Mustard Seeds, Cumin Seeds, Curry Leaves",15,15,15,30,4,Gujarati Recipesï»¿,Appetizer,Vegetarian
Yele Kadubu Recipe With Sweet And Spicy Onion Chutney,"Wheat Flour, Water, Salt, Ghee, Oil, Red Onion, Bud Garlic, Fenugreek Seeds, Dry Red Chili, Tamarind Paste, Jaggery, Oil, Salt",13,15,15,30,2,Karnataka,Snack,Vegetarian
Pulikuthi Upperi Recipe - Spicy & Tangy Palakkad Poriyal Recipe,"Raw Banana, Kaddu, Bhindi, Tamarind, Turmeric Powder, Jaggery, Rice, Methi Seeds, Dry Red Chilli, Mustard Seeds, Curry Leaves, Asafoetida, Coconut Oil, Salt",14,10,20,30,4,Kerala Recipes,Lunch,Vegetarian
High Protein Spinach & Soy Bites Recipe,"Spinach Leaves, Soy Flakes, Almond Meal, Whole Wheat Bread Crumbs, Parmesan Cheese, Red Chilli Flakes, Paneer, Salt And Pepper, Extra Virgin Olive Oil",9,15,45,60,4,Snack,High Protein Vegetarian,High Protein Vegetarian
Eggless Cranberry Pistachio Biscotti Recipe,"All Purpose Flour, Baking Powder, Sunflower Oil, Sugar, Vanilla Extract, Pistachios, Cranberries, Salt",8,60,35,95,4,French,Dessert,Vegetarian
Bottle Gourd Peel Chutney Recipe,"Gourd, Tomato, Green Chilies, Salt, Turmeric Powder, Oil, Mustard, Fenugreek Seeds, White Urad Lentils, Dry Red Chilli, Asafoetida, Of Green Coriander, Tamarind Paste",13,10,15,25,6,South Indian Recipes,Side Dish,Vegetarian
Methi & Soya Chunks Dry Sabzi Recipe,"Soy Chunks, Methi Leaves, Tomato, Onion, Sunflower Oil, Mustard Seeds, Turmeric Powder, Red Chilli Powder, Cumin Powder, Coriander Powder, Garam Masala Powder, Salt",12,30,20,50,4,North Indian Recipes,Side Dish,Vegetarian
Aloo Bilahi Maas Recipe - Assamese Fish Curry With Potatoes And Tomatoes,"Rohu Fish Any Other Fresh Water Fish, Mustard Oil, Turmeric Powder, Salt, Bay Leaf, Dry Red Chilli, Cumin Seeds, Potato, Tomato, Onion, Garlic, Turmeric Powder, Garam Masala Powder, Cumin Powder, Water, Mustard Oil, Coriander",17,10,20,30,2,Assamese,Dinner,High Protein Non Vegetarian
Thinai Thakkali Sadam Recipe (Foxtail Millet Tomato Rice),"Foxtail Millet, Onion, Tomato, Garlic, Ginger, Green Chilli, Fennel Seeds, Kashmiri Red Chilli Powder, Turmeric Powder, Mustard Seeds, Curry Leaves, Sunflower Oil, Salt",13,15,20,35,4,Tamil Nadu,Lunch,Vegetarian
Chicken Wings With Bhuna Masala Recipe,"Chicken Wings, Onion, Tomato, Ginger, Garlic, Red Chilli Powder, Turmeric Powder, Garam Masala Powder, Cumin Powder, Salt",10,10,30,40,4,Indian,Appetizer,High Protein Non Vegetarian
Tamil Nadu Style Beetroot kootu Recipe,"Beetroot, Yellow Moong Dal, Salt, Fresh Coconut, Dry Red Chilli, Cumin Seeds, Curry Leaves, Coconut Oil, Mustard Seeds, White Urad Dal, Curry Leaves",11,10,30,40,4,Tamil Nadu,Side Dish,Vegetarian
à¤¸à¥à¤®à¤¿à¤¯à¤¾ à¤à¤ªà¤®à¤¾ à¤°à¥à¤¸à¤¿à¤ªà¥ -Semiya Upma ,"Semia, Rye, White Urad Dal, Asafoetida, Curry Leaves, Dal Sugar Powder, Teaspoon Cardamom Powder, Turmeric Powder, Onion, Ginger, Carrot, Green Beans, Carrots, Lemon Juice, Sugar, Red Chili Powder, Salt, Of Green Coriander",18,15,30,45,4,South Indian Recipes,South Indian Breakfast,Vegetarian
Sindhi Sai Bhaji Recipe,"Spinach, Fenugreek, Heart Leaves, Chana Dal, Green Moong Dal, Carrots, Green Beans, Eggplant, Gourd, Onion, Tomato, Raw Mango, Ginger, Green Chilli, Ghee, Salt, Turmeric Powder, Coriander Powder, Garlic, Red Chilli Powder, Ghee",21,25,20,45,4,Sindhi,One Pot Dish,Diabetic Friendly
Avalakki Porridge In Warm Spiced Berries Recipe,"Poha, Ripe Bananas, Coconut Milk Regular Milk, Honey Maple Syrup, Orange, Orange, Blackberries Any Other Berries, Black Pepper Powder, Vanilla Extract, Peanut Butter Any Other Nut Butter",10,10,15,25,3,South Indian Recipes,South Indian Breakfast,Vegetarian
Mudaliar Style Omelette Curry Recipe,"Whole Eggs, Onion, Green Chilli, Coriander, Salt, Onion, Green Chilli, Coriander, Whole Black Peppercorns, Ginger, Garlic, Coriander, Mint Leaves, Tomato, Fresh Coconut, Poppy Seeds, Hung Curd, Turmeric Powder, Salt, Sunflower Oil, Cinnamon Stick, Cardamom, Curry Leaves, Onion, Coriander",25,15,45,60,4,Tamil Nadu,Lunch,Eggetarian
Doodh Jhinge Curry Recipe-Ridge Gourd Cooked In Milk,"Ridge Gourd, Milk, Ginger, Green Chilli, Dry Red Chilli, Mustard Seeds, Mustard Oil, Ghee, Sugar, Salt",10,10,20,30,2,Indian,Side Dish,Vegetarian
Amla Chutney Recipe,"Of Amla, Cumin, Mustard, Curry Leaves, Asafetida, Jaggery, Red Chili Powder As Desired, Salt, According",9,10,45,55,4,North Indian Recipes,Side Dish,Vegetarian
Arbi Dahi Wali Sabzi Recipe,"Colocasia Root, Curd, Ajwain, Kashmiri Red Chilli Powder, Turmeric Powder, Coriander Powder, Garam Masala Powder, Coriander, Salt, Sunflower Oil Cook, Water",11,15,25,40,4,North Indian Recipes,Lunch,Vegetarian
South Indian Style Radish Greens Stir Fry ,"Small Onion, Tomato, Radish Leaves, Turmeric Powder, Salt, Tur Dal, Coconut, Dry Red Chilli, Sesame Oil, Cumin Seeds, Ginger, Asafetida, Curry Leaves",13,10,20,30,4,South Indian Recipes,Lunch,Vegetarian
Vegetarian Hakka Noodles -Chinese Chow Mein Recipe,"Veg Hakka Noodles, Onion, Ginger, Carrots, Green Bell Pepper, Cabbage, Green Beans, Spring Onion, Black Pepper Powder, Soy Sauce, Red Chilli Sauce, Chilli Vinegar, Salt, Sunflower Oil",14,20,30,50,4,Cantonese,Main Course,Vegetarian
Sweet Potato Mash Recipe,"Sweet Potato, Milk, Butter, Garlic, Salt And Pepper",5,5,15,20,4,Continental,Side Dish,Vegetarian
Thenga Manga Soya Sundal Recipe,"Soybeans, Mango, Fresh Coconut, Turmeric Powder, Red Chilli Powder, Curry Leaves, Salt, Coconut Oil, Asafoetida, Mustard Seeds",10,10,35,45,4,South Indian Recipes,Side Dish,High Protein Vegetarian
Raw Banana Thoran ,"Raw Banana Peel, Turmeric Powder, Water, Salt, Coconut, Garlic, Cumin, Green Chilli, Small Onion, Salt, Oil, Mustard, Dry Red Chilli, Curry Leaves",14,10,30,40,2,Kerala Recipes,Lunch,Vegetarian
Kerala Cheriya Ulli Sambar Recipe,"Arhar Dal, Turmeric Powder, Tamarind Water, Shallots, Tomato, Sambar Powder, Fresh Coconut, Green Chilli, Salt, Mustard Seeds, Cumin Seeds, Fresh Coconut, Asafoetida, Curry Leaves, Dry Red Chilli, Coconut Oil",16,10,30,40,2,Karnataka,Lunch,High Protein Vegetarian
Oriya Special Dalma Recipe (Oriya Dal & Tarkari),"Arhar Dal, Elephant Yam, Kaddu, Brinjal, Raw Banana, Carrot, Mooli Mullangi, Cinnamon Powder, Red Chilli Powder, Panch Phoran Masala, Turmeric Powder, Sugar, Salt, Sunflower Oil, Ghee, Dry Red Chilli, Fennel Seeds, Fresh Coconut, Coriander, Coriander",20,20,50,70,4,Oriya Recipes,Lunch,Vegetarian
Methi Shakarkand Aloo Sabzi Recipe - Sweet Potato & Fenugreek Leaves Sabzi,"Sweet Potato, Methi Leaves, Cumin Seeds, Green Chilli, Coriander Powder, Black Pepper Powder, Turmeric Powder, Salt",8,10,30,40,4,North Indian Recipes,Side Dish,Vegetarian
Sauteed Spinach With Garlic And Cheese Recipe,"Spinach Leaves, Garlic, Parmesan Cheese, Black Pepper Powder, Cinnamon Powder, Extra Virgin Olive Oil, Salt",7,5,10,15,2,European,Appetizer,Vegetarian
Egg Hakka Noodles Recipe,"Veg Hakka Noodles, Spring Onion, Carrot, Green Bell Pepper, Broccoli, Button Mushrooms, Soy Sauce, Green Chilli Sauce, Garlic, Black Pepper Powder, Spring Onion Greens, Salt, Whole Eggs, Black Pepper Powder, Salt",15,25,30,55,4,Chinese,Main Course,Eggetarian
Goan Style Recheado Bangdo Recipe | Stuffed Mackerel,"Mackerel Fish, Cup Goan Recheado Masala, Cup Sooji, Extra Virgin Olive Oil Shallow Fry, Salt",5,60,15,75,6,Goan Recipes,Main Course,High Protein Non Vegetarian
Idichakka Thoran Recipe (Young Jack Fruit With Spiced Coconut),"Jackfruit Raw, Turmeric Powder, Fresh Coconut, Dry Red Chilli, Onion, Green Chilli, Cumin Seeds, Mustard Seeds, White Urad Dal, Curry Leaves, Asafoetida, Salt",12,15,45,60,4,Kerala Recipes,Lunch,Vegetarian
Kala Chana Mithaas Liye Recipe (Chickpeas & Lotus seed In Date Curry),"Kala Chana, Phool Makhana, Dates, Raisins, Fresh Cream, Bay Leaf, Cinnamon Stick, Coriander Powder, Red Chilli Powder, Fennel Seeds, Turmeric Powder, Salt",12,5,20,25,4,Himachal,Lunch,Vegetarian
Dry Methi Malai Matar Recipe,"Methi Leaves, Green Peas, Fresh Cream, Sunflower Oil, Bay Leaf, Cinnamon Stick, Cumin Seeds, Onion, Garlic, Ginger, Green Chilli, Tomato, Tomato Ketchup, Garam Masala Powder, Red Chilli Powder, Salt",16,10,30,40,4,North Indian Recipes,Dinner,Vegetarian
Goan Moolyacho Ross Recipe (Goan Radish Curry),"Mooli Mullangi, Arhar Dal, Onion, Fresh Coconut, Green Chilli, Dry Red Chilli, Coriander, Tamarind, Jaggery, Salt",10,20,30,50,4,Goan Recipes,Lunch,Vegetarian
Cauliflower And Methi Paratha Recipe,"Whole Wheat Flour, Sunflower Oil, Water, Salt, Cauliflower, Onion, Methi Leaves, Turmeric Powder, Red Chilli Powder, Garlic, Green Chilli, Cumin Seeds, Sunflower Oil, Salt, Ghee",15,20,40,60,4,Indian,Indian Breakfast,Vegetarian
Lau Er Khosha Bhaja Recipe - Bottle Gourd Peel Stir Fry,"Bottle Gourd, Potato, Mustard Oil, Kalonji, Green Chilli, Sugar, Poppy Seeds, Dry Red Chilli, Turmeric Powder, Salt",10,25,30,55,4,Bengali Recipes,Lunch,Vegetarian
Spicy Mango Lime Grilled Chicken Recipe,"Chicken Breasts, Mango, Lemon Juice, Sriracha Sauce Any Red Chilli Sauce, Fish Sauce, Extra Virgin Olive Oil, Garlic, Salt, Honey, Sriracha Sauce, Corn Flour, Water, Extra Virgin Olive Oil Grill The Chicken",13,60,20,80,4,Continental,Appetizer,High Protein Non Vegetarian
Overnight Pumpkin French Toast Baked Casserole Recipe,"Whole Eggs, Vanilla Extract, Sugar, Salt, Cinnamon Powder, Cloves, Nutmeg Powder, Pumpkin Puree, French Loaf, Brown Sugar, Walnuts, Butter, Milk",13,480,55,535,4,Continental,World Breakfast,Vegetarian
Coconut Kozhukattai Recipe,"Fresh Coconut, Rice Flour, Jaggery, Ghee, Water, Salt",6,20,10,30,5,Tamil Nadu,Dessert,Vegetarian
Buckwheat Dosa Recipe,"Buckwheat Flour, Black Urad Dal, Rice Flour, Salt, Sunflower Oil, Mustard Seeds, Asafoetida, Green Chilli, Coriander, Water",10,10,20,30,4,Indian,South Indian Breakfast,Vegetarian
Pear And Alfalfa Sprouts Salad Recipe,"Pears, Alfalfa Sprouts, Roasted Peanuts, Basil Leaves, Brie Cheese, Balsamic Vinegar, Black Pepper Powder, Salt",8,15,15,30,2,Continental,Side Dish,Vegetarian
Onion And Cheese Pepper Sandwich Recipe,"Whole Wheat Brown Bread, Cheddar Cheese, Mozzarella Cheese, Onion, Black Pepper Powder, Dried Oregano, Butter, Salt",8,10,20,30,4,Continental,Snack,Vegetarian
Saagwala Chicken  Recipe - Palak Chicken Curry,"Chicken, Spinach, Ajwain, Ghee, Garlic, Cardamom, Cinnamon Stick, Cloves, Ginger, Green Chilli, Onion, Red Chilli Powder, Garam Masala Powder, Fresh Cream, Salt",15,40,30,70,4,North Indian Recipes,Lunch,High Protein Non Vegetarian
Motichoor Ladoo Yogurt Cheesecake Recipe,"Multigrain Digestive Oat Biscuits, Butter, Britannia Cheese Spread  Classic, Hung Curd, Honey, Rose Water, Cardamom Powder, Motichoor Ladoos, Pistachios",9,30,0,30,20,Fusion,Dessert,Vegetarian
Chatpata Aloo Moong Sprouts Recipe With Buttered Pav Buns,"Green Moong Sprouts, Potato, Onion, Tomato, Green Chutney, Sweet Chutney, Chaat Masala Powder, Cumin Powder, Red Chilli Powder, Lemon Juice, Coriander, Pav Buns, Butter",13,20,20,40,4,Indian,Snack,Vegetarian
Bengali Style Mixed Vegetable ,"Trumpet, Pumpkin, Eggplant, Potato, Drumsticks, Cowpea Pod, Parwal, Radish, Mustard Oil, Oil, Dijon Mustard, Green, Turmeric Powder, Salt, Asafoetida, , Teaspoon Sugar",17,10,40,50,4,Bengali Recipes,Lunch,Vegetarian
 Bengali Style Cholar Dal Recipe,"Chana Dal, Coconut, Ghee, Turmeric Powder, Sugar, Salt, Ghee, Dry Red Chilli, , Cinnamon, Cumin Seeds, Bay Leaf, Green Chilies, Ginger",14,10,30,40,3,Bengali Recipes,Lunch,High Protein Vegetarian
Chicken In Thai Basil Sauce Recipe,"Thai Basil Leaves, Lemongrass, Garlic, Whole Black Peppercorns, Spring Onion, Green Chilli, Ginger, Coriander, Cumin Seeds, Salt, Coriander, Sunflower Oil, Chicken Breasts, Roasted Peanuts, Coconut Milk, Salt",16,15,20,35,4,Thai,Appetizer,High Protein Non Vegetarian
Chicken Seekh Kebab Recipe,"Chicken Breasts, Onion, Garlic, Ginger, Green Chilli, Garam Masala Powder, Coriander, Kashmiri Red Chilli Powder, Fennel Seeds, Cinnamon Stick, Black Pepper Powder, Lemon Juice, Gram Flour, Salt, Coal, Ghee",16,30,30,60,8,Hyderabadi,Appetizer,Non Vegeterian
Mutton Keema Soup Recipe,"Mutton, Onion, Tomato, Green Chilli, Bay Leaves, Tablespoon Coriander, Sprig Fresh Thyme Leaves, Black Pepper Powder, Ginger, Turmeric Powder, Cups Chicken Stock Vegetable Stockwater, Tablespoon Sunflower Oil, Salt",13,10,25,35,4,Middle Eastern,Appetizer,Non Vegeterian
Potoler Dolma Recipe,"Parwal, Cashews, Turmeric Powder, Red Chilli Powder, Garam Masala Powder, Cumin Seeds, Mustard Oil, Salt, Of Cottage Cheese, Figs, Dates, Almonds, Pistachios, Raisins, Sugar, Salt, Onion, Tomato, Green Chilli, Ginger, Of Green Coriander",21,30,20,50,4,Bengali Recipes,Lunch,Vegetarian
Instant Baked Aloo Tikki Recipe,"Potato, Green Onion, Capsicum, Wheat Flour Maida, Rice Flour, Salt, As Per  Red Chili Powder, Oil Brush",8,5,10,15,2,Indian,Snack,Vegetarian
Awadh Style Bakarhani Roti Recipe ( Thick Spiced Flat-Bread Recipe ),"All Purpose Flour, Sooji, Milk, Fresh Cream, Active Dry Yeast, Poppy Seeds, Cardamom Powder, Sugar, Cashew Nuts, Sunflower Oil Knead, Ghee, Salt",12,30,45,75,4,Awadhi,Main Course,Vegetarian
Radish Sandwich Recipe,"Whole Wheat Brown Bread, Mooli Mullangi, Green Bell Pepper, Black Pepper Powder, Chaat Masala Powder, Green Chilli, Cheese, Butter, Salt",9,10,20,30,4,Continental,Lunch,Vegetarian
Barnyard Millet And Mushroom Cutlet Recipe,"Barnyard Millet, Button Mushrooms, Onion, Ginger, Cloves, Green Chilli, Potato, Red Chilli Powder, Turmeric Powder, Coriander Powder, Garam Masala Powder, Salt, Sunflower Oil, Whole Wheat Bread Crumbs",14,10,30,40,4,Indian,Appetizer,Vegetarian
Indo Chinese Paneer Lolipop Recipe,"Paneer, Thai Sweet Chilli Sauce, Soy Sauce, Schezwan Sauce, Corn Flour, Garlic, Spring Onion Greens, Sesame Seeds, Corn Flour, Salt, Sunflower Oil, Toothpicks, Spring Onion Greens",13,20,15,35,6,Indo Chinese,Appetizer,High Protein Vegetarian
Kerala Style Murungai Keerai Thoran Recipe,"Drumstick Leaves, Pearl Onion, Ginger, Curry Leaves, Mustard Seeds, Salt, Coconut Oil, Fresh Coconut, Cumin Seeds, Turmeric Powder, Red Chilli Powder",11,25,15,40,4,Kerala Recipes,Lunch,Vegetarian
Ringan Ravaiya Recipe (Parsi Style Stuffed Eggplant Recipe),"Small Brinjal, Coconut Milk, Tamarind Water, Sunflower Oil, Fresh Coconut, Pearl Onion, Turmeric Powder, Garlic, Ginger, Dhansak Masala",10,20,45,65,4,Parsi Recipes,Lunch,Vegetarian
Ginger Teriyaki Rice Recipe,"Rice, Sesame Oil, Bud Garlic, Ginger, Green Onion, Salt, Pepper Powder, Ginger Teriyaki Sauce, Lemon Juice",9,10,30,40,4,Asian,Lunch,Vegetarian
Baked Salmon Recipe Flavored With Herbs And Tartare Dip,"Salmon Fillet, Salt, Black Pepper Powder, Fresh Herbs, Del Monte Tartare Dip, Butter Olive Oilgrease",6,10,30,40,2,Continental,Appetizer,Vegetarian
Kaccha Kela Aur Bhindi Ki Sabzi Recipe - Raw Banana & Ladies Finger Stir Fry,"Bhindi, Raw Banana, Turmeric Powder, Black Pepper Powder, Ssp Asafoetida, Amchur, Salt, Sunflower Oil, Red Chilli Powder, Garam Masala Powder, Coriander",11,10,30,40,4,North Indian Recipes,Side Dish,Diabetic Friendly
Vegan Instant Coffee Recipe,"Soy Milk Almond Milk, Sugar, Instant Coffee Powder",3,5,5,10,2,Indian,Vegan,Vegetarian
Egg Dosa Recipe With Cheesy Garlic Mayo,"Idli Dosa Batter, Whole Eggs, Onion, Tomato, Coriander, Del Monte Cheesy Garlic Mayo, Turmeric Powder, Red Chilli Powder, Salt, Sunflower Oil, Onion, Coriander",12,15,20,35,2,South Indian Recipes,South Indian Breakfast,Eggetarian
Brahmi Chutney Recipe,"Brahmi Leaves, Fresh Coconut, White Urad Dal, Chana Dal, , Asafoetida, Curry Leaves, Tamarind, Salt, Coconut Oil",10,10,5,15,4,South Indian Recipes,Side Dish,Vegetarian
"Bread Boats Recipe Filled With Spinach, Eggs And Sandwich Spread","Crusty Bread Log, Spinach Leaves, Onion, Garlic, Del Monte Sandwich Spread, Whole Eggs, Whole Black Peppercorns, Extra Virgin Olive Oil, Salt, Sugar, Cherry Tomato Garnish, Butter",12,15,30,45,4,Continental,World Breakfast,Eggetarian
Vazhaipoo Bajra Adai Recipe - Banana Flower & Pearl Millet Dosa,"Banana Flower, Onion, Turmeric Powder, Salt, White Urad Dal, Arhar Dal, Chana Dal, Bajra, Whole Black Pepper Corns, Curry Leaves",10,180,30,210,6,Tamil Nadu,South Indian Breakfast,Diabetic Friendly
Spicy & Tangy Goan Chicken Stew Recipe With Vegetables,"Chicken, Onion, Tomato, Green Chilli, Carrots, Potato, Green Peas, Ginger, Garlic, Coriander Powder, Cumin Powder, Black Pepper Powder, Tamarind Paste, Salt, Gingelly Oil, Water, Red Chilli Powder, Salt, Lemon Juice",19,10,45,55,4,Goan Recipes,Dinner,High Protein Non Vegetarian
Karnataka Style Sabsige Soppu Paddu Recipe (Dill leaves Savory Fritters Recipe),"Idli Dosa Batter, Onion, Green Chilli, Curry Leaves, Cumin Seeds, Dill Leaves, Salt, Sunflower Oil",8,10,30,40,4,Karnataka,South Indian Breakfast,Vegetarian
Spicy Mexican Salsa Recipe - Tomato Salsa Recipe,"Tomato, Onion, Green Chilli, Cumin Powder, Salt, Sugar, Coriander, Tabasco Original",8,15,20,35,4,Mexican,Side Dish,Vegetarian
Pitor Ki Sabzi Recipe,"Flour, Curd, , Ginger, Turmeric Powder, Salt, Tablespoon Oil, Cumin Seeds, Green, Asafoetida, Oil, Cumin Seeds, Dry Red Chilli, Curd, Green Chilli, Red Chilli Powder, Turmeric Powder, Salt",18,0,90,90,4,Rajasthani,Lunch,Vegetarian
Beetroot Gajar Mooli Salad Recipe - Radish & Beetroot Salad,"Mooli Mullangi, Beetroots, Carrots, Roasted Peanuts, Green Chilli, Lemon Juice, Salt",7,15,0,15,4,Indian,Appetizer,Vegetarian
Arbi Tomato Onion Sabzi ,"Arbi, Onion, Tomato, Ginger Garlic Paste, Asafetida, Turmeric Powder, Salt, Red Chili Powder, Garam Masala Powder, Green Chilli, Coriander Powder, Dry Red Chilli, Oil",13,10,45,55,4,North Indian Recipes,Lunch,Vegetarian
Chocolate Flavoured 7 Cup Burfi Recipe,"Gram Flour, Sugar, Ghee, Milk, Fresh Coconut, Cocoa Powder, Cashew Nuts, Cashew Nuts, Cardamom",9,10,60,70,4,North Indian Recipes,Dessert,Vegetarian
Whole Wheat Roasted Vegetable Pizza Pockets Recipe,"Yellow Zucchini, Green Zucchini, Yellow Bell Pepper, Red Bell Pepper, Onion, Sea Salt, Black Pepper Powder, Dried Oregano, Dried Basil Leaves, Red Chilli Flakes, Extra Virgin Olive Oil, Whole Wheat Flour   More, Extra Virgin Olive Oil, Active Dry Yeast, Sugar, Milk, Water    More, Dried Basil Leaves, Mozzarella Cheese, Homemade Pizza And Pasta Sauce, Italian Seasoning",21,20,300,320,8,Continental,Dinner,Vegetarian
Saunf Wali Hari Gobi Sabzi ,"Cabbage, Fennel, Ginger, Tomato, Bay Leaves, Green Chutney, Curd, Turmeric Powder, Coriander Powder, Salt, Red Chili Powder, Oil",12,20,30,50,4,North Indian Recipes,Side Dish,No Onion No Garlic (Sattvic)
Navrang Dal Recipe ( Spicy Mixed Lentils),"Green Moong Dal, White Urad Dal, Black Urad Dal, Pink Masoor Dal, Masoor Dal, Rajma, Kabuli Chana, Yellow Moong Dal, Arhar Dal, Onion, Tomato, Ginger Garlic Paste, Green Chilli, Coriander Powder, Red Chilli Powder, Garam Masala Powder, Kasuri Methi, Ginger, Ghee, Cinnamon Stick, Cumin Seeds, Salt",22,10,30,40,4,North Indian Recipes,Lunch,High Protein Vegetarian
Suran Kebab Masala Recipe - Yam In Tomato Onion Gravy,"Elephant Yam, Kebab Masala, Onion, Homemade Tomato Puree, Garlic, Ginger, Green Chilli, Red Chilli Powder, Turmeric Powder, Coriander Powder, Cumin Powder, Garam Masala Powder, Curd, Sunflower Oil, Salt",15,10,20,30,4,North Indian Recipes,Lunch,Vegetarian
No Bake Poha & Millets Chocolate Tart With Strawberry Cheese Recipe,"Poha, Barnyard Millet, Badam, Cashew Nuts, Jaggery, Dark Chocolate, Chocolate Pearls, Hung Curd, Britannia Cream Cheese, Strawberries, Sugar",11,360,0,360,6,Fusion,Dessert,Vegetarian
Paneer Sizzler Recipe In Chilli Garlic Sauce With Rice,"Sesame, Garlic, Blanched Tomato, Red Chilli Sauce, Water, Corn Flour, Sugar, Mixed Vegetables, Salt, Basmati Rice, Onion, Carrot, Green Beans, Red Yellow And Green Bell Peppers, Green Chilli, Ginger Garlic Paste, Sesame, Salt, Paneer, Onion, Carrot, Tomato, Cauliflower, Sweet Corn, Green Beans, Sunflower Oil, Whole Black Peppercorns, Salt, Spring Onion Greens, Cabbage, Butter",31,15,45,60,2,Continental,Main Course,Vegetarian
Whole Wheat Black Forest Cake In A Jar Recipe (Eggless),"Butter, Curd, Milk, Whole Wheat Flour, Caster Sugar, Baking Powder, Baking Soda, Cocoa Powder, Chocolate Chips, Water, Strawberries, Sugar, Heavy Whipping Cream, Caster Sugar, Vanilla Extract, Strawberries, Chocolate Chips",17,20,30,50,2,Continental,Dessert,Vegetarian
Aratikaya Masala Pulusu Recipe - Raw Banana Stir Fry,"Raw Banana, Mustard Seeds, Curry Leaves, Red Chilli Powder, Turmeric Powder, Tamarind Water, Ginger, Garlic, Rice",9,10,25,35,4,Andhra,Lunch,Diabetic Friendly
Kashmiri Kesar Pulao Recipe,"Rice, Saffron, Milk, Cumin Seeds, Fennel, Cinnamon, , Salt, As Per",9,5,20,25,4,Kashmiri,Main Course,Vegetarian
Kheer Puli Pitha | Bengali Pitha Recipe,"Milk, Palm Jaggery, Cardamom Powder, Rice Flour, Hot Water, Ghee, Fresh Coconut, Salt, Cashew Nuts",9,10,60,70,4,Bengali Recipes,Dessert,Vegetarian
Chilled Spinach And Cucumber Soup Recipe,"Spinach Leaves, Cucumber, Carrot, Clove Garlic, Ginger, Green Chilli, Onion, Paprika Powder, Curd, Balsamic Vinegar, Extra Virgin Olive Oil, Pine Nuts",12,20,25,45,4,Continental,Dinner,Vegetarian
Thandai Mousse Recipe,"Thandai Masala, Agar Agar, Milk, Sugar, Heavy Whipping Cream, Lemon Juice, Pistachios",7,360,30,390,2,North Indian Recipes,Dessert,Gluten Free
Kesar Pista Mango Ice Cream Recipe,"Mango, Milk, Heavy Whipping Cream, Vanilla Extract, Water, Pistachios, Saffron Strands, Honey Date Syrup",8,30,120,150,4,Fusion,Dessert,Vegetarian
Kothu Kari Kuzhambu Recipe - Mutton Keema Curry,"Mutton Kheema, Sunflower Oil, Bay Leaf, Cloves, Cinnamon Stick, Cardamom, Star Anise, Dagad Phool, Ginger, Garlic, Green Chilli, Onion, Tomato, Red Chilli Powder, Garam Masala Powder, Turmeric Powder, Coriander Powder, Black Pepper Powder, Coriander, Mint Leaves, Salt",21,10,19,29,4,Tamil Nadu,Main Course,Non Vegeterian
Gujarati Kadhi With Milk And Mint Recipe,"Curd, Water, Gram Flour, Milk, Fresh Cream, Green Chilli, Ginger, Sugar, Ghee, Methi Seeds, Cumin Seeds, Dry Red Chilli, Cloves, Cinnamon Stick, Curry Leaves, Mint Leaves, Asafoetida",17,7,15,22,4,Gujarati Recipesï»¿,Dinner,Vegetarian
Cheese Garlic Cracked Bread Recipe,"Burger Buns, Veeba Pasta Sauce, Mozzarella Cheese, Salted Butter, Extra Virgin Olive Oil, Garlic, Mixed Herbs, Coriander",8,15,10,25,3,Continental,Appetizer,Vegetarian
PiÃ±a Colada Recipe,"Ice   Pineapple  Peel And Chop, Coconut Milk, Sugar, White Bacardi Rum, Pistachios, As Per The Experiment",6,5,20,25,4,Caribbean,Appetizer,Vegetarian
Sattu Ka Namkeen Sharbat Recipe,"Roasted Gram Flour, Mint Leaves, Coriander, Green Chilli, Lemon Juice, Cumin Powder, Black Salt, Chilled Water, Salt",9,10,0,10,2,North Indian Recipes,Snack,Vegetarian
Sago Kheer Recipe - Tapioca Milk Pudding,"Milk, Sabudana, Sugar, Cardamom Powder, Saffron Strands, Cashew Nuts, Raisins",7,70,15,85,4,Indian,Dessert,Vegetarian
Choto Aloor Dum ,"Small Potato, Turmeric Powder, Coriander Powder, Garam Masala Powder, Red Chilli Powder, Sugar, Salt, Onion, Tomato, Green Chilli, Ginger, Mustard Oil, Cumin Seeds, Coriander Leaves",14,10,55,65,4,Bengali Recipes,Lunch,Vegetarian
Buckwheat Cracker Recipe,"Buckwheat Flour, Flax Seeds, Sesame Seeds, Sunflower Oil, Salt, Sugar, Red Chilli Flakes, Mixed Herbs, Chilled Water",9,15,20,35,4,Indian,Snack,Vegetarian
Saffron Milk Pudding Recipe,"Milk, Sugar, Custard Powder, Gelatin, Hot Water, Badam, Rose Water, Kewra Essence, Saffron Strands",9,10,30,40,4,Indian,Dessert,Vegetarian
Whole Wheat Ragi Chocolate Chip Cookie Pizza Recipe,"Whole Wheat Flour, Ragi Flour, Baking Soda, Salted Butter, Curd, Cane Sugar, Vanilla Extract, Chocolate Chips, Dessicated Coconut, Decorative Sugar",10,10,30,40,8,American,Dessert,Vegetarian
Mangalorean Style Bendekayi Huli Koddel Recipe - Ladies finger Dal without Coconut Recipe,"Bhindi, Yellow Moong Dal, Tamarind Water, Jaggery, Turmeric Powder, Green Chilli, Red Chilli Powder, Salt, Sunflower Oil, White Urad Dal, Mustard Seeds, Cumin Seeds, Cinnamon Stick, Dry Red Chilli, Coriander, Asafoetida, Mustard Seeds, Cumin Seeds, White Urad Dal, Curry Leaves, Dry Red Chilli, Asafoetida, Sunflower Oil, Coriander",24,10,30,40,4,Mangalorean,Lunch,Vegetarian
Gahat Rasmi Badi Recipe (Uttaranchal Kulith Koftas In Tomato Onion Gravy),"Cup Horse Gram Dal, Turmeric Powder, Green Chilli, Sunflower Oil, Onion, Tomato, Cumin Seeds, Ginger Garlic Paste, Red Chilli Powder, Garam Masala Powder, Cinnamon Powder, Water, Salt",13,10,40,50,2,North Indian Recipes,Side Dish,High Protein Vegetarian
Bihari Kale Channe Ki Ghugni ,"Black Gram, Onion, Ginger Garlic Paste, Green Chilli, Cumin Seeds, Bay Leaf, Turmeric Powder, , Coriander Powder, Black Pepper Powder, Cumin Powder, Mustard Oil, Onion, Green Chili, Coconut, Cumin Seeds",16,520,60,580,4,Bihari,Dinner,Vegetarian
Vegan Chickpeas And Broccoli Curry Recipe,"Oil, Lentil Sugar, , Of Chickpeachickpeas, Broccoli, Onion, Tomato, Ginger Garlic Paste, Cumin Powder, Red Chilli Powder, Salt, Water, Coriander Leaves",13,30,35,65,4,North Indian Recipes,Lunch,Vegan
Broccoli Peanut Oats Tikki Recipe,"Extra Virgin Olive Oil, Broccoli, Potato, Roasted Peanuts, Instant Oats, Green Chilli, Garlic, Garam Masala Powder, Chaat Masala Powder",9,20,30,50,4,North Indian Recipes,Snack,Vegetarian
Matta Rice Peas Pulao,"Kerala Matta Rice, Green Peas, Cardamom, Lentil Sugar, Bay Leaf, Cumin Seeds, Salt, Sugar, Ghee",9,30,15,45,4,Indian,Lunch,Vegetarian
Pear and Apple Coleslaw Recipe,"Cabbage, Apple, Pears, Curd, Pineapple Juice, Tabasco Original  Hot Sauce, Sugar, Coriander",8,15,0,15,4,Continental,Appetizer,Vegetarian
Hash Brown With Spinach & Cheese Recipe,"Potato, Spinach, Cheese, Dried Oregano, Red Chilli Flakes, Black Pepper Powder, Salt",7,10,15,25,4,Continental,World Breakfast,Vegetarian
Gojju Avalakki Recipe - Puli Aval,"Poha, Onion, Green Bell Pepper, Tamarind Paste, Jaggery, Sambar Powder, Turmeric Powder, Mustard Seeds, Chana Dal, White Urad Dal, Roasted Peanuts, Curry Leaves, Green Chilli, Asafoetida, Coriander, Fresh Coconut, Sunflower Oil, Salt",18,10,30,40,4,Karnataka,South Indian Breakfast,Vegetarian
Savory French Toast Recipe With Creamy Achari Mushroom,"Nutralite Garlic & Oregano Spread, Whole Wheat Brown Bread, Onion, Green Chilli, Button Mushrooms, Achari Mayo, Mint Leaves, Whole Eggs, Cup Milk, Cup Fresh Cream, Whole Black Pepper Corns, Salt",12,10,20,30,4,Continental,World Breakfast,Eggetarian
Snake Gourd Salan Recipe (Snake Gourd Cooked In Tangy Spicy Peanut Sesame Curry),"Snake Gourd, Cumin Seeds, Mustard Seeds, Methi Seeds, Turmeric Powder, Coriander Powder, Red Chilli Powder, Tomato, Tamarind Water, Curry Leaves, Sunflower Oil Cooking, Coriander, Salt, Roasted Peanuts, Sesame Seeds, Fresh Coconut, Garlic, Ginger, Onion",19,20,30,50,4,Andhra,Dinner,Vegetarian
Bharwa Karela Recipe,"Karela, Onion, Turmeric Powder, Red Chilli Powder, Cumin Seeds, Salt, Coriander Powder, Mango Pickle, Cotton Threads Tie And Secure The Guards, Sunflower Oil",10,10,30,40,4,North Indian Recipes,Dinner,Vegetarian
Mamidikaya Nuvvula Pachadi Recipe - Raw Mango Til Chutney Recipe,"Mango, Sesame Seeds, Green Chilli, Salt, Sunflower Oil, Cumin Seeds, Mustard Seeds, Dry Red Chilli, Curry Leaves, Asafoetida",10,10,20,30,3,Andhra,Side Dish,Vegetarian
Kolkata Chicken Chaap Recipe  - Slow Cooked Chicken Legs,"Chicken Legs, Hung Curd, Dry Red Chilli, Bay Leaves, Cinnamon Stick, Onion, Ginger, Garlic, Red Chilli Powder, Turmeric Powder, Garam Masala Powder, Cashew Nuts  Groundpaste, Poppy Seeds, Kewra Water, Ghee Butter As Required For Cooking, Salt, Sugar",17,30,70,100,2,Bengali Recipes,Side Dish,Non Vegeterian
Frozen Mango Yogurt Recipe-Mango Froyo,"Curd, Mango, Saffron Strands, Cardamom Powder, Sugar",5,70,20,90,4,Continental,Dessert,High Protein Vegetarian
Dhingri Matar ,"Button Mushroom, Green Peas, Soy Chunks, Tomato Puree, Turmeric Powder, Garam Masala Powder, Red Chilli Powder, Bud Garlic, Ginger, Poppy Seeds, Cashews, Oil, Salt, Coriander",14,20,30,50,4,North Indian Recipes,Lunch,Vegetarian
Homemade Black Bean Burger Recipe,"Canned Black Beans, Extra Virgin Olive Oil, Onion, Garlic, Ginger, Mint Leaves, Whole Wheat Bread Crumbs, Oats Flour",8,30,45,75,4,Continental,Dinner,Vegetarian
Nando's Peri Peri Chicken Recipe,"Boneless Chicken, Nando'S Peri Peri Chicken Marinade, Coriander, Extra Virgin Olive Oil, Lemon Juice, Fresh Red Chilli",6,5,15,20,2,Continental,Main Course,Non Vegeterian
Thandai Panna Cotta With Strawberry And Mango Coulis Recipe,"Fresh Cream, Milk, Gelatin, Sugar, Thandai Masala Syrup, Mango Pulp, Lemon Juice, Water, Strawberries, Sugar, Lemon Juice, Water",12,240,60,300,4,Fusion,Dessert,Non Vegeterian
"Green Peas, Potato and Paneer Tikki Recipe","Sunflower Oil, Potato, Paneer, Green Peas, Onion, Instant Oats, Ginger, Green Chilli, Coriander, Cumin Powder, Red Chilli Powder, Chaat Masala Powder, Salt",13,15,30,45,4,North Indian Recipes,Snack,Vegetarian
Lauki Thepla Recipe,"Whole Wheat Flour, Gram Flour, Bottle Gourd, Green Chilli, Coriander, Ginger, Turmeric Powder, Red Chilli Powder, Garam Masala Powder, Hung Curd, Ghee, Salt",12,10,40,50,4,North Indian Recipes,North Indian Breakfast,Vegetarian
Creamy and Delicious Fruit Custard Recipe,"Milk, Custard Powder, Sugar, Apple, Ripe Bananas, Green Seedless Grapes, Orange, Fresh Pomegranate Fruit Kernels",8,20,20,40,4,Indian,Dessert,Vegetarian
Khajoor Imli Ki Chutney With Panch Phoran Masala Recipe,"Dates, Tamarind, Jaggery, Sunflower Oil, Dry Red Chilli, Panch Phoran Masala, Salt",7,60,30,90,10,North Indian Recipes,Side Dish,Vegetarian
Mangalorean Style Sajjige Rotti/Rulavachi Bhakri Recipe (Semolina Pancake Recipe),"Sooji, Whole Wheat Flour, Fresh Coconut, Onion, Green Chilli, Ginger, Hung Curd, Water  For Kneading, Curry Leaves, Coriander, Jaggery, Salt, Ghee Oil For Shallow Frying",13,10,20,30,4,Mangalorean,South Indian Breakfast,Vegetarian
Kadai Paneer ,"Cheese, Onion, Capsicum, Ginger, Garlic, Tomato, Cardamom Powder, Small Tablespoon Turmeric Powder, Cumin Powder, Red Chilli Powder, Black Pepper Powder, Kasuri Methi, Oil, Butter, Salt",15,20,30,50,4,Punjabi,Dinner,High Protein Vegetarian
Moroccan Chicken Burgers With Feta And Carrot Recipe,"Chicken, Onion, Mint Leaves, Ginger, Harissa Paste, Paprika Powder, Cumin Powder, Garlic, Salt, Black Pepper Powder, Lemon Juice, Sunflower Oil, Mini Pita Breads, Iceberg Lettuce, Hung Curd, Feta Cheese, Carrots, Lemon Juice, Black Pepper Powder, Salt, Extra Virgin Olive Oil",21,15,30,45,4,African,Dinner,Non Vegeterian
Lilve Ki Sabzi ,"Oil, Make  Green Lilwe, Potato, Bay Leaf, , Big Cardamom, Ginger Garlic Paste, Curd, Onion  Paste  Onion  Finely, Red Chilli Powder, Turmeric Powder, Coriander Powder, Salt, Water, Green Coriander",15,15,45,60,3,North Indian Recipes,Lunch,Vegetarian
Chilli Roasted Black Eyed Peas Recipe,"Black Eyed Beans, Tabasco Original, Red Chilli Powder, Rosemary, Dried Oregano, Lemon Juice, Salt, Sunflower Oil",8,120,30,150,4,Continental,Snack,High Protein Vegetarian
Eerulli Palya Recipe - Vengaya Poriyal Recipe,"Onion, Tomato, Green Chilli, Mustard Seeds, Cumin, Curry Leaves, Dry Red Chilli, Asafoetida, Salt, Sunflower Oil, Mint Leaves",11,10,10,20,4,South Indian Recipes,Side Dish,Vegetarian
SautÃ©ed Potatoes With Spinach ,"Potato, Spinach, Onion, Ginger, Tomato, Turmeric Powder, Red Chili Powder, Cinnamon Powder, Garam Masala Powder, Cumin Seeds, Oil, Salt",12,10,40,50,4,North Indian Recipes,Lunch,Vegetarian
Cream Cheese Carrot Raisin Sandwich Recipe,"Whole Wheat Brown Bread, Britannia Cream Cheese, Carrots, Raisins, Coriander",5,10,10,20,4,Continental,Lunch,Vegetarian
Whole Wheat Muesli Pancake with Spirulina Recipe,"Instant Oats, Whole Wheat Flour, Muesli, Baking Powder, Prunes, Honey, Salt, Spirulina, Curd",9,10,25,35,4,Continental,World Breakfast,High Protein Vegetarian
Spiced Cauliflower And Almond Soup Recipe,"Cauliflower, Badam, Harissa Paste, Cumin Powder, Coriander Powder, Cinnamon Powder, Salt, Vegetable Stock, Extra Virgin Olive Oil, Black Pepper Powder",10,10,45,55,6,Italian Recipes,Dinner,Vegetarian
Spicy Baked Beans With Potato Cakes Recipe,"Button Mushrooms, Extra Virgin Olive Oil, Fresh Red Chilli, Brown Sugar, Black Pepper Powder, Parsley Leaves, Fresh Oregano, Garlic, Onion, Vinegar, Worcestershire Sauce, Homemade Tomato Puree, Salt, Green Beans, Potato, All Purpose Flour, Butter",17,10,30,40,4,Karnataka,Lunch,Vegetarian
Aloo Kulcha Recipe (Spiced Potato Stuffed Indian Flat Bread),"All Purpose Flour, Hung Curd, Baking Soda, Baking Powder, Sugar, Sunflower Oil, Salt, Lukewarm Water, Potato, Salt, Green Chilli, Ginger, Chaat Masala Powder, Red Chilli Powder, Cumin Powder, Coriander Powder, Garam Masala Powder, Coriander, Ajwain, Ghee",20,15,45,60,4,North Indian Recipes,Dinner,Vegetarian
Mughlai Style Chicken Changezi Recipe,"Curd, Ginger Garlic Paste, Coriander Powder, Cumin Powder, Salt, Turmeric Powder, Kasuri Methi, Kashmiri Red Chilli Powder, Sunflower Oil, Chicken, Sunflower Oil, Ginger, Garlic, Homemade Tomato Puree, Onion, Salt, Red Chilli Powder, Fresh Cream",18,30,30,60,4,Indian,Dinner,High Protein Non Vegetarian
Chicken Corn Fritters Recipe,"Chicken Breasts, Del Monte Whole Corn Kernels, Whole Egg, Milk, Butter, Salt, Red Chilli Powder, Black Pepper Powder, All Purpose Flour, Baking Powder, Water, Sunflower Oil",12,15,35,50,15,Continental,Appetizer,Non Vegeterian
Chaler Payesh Recipe (Bengali Style Rice Pudding),"Govind Bhog Rice Any Rice, Milk, Sugar, Cashew Nuts, Cardamom, Condensed Milk, Ghee",7,10,30,40,4,Bengali Recipes,Dessert,Vegetarian
Kashmiri Dahi Baingan Recipe,"Brinjal, Mustard Oil, Curd, Dry Ginger Powder, Kashmiri Red Chilli Powder, Turmeric Powder, Fennel Seeds, Cardamom, Ssp Asafoetida, Salt",10,10,15,25,4,Kashmiri,Main Course,Vegetarian
Ambade Kaarle Lonche Recipe - Hog Plums & Bitter Gourd Pickle,"Hog Plum, Karela, Jaggery, Salt, Sunflower Oil, Turmeric Powder, Sunflower Oil, Mustard Seeds, Methi Seeds, Green Chilli, Asafoetida",11,15,20,35,6,Coastal Karnataka,Side Dish,Vegetarian
Garlic And Pepper Mushroom Stir Fry Recipe,"Button Mushrooms, Small Onion, Garlic, Black Pepper Powder, Salt, Oil, Green Coriander",7,10,25,35,4,Indian,Snack,Vegetarian
Masala Bhurji Cheese Sandwich Recipe,"Whole Wheat Brown Bread, Cheddar Cheese, Whole Eggs, Onion, Tomato, Green Chilli, Salt, Sunflower Oil Butter As Required, Black Pepper Powder, S Coriander",10,5,20,25,2,Fusion,Lunch,Vegetarian
Spinach Salad Recipe With Boiled Eggs And Mushrooms,"Button Mushrooms, Extra Virgin Olive Oil, Spinach Leaves, Whole Eggs, Salt, Black Pepper Powder, Lemon Juice, Ginger, Dijon Mustard, Sesame, Pumpkin Seeds",11,15,20,35,3,Continental,Dinner,Eggetarian
Radish Leaves Pachadi ,"Radish Leaves, Tomato, Dry Red Chilli, Green Chilli, Salt, Turmeric Powder, Oil, Mustard, Big Spoon Black Urad Dal, Fenugreek Seeds, Asafoetida, Curry Leaves, Garlic, Tamarind",14,20,15,35,4,South Indian Recipes,Side Dish,Diabetic Friendly
Couscous Eggplant And Tomato Gratin Recipe,"Couscous, Roasted Tomato Pasta Sauce, Harissa Paste, Japanese Eggplant, Extra Virgin Olive Oil, Feta Cheese, Whole Wheat Bread Crumbs, Mint Leaves, Salt",9,10,30,40,3,French,Dinner,Vegetarian
Baked Beans & Potatoes Chaat Recipe,"Whole Wheat Brown Bread, Baked Beans, Potato, Cumin Powder, Onion, Green Chilli, Chaat Masala Powder, Coriander, Sev, Salt, Butter",11,30,25,55,4,Indian,Snack,Vegetarian
Fish Molee Recipe - Kerala Style Fish Curry,"Fish, Sunflower Oil, Cumin Seeds, Onion, Ginger, Tomato, Garlic, Turmeric Powder, Red Chilli Powder, Vinegar, Lemon Juice, Coconut Milk, Salt",13,15,20,35,6,Kerala Recipes,Lunch,High Protein Non Vegetarian
Hariyali Mutton Curry Recipe,"Mutton, Onion, Tomato, Salt, Sunflower Oil, Fresh Cream, Coriander, Mint Leaves, Green Chilli, Cloves, Cinnamon Stick, Cardamom, Star Anise, Ginger, Garlic",15,15,45,60,6,North Indian Recipes,Dinner,Non Vegeterian
Delicious Avocado Salad Recipe with Vegetables,"Carrots, Avocado, Cucumber, Cherry Tomato, Black Olives, Sweet Corn, Iceberg Lettuce, Sesame Seeds, Extra Virgin Olive Oil, Honey, Salt, Black Pepper Powder, Mint Leaves, Dried Oregano",14,15,0,15,2,Continental,Side Dish,Vegetarian
Dal Chenchki ( Red Lentils with Shallots),"Pink Masoor Dal, Shallot, Tomato, Green Chilli, Cumin Seeds, Bay Leaf, Red Chilli Powder, Turmeric Powder, Garam Masala Powder, Coriander Powder, Salt, Ghee",12,10,30,40,3,Bengali Recipes,Dinner,High Protein Vegetarian
Eggplant In Mustard Poppy Seed Yogurt Gravy Recipe-Begun Doi Sorse Posto bata Jhol,"Brinjal, Turmeric Powder, Red Chilli Powder, Mustard Seeds, Poppy Seeds, Mustard Oil, Panch Phoran Masala, Green Chilli, Curd, Salt",10,20,25,45,5,Bengali Recipes,Dinner,Vegetarian
Maharashtrian Narali Bhaat Recipe (Sweetened Coconut Rice),"Basmati Rice, Fresh Coconut, Jaggery, Saffron Strands, Cloves, Ghee, Water, Mixed Nuts",8,20,30,50,4,Maharashtrian Recipes,Lunch,Vegetarian
Chettinadu Style Potato Kaarakozhambu Recipe,"Potato, Brinjal, Tomato, Onion, Green Chilli, Sambar Powder, Tamarind Water, Turmeric Powder, Salt, Garlic, Fresh Coconut, Poppy Seeds, Sesame, Mustard Seeds, Methi Seeds, Chana Dal, Asafoetida, Curry Leaves",18,15,60,75,4,South Indian Recipes,Lunch,Vegetarian
Thatte Idli Recipe,"Rice, Black Urad Dal, Poha, Sabudana, Cooking Soda, Salt, Sunflower Oil",7,10,10,20,4,Karnataka,South Indian Breakfast,Vegetarian
Beans Mezhukkupuratti Recipe - Kerala Style Stir Fried Beans,"Green Beans, Onion, Mustard Seeds, Curry Leaves, Turmeric Powder, Black Pepper Powder, Coconut Oil, Salt",8,10,15,25,4,Kerala Recipes,Lunch,Vegetarian
Karwar Style Dali Ambat Ani Maska Sang Recipe-Toor Dal & Drumsticks Pod Curry,"Arhar Dal, Coriander, Dry Red Chilli, Fresh Coconut, Drumstick   Into  Pieces, Jaggery, Kokum, Salt",8,10,35,45,4,Karnataka,Main Course,Vegetarian
Karwar Style Kelya Sasav Recipe-Ripened Banana Relish,"Ripe Bananas, Fresh Coconut, Dry Red Chilli, Jaggery, Salt",5,5,10,15,4,Karnataka,Snack,Vegetarian
Kothamalli Kozhukattai (Coriander Rice) Recipe,"Rice, Arhar Dal, Chana Dal, Water, Coconut Oil, Mustard Seeds, Fresh Coconut, Green Chilli, Asafoetida, Black Pepper Powder, Cumin Seeds, Curry Leaves, Salt, Coriander",14,10,35,45,2,South Indian Recipes,Dinner,Vegetarian
Chichinda Ki Sabzi Recipe -Uttar Pradesh Style Snake Gourd Stir Fry,"Snake Gourd, Gram Flour, Onion, Turmeric Powder, Red Chilli Powder, Amchur, Mustard Seeds, Chana Dal, Dry Red Chilli, Sunflower Oil, Salt",11,10,20,30,4,Uttar Pradesh,Side Dish,Vegetarian
White Chocolate Pistachio Bars Recipe | White Chocolate Pistachio Fudge,"White Chocolate, Butter, Condensed Milk, Pistachios",4,60,2,62,4,Continental,Dessert,Vegetarian
Sookha Bhujia Bhel Recipe,"Sev, Onion, Tomato, Cucumber, Green Chilli, Coriander, Green Channa Sprouts, Sweet Chutney, Green Chutney, Lemon Juice, Chaat Masala Powder, Salt And Pepper",12,20,10,30,4,North Indian Recipes,Snack,Vegetarian
Mixed Vegetable Samosa Recipe,"Maida, Oil, Celery, Lemon Juice, Potato, Green Peas, Rye, Coriander Seeds, Onion, Curry Leaves, Green Chilies, Ginger, Red Chilli Powder, Coriander Powder, Turmeric Powder, Garam Masala Powder, Salt, Oil",18,10,45,55,2,North Indian Recipes,Snack,Vegetarian
Ratalu Ki Chutney Recipe - Yam Chutney Recipe,"Elephant Yam, Sunflower Oil, Coriander, Cumin Seeds, Dry Red Chilli, Tamarind Paste, Salt, Water, Sunflower Oil, Mustard Seeds, Asafoetida, Curry Leaves, Chana Dal",13,15,25,40,4,Indian,Side Dish,Vegetarian
Milagu Ven Pongal Recipe Made With Figaro Olive Oil,"Rice, Yellow Moong Dal, Salt, Figaro Pure Olive Oil, Cumin Seeds, Ginger, Whole Black Peppercorns, Cashew Nuts, Curry Leaves",9,10,40,50,4,South Indian Recipes,South Indian Breakfast,High Protein Vegetarian
Moong Dal Ke Kebab Recipe,"Cup Green Moong Dal, Tablespoon Ghee, Garlic, Black Pepper Powder, Cumin Seeds, Red Chilli Powder, Garam Masala Powder, Cup Hung Curd, Salt",9,15,15,30,2,Indian,Appetizer,High Protein Vegetarian
Coconut Peanut Chutney ,"Coconut, Green Chilli, S Of Green Coriander, Curry Leaves, Peanuts, Salt Rock Salt",6,20,20,40,4,South Indian Recipes,Side Dish,No Onion No Garlic (Sattvic)
Gujarati Vaghareli Mag ,"Green Moong Dal, Cumin Seeds, Curry Leaves, Ginger, Green Chilli, Turmeric Powder, Lemon Juice, Coriander Leaves, Oil, Salt",10,10,40,50,2,Gujarati Recipesï»¿,Lunch,High Protein Vegetarian
Gavarfali Ki Sukhi Sabzi Recipe,"Gawar Phali, Onion, Cumin Seeds, Garlic, Sunflower Oil, Turmeric Powder, Coriander Powder, Cumin Powder, Red Chilli Powder, Salt",10,10,30,40,4,Rajasthani,Lunch,Vegetarian
Spicy Thai Style Tofu With Quinoa Recipe,"Tofu, Quinoa, Spring Onion Greens, Thai Red Chilli, Garlic, Sesame, Ginger, Red Bell Pepper, Carrots, Roasted Peanuts, Soy Sauce Thai Fish Sauce, Sweet And Spicy Red Chilli Sauce, Rice Vinegar, Brown Sugar, Vegetable Stock, Corn Flour, Lemon Juice, Salt, Thai Basil Leaves, S Coriander",20,0,15,15,4,Thai,Lunch,Vegetarian
Roti Gambang Recipe (Indonesian Bread Recipe),"All Purpose Flour, Whole Wheat Bread Crumbs, Sugar, Milk Powder, Lukewarm Water, Salt, Baking Soda, Baking Powder, Cinnamon Powder, Vanilla Extract, Egg Yolks, Butter, Sesame Seeds",13,10,60,70,4,Indonesian,Side Dish,Eggetarian
Homemade Butter Naan Recipe - Soft Yogurt Bread,"All Purpose Flour, Butter, Curd, Lukewarm Water, Sugar, Active Dry Yeast, Salt, Chaat Masala Powder, Butter",9,60,30,90,4,North Indian Recipes,Dinner,Vegetarian
Radish Leaves Pachadi Recipe,"Cups Mooli Ke Patte, Tomato, Dry Red Chilli, Green Chilli, Salt, Turmeric Powder, Tablespoon Sunflower Oil, Tablespoon Mustard Seeds, Tablespoon White Urad Dal, Methi Seeds, Asafoetida, Curry Leaves, Garlic, Tamarind",14,20,15,35,4,South Indian Recipes,Side Dish,Diabetic Friendly
Chia Seeds Shikanji ,"Sabza Seeds, Cold Water, Ice, Lemon, Sugar, Black Saltrock Salt, Cumin Powder, Pepper Powder, Peppermint",9,30,0,30,4,Indian,Snack,Vegetarian
Mysore Rasam Recipe,"Arhar Dal, Tomato, Tamarind, Jaggery, Green Chilli, Curry Leaves, Coriander, Mustard Seeds, Asafoetida, Ghee, Salt, Chana Dal, Coriander, Cumin Seeds, Black Pepper Powder, Kashmiri Dry Red Chilli, Fresh Coconut",17,10,5,15,4,South Indian Recipes,Lunch,Vegetarian
Mexican Taco Recipe With Refried Beans & Fresh Summer Salad,"Hard Taco Shells, Summer Salad, Refried Beans, Sour Cream, Tomato Salsa, Guacamole",6,30,0,30,4,Mexican,Dinner,Vegetarian
Chena Mezhukuparrati Recipe ( Eggplant Foot Yam Stir Fry),"Elephant Yam, Water, Garlic, Onion, Turmeric Powder, Red Chilli Powder, Black Pepper Powder, Fennel Powder, Sunflower Oil, Mustard Seeds, Curry Leaves",11,15,35,50,4,Kerala Recipes,Lunch,Vegetarian
Spring Onion Dosa Recipe,"Spring Onion, Spring Onion Greens, Dosa Rice, Poha, White Urad Dal, Methi Seeds, Dry Red Chilli, Fresh Coconut, Jaggery, Water, Sunflower Oil Prepare Dosa, Salt",12,360,30,390,5,Karnataka,South Indian Breakfast,Vegetarian
Prawns Spinach Spaghetti Recipe,"Prawns, Spinach, Spaghetti Pasta, Garlic, Extra Virgin Olive Oil, Butter, Lemon Zest, Lemon Juice, Black Pepper Powder, Paprika Powder, Parsley Leaves",11,10,30,40,4,Italian Recipes,Lunch,Vegetarian
Mangalorean Style Vaingana Mashinga Sange Sukhe/Sukka Recipe - Brinjal & Cashew Nut Stir Fry,"Small Brinjal, Mustard Seeds, Onion, Garlic, Turmeric Powder, Red Chilli Powder, Curry Leaves, White Urad Dal, Chana Dal, Coriander, Whole Black Peppercorns, Dry Red Chilli",12,10,45,55,4,Mangalorean,Lunch,Vegetarian
Vietnamese Chicken & Potato Curry Recipe,"Chicken Breasts, Potato, Carrot, Onion, Garlic, Coconut Milk, Turmeric Powder, Salt, Sunflower Oil, Bay Leaf, Cumin Seeds, Fennel Seeds, Coriander, Cinnamon Stick, Cloves, Star Anise, Black Pepper Corns",17,10,20,30,4,Vietnamese,Lunch,Non Vegeterian
Konkani Style Phanna Doddak Recipe-Tempered Dosa Recipe,"White Urad Dal, Sooji, Ginger, Green Chilli, Salt, Curry Leaves, Mustard Seeds, Sunflower Oil",8,30,20,50,4,Konkan,South Indian Breakfast,High Protein Vegetarian
Mozzarella Stuffed Potato Balls Recipe,"Potato, Corn Flour, Black Pepper Powder, Salt, Mozzarella Cheese, Whole Wheat Bread Crumbs, All Purpose Flour, Corn Flour, Sunflower Oil",9,10,30,40,4,Indian,Appetizer,Vegetarian
Alu Vadi Or Patrode Recipe - Maharashtrian Snack With Colocasia Leaves,"Colocasia Leaves, Multigrain Flour Chickpea Flour, Tamarind Water, Garlic, Cumin Powder, Coriander Powder, Asafoetida, Turmeric Powder, Red Chilli Powder, Jaggery  Grated, Salt, Water, Sunflower Oil, Cumin Seeds, Fennel Seeds, Sesame Seeds",16,15,25,40,4,Maharashtrian Recipes,Snack,Vegetarian
Healthy Bharwa Karela Recipe - Stuffed Bitter Gourd,"Karela, Sunflower Oil, Kashmiri Red Chilli Powder, Garam Masala Powder, Amchur, Salt, Onion, Tomato, Mango, Green Chilli, Garlic, Ginger, Fresh Turmeric Root, Raw Peanuts, Coriander, Dry Red Chilli, Tamarind, Fresh Coconut",18,30,50,80,4,Indian,Side Dish,Diabetic Friendly
Lau Er Kofta Curry Recipe (Bengali Style Doodhi Dumplings In Tomato Based Gravy),"Bottle Gourd, Ginger Garlic Paste, Panch Phoran Masala, Green Chilli, Gram Flour, Salt, Ajwain, Bay Leaf, Onion, Tomato, Ginger, Garlic, Green Chilli, Turmeric Powder, Cumin Powder, Coriander Powder, Sugar, Salt, Sunflower Oil Cook, Coriander",20,40,15,55,4,Bengali Recipes,Side Dish,Vegetarian
Ginger Garlic Chicken Recipe,"Chicken Breasts, Garlic, Ginger, Onion, Green Chilli, Spring Onion Greens, Sprig Ginger Teriyaki Sauce, Schezwan Sauce, Sweet And Spicy Red Chilli Sauce, Soy Sauce, Chilli Vinegar, Salt, Black Pepper Powder, Honey, Corn Flour",15,15,15,30,4,Indo Chinese,Side Dish,Non Vegeterian
Onion Raita Recipe,"Yogurt, Water, Onion, Green Chilli, Green Coriander, Mint, Salt",7,10,0,10,3,Indian,Side Dish,Vegetarian
Paneer Bhurji Wraps Recipe,"Tortillas, Paneer, Onion, Tomato, Green Chilli, Coriander, Sunflower Oil, Salt",8,5,25,30,4,Indian,Snack,High Protein Vegetarian
Whole Wheat Oats And Pesto Bread Recipe,"Whole Wheat Flour, Instant Oats, Homemade Basil Pesto, Active Dry Yeast, Extra Virgin Olive Oil, Salt, Garlic Powder",7,120,90,210,1,Continental,Dinner,Vegetarian
Grilled Aubergines with Tzatziki Sauce Recipe,"Brinjal, Cup Extra Virgin Olive Oil, Fresh Thyme Leaves  Fresh, Fresh Pomegranate Fruit Kernels, Za'Atar, Sumac, Salt And Pepper, Cup Tzatziki, Extra Virgin Olive Oil, Salt, Fresh Thyme Leaves  Fresh",11,20,30,50,8,Mediterranean,Appetizer,Vegetarian
Lemon Coriander Soup Recipe,"Sunflower Oil, Garlic, Ginger, Spring Onion, Coriander, Carrots, Water, Salt, Black Pepper Powder, Corn Flour, Lemon Juice",11,10,20,30,4,Indo Chinese,Appetizer,Vegetarian
Dry Jamun Recipe,"Khoya, Paneer, Milk Powder, All Purpose Flour, Cardamom Powder, Sugar, Sugar, Water Make Sugar Syrup, Dessicated Coconut, Ghee",10,10,30,40,6,Indian,Dessert,Vegetarian
Whole Wheat Butter Cookies Recipe,"Whole Wheat Flour, Brown Sugar, Decorative Sugar, Cardamom Powder, Baking Powder, Butter, Extra Virgin Olive Oil",7,15,30,45,4,Continental,Snack,Vegetarian
"Broccoli, Paneer & Peanut Sandwich Recipe ","Whole Wheat Brown Bread, Broccoli, Paneer, Roasted Peanuts, Garlic, Red Chilli Sauce, Black Pepper Powder, Salt, Butter, Sunflower Oil",10,10,30,40,4,Continental,Snack,High Protein Vegetarian
Egg Butter Masala Recipe,"Whole Eggs, Tomato, Onion, Garlic, Ginger, Butter, Bay Leaf, Red Chilli Powder, Garam Masala Powder, Kasuri Methi, Cashew Nuts, Ginger Garlic Paste, Salt",13,15,45,60,4,Indian,Lunch,Eggetarian
Carrot and Cucumber Thalipeeth Recipe,"Rice Flour, Gram Flour, Whole Wheat Flour, Cucumber, Carrot, Dill Leaves, Red Chilli Powder, Turmeric Powder, Salt",9,10,30,40,4,Maharashtrian Recipes,North Indian Breakfast,No Onion No Garlic (Sattvic)
Maharashtrian Style Kelfulachi Bhaji Recipe - Banana Flower Stir Fry Recipe,"Banana Flower, Green Peas, Onion, Mustard Seeds, Cumin Seeds, Asafoetida, Cloves, Jaggery, Malwani Masala, Kokum, Salt",11,60,30,90,4,Maharashtrian Recipes,Side Dish,Vegetarian
Vegetarian Mexican Chili for Tacos Recipe - Made from Horse Gram,"Horse Gram Dal, Onion, Stalk Celery, Pickled Jalapenos, Garlic, Tomato, Red Chilli Powder, Cumin Powder, Dried Oregano, Bay Leaf, Black Pepper Powder, Extra Virgin Olive Oil, Salt",13,10,60,70,2,Mexican,Dinner,Diabetic Friendly
Pahadi Chicken Curry Recipe,"Chicken, Curd, Milk, Turmeric Powder, Cardamom, Black Cardamom, Coriander, Salt, Sunflower Oil, Onion, Garlic, Ginger, Coriander, Cinnamon Stick, Cloves, Fennel Seeds, Whole Black Peppercorns, Green Chilli",18,10,35,45,4,North Indian Recipes,Lunch,Non Vegeterian
Kurkuri Bhindi And Onion Masala Recipe,"Bhindi, Gram Flour, Red Chilli Powder, Turmeric Powder, Coriander Powder, Amchur, Salt, Water, Sunflower Oil, Cumin Seeds, Mustard Seeds, Asafoetida, Ginger Garlic Paste, Green Chilli, Onion, Coriander",16,15,45,60,4,North Indian Recipes,Lunch,Vegetarian
Himachali Dry Raw Mango Chutney Recipe,"Raw Mango, Peppermint, Green Coriander, Green Chilli, Sugar, Salt, As Per",7,10,10,20,12,Himachal,Side Dish,Vegetarian
Sichuan Style Bird Eye Chili Sauce Recipe,"Thai Red Chilli, Ginger, Garlic, Sugar, Vinegar, Salt, Sesame",7,1,30,31,10,Sichuan,Lunch,Non Vegeterian
Beetroot And Celery Juice Recipe,"Beetroot, Stalk Celery, Ginger, Black Salt",4,10,5,15,1,Continental,World Breakfast,Vegetarian
Nut Filled Chocolate Pastry Recipe,"Puff Pastry Sheet, Chocolate Bar, Cashew Nuts, Whole Egg, Caster Sugar",5,10,20,30,2,Continental,Dessert,Eggetarian
Cauliflower Moong Dal Recipe,"Yellow Moong Dal, Cauliflower, Turmeric Powder, Green Chilli, Cumin Powder, Onion, Salt, Tomato, Sunflower Oil, Ginger, Coriander, Garam Masala Powder",12,10,60,70,6,Indian,Side Dish,High Protein Vegetarian
Spanish Omelette Recipe (Tortilla Espanola),"Whole Eggs, Onion, Potato, Whole Black Peppercorns, Paprika Powder Red Chilli Powder, Extra Virgin Olive Oil, Salt, Spring Onion Greens Coriander Leaves For Garnishing",8,20,20,40,3,Mediterranean,World Breakfast,Eggetarian
Cantonese Style Vegetarian Chowmein Recipes,"Packet Egg Noodles, Bean Sprouts, Broccoli, Green Bell Pepper, Spring Onion, Corn Flour, Soy Sauce, Red Chilli Sauce, Sesame, Sugar, Vinegar, Salt, Black Pepper Powder",13,20,45,65,4,Cantonese,Main Course,Vegetarian
Chettinad Style Paneer Kurma ,"Paneer, Small Onion, Tomato, Mustard, Red Chili Powder, Salt, Oil Cook, Nuggets Curry Leaves, Coriander Seeds, Lavang, Cinnamon, Cardamom, Whole Pepper, Kalpasi Leaves, Chakra Flowers, Dry Red Chilli, Poppy Poppy Seeds, Coconut, Green Chilli, Curry Leaves, Coriander",21,20,30,50,4,Chettinad,Main Course,Vegetarian
Sicilian Watermelon Pudding Recipe With Cinnamon Twist  - Gelo Di Melone,"Watermelon, Corn Flour, Sugar, Vanilla Extract, Cinnamon Stick, Cinnamon Powder, Walnuts",7,15,380,395,4,Italian Recipes,Dessert,Vegetarian
Russian Pattice Recipe - Parsi Chicken Cutlet,"Potato, Chicken Breasts, Cheese, Garlic, Ginger, Green Chilli, Coriander, Whole Wheat Bread Crumbs, Salt, Black Pepper Powder, Garam Masala Powder, Whole Egg, Sooji, Whole Wheat Bread Crumbs",14,10,15,25,4,Parsi Recipes,Appetizer,Non Vegeterian
Tomato pulao Recipe,"Basmati Rice, Tomato, Onion, Mint Leaves, Cumin Seeds, Bay Leaves, Turmeric Powder, Sugar, Lemon Juice, Sunflower Oil, Ghee, Coriander, Poppy Seeds, Cumin Seeds, Whole Black Peppercorns, Cinnamon Stick, Cloves, Green Chilli, Red Chilli Powder, Garlic, Onion, Ginger",22,10,40,50,2,Karnataka,Lunch,Vegetarian
Filter Coffee Fudge Brownies Recipe,"Butter, Whole Eggs, Coffee Decoction, Cocoa Powder, Brown Sugar, Vanilla Extract, Dark Chocolate, All Purpose Flour, Walnuts, Dark Chocolate Chips, Heavy Whipping Cream, Dark Chocolate Chips, Instant Coffee Powder",13,20,40,60,6,Continental,Dessert,Eggetarian
Peanut Butter And Flax Oats Bar With Chocolate Chip Recipe,"Instant Oats, Peanut Butter, Honey, Flax Seeds, Chocolate Chips",5,240,15,255,4,Continental,Snack,Vegetarian
Pirandai Oorugai Recipe - Pirandai Pickle Recipe,"Pirandai, Dry Red Chilli, Tamarind Paste, Sesame, Mustard Seeds, Methi Seeds, Salt, Asafoetida",8,15,12,27,4,South Indian Recipes,Side Dish,Vegetarian
Surati Jowar Vada Recipe,"Jowar Flour, Gram Flour, Ginger, Garlic, Red Chilli Powder, Turmeric Powder, Curd, Salt, Sesame Seeds, Sunflower Oil",10,60,35,95,4,North Indian Recipes,Snack,Gluten Free
Beetroot and Carrot Veg balls with sautÃ©ed leek Recipe,"Leek, Black Sesame Seeds, Butter, Carrots, Beetroot, Paneer, Ginger, Onion, Dried Oregano, Tarragon, Rosemary, Red Chilli Flakes, Honey, Gram Flour, Salt, Sunflower Oil",16,10,25,35,4,Continental,Lunch,Vegetarian
Wheat Berry Salad With Cranberries & Carrots Recipe,"Orange, Fresh Thyme Leaves, Rosemary, Extra Virgin Olive Oil, Red Wine Vinaigrette, Salt And Pepper, Wheat Berries Whole Wheat, = Carrot, Cranberries, Walnuts Pecans",10,15,60,75,3,Continental,Appetizer,Vegetarian
Chai Ka Masala Recipe - Homemade Spice Powder for Tea,"Cardamom, Cloves, Dry Ginger Powder, Whole Black Peppercorns, Cinnamon Stick, Nutmeg Powder",6,10,20,30,4,Goan Recipes,Lunch,High Protein Non Vegetarian
Restaurant Style Hara Bhara Kebab Recipe - Vegetarian Green Patties,"Spinach Leaves, Coriander, Potato, Green Peas, Ginger, Green Chilli, Amchur, Gram Flour, Sunflower Oil Shallow Fry, Chaat Masala Powder, Salt",11,30,20,50,4,Indian,Appetizer,High Protein Vegetarian
"Oats, Dates And Dry Fruits Ladoo Recipe","Dates, Instant Oats, Cashew Nuts, Badam, Dessicated Coconut, Caster Sugar, Cardamom Powder, Ghee",8,20,25,45,12,Indian,Snack,Vegetarian
Kashmiri Mutton Yakhni Recipe,"Mutton, Nutralite Classic Spread, Cardamom, Cinnamon Stick, Bay Leaf, Dry Red Chilli, Cloves, Fennel Seeds, Salt, Curd, Red Chilli Powder, Turmeric Powder, Dry Ginger Powder, Saffron Strands, Milk",15,10,25,35,4,Kashmiri,Main Course,Non Vegeterian
Banana Apple Mash Recipe,"Ripe Bananas, Apple, Cardamom Powder, Cinnamon Powder, Milk, Honey, Cardamom Powder, Cinnamon Powder",8,5,10,15,2,Indian,Main Course,Vegetarian
Hawaiian Chicken Skewers Recipe,"Chicken Breasts, Tomato Ketchup, Brown Sugar, Soy Sauce, White Vinegar, Pineapple Juice, Salt, Sesame, Garlic, Ginger, Whole Black Peppercorns, Red Bell Pepper, Yellow Bell Pepper, Green Bell Pepper, Pineapple",15,15,160,175,4,Continental,Appetizer,High Protein Non Vegetarian
Maharashtrian Style Kala Chana Cooked In Koli Masala Recipe,"Kala Chana, Cumin Seeds, Curry Leaves, Sunflower Oil, Coriander, Salt, Onion, Fresh Coconut, Cumin Seeds, Coriander, Green Chilli, Red Chilli Powder, Garam Masala Powder, Koli Masala, Turmeric Powder, Coriander Powder, Kokum",17,15,15,30,4,Maharashtrian Recipes,Lunch,High Protein Vegetarian
South Indian Filter Coffee Recipe With Filter Coffee Powder,"Filter Coffee Powder, Hot Water, Milk, Sugar",4,10,10,20,1,South Indian Recipes,Indian Breakfast,Vegetarian
Jain Style Corn Palak Recipe,"Spinach Leaves, Sweet Corn, Salt, Sugar, Kasuri Methi, Lemon Juice, Garam Masala Powder, Red Chilli Powder, Cumin Powder, Sunflower Oil, Tomato, Green Chilli, Cashew Nuts, Sunflower Oil, Cumin Seeds, Asafoetida, Red Chilli Powder",17,20,25,45,4,North Indian Recipes,Lunch,Vegetarian
Cabbage And Carrot Thoran Recipe,"Carrots, Cabbage, Onion, Green Chilli, Turmeric Powder, Cumin Powder, Sunflower Oil, Mustard Seeds, Fresh Coconut, Curry Leaves, Salt",11,10,30,40,4,Kerala Recipes,Lunch,Vegetarian
Sweet Potato And Bitter Gourd Kulambu Recipe,"Sweet Potato, Onion, Dry Coconut, Karela, Tamarind, Dry Red Chilli, Sesame, Raw Peanuts, Turmeric Powder, Sambar Powder, Coriander Powder, Salt, Mustard Seeds, Methi Seeds, Chana Dal, Asafoetida, Curry Leaves, Water",18,15,35,50,4,Indian,Lunch,Vegetarian
Diabetic Friendly Green Moong Dal/ Mung Beans Soup Recipe,"Green Moong Dal, Green Chilli, Cumin Seeds, Asafoetida, Whole Black Peppercorns, Lemon Juice, Salt, Sunflower Oil",8,5,15,20,3,Indian,Appetizer,Diabetic Friendly
Masala Roasted Aloo Recipe,"Baby Potato, Sunflower Oil, Cumin Seeds, Asafoetida, Amchur, Salt, Lemon, Coriander, Dry Red Chilli, Whole Black Peppercorns, Fennel Seeds, Cumin Seeds",12,10,40,50,4,Indian,Lunch,Vegetarian
Baklava Rolls Recipe - Turkish Sweet Rolls,"Badam, Walnuts, Pistachios, Caster Sugar, Butter, Cinnamon Powder, Sugar, Water, Lemon Juice, Phyllo Sheets Strudel Sheets, Pistachios",11,30,40,70,6,Middle Eastern,Dessert,Vegetarian
Gujarati Vagharela Mag Recipe - Moong Sprouts Sabzi Recipe,"Green Moong Sprouts, Cumin Seeds, Curry Leaves, Ginger, Green Chilli, Turmeric Powder, Lemon, Coriander, Sunflower Oil, Salt",10,15,45,60,4,Gujarati Recipesï»¿,Side Dish,High Protein Vegetarian
Mushrooms Stuffed With Carrots And Mint Mayo Recipe,"Button Mushrooms  Cleaned, Carrot, Del Monte Mint Mayo, Onion, Garlic, Roasted Peanuts, Whole Black Peppercorns, Extra Virgin Olive Oil, Salt",9,15,20,35,2,Continental,Appetizer,Vegetarian
Ridge Gourd Peel Chutney Recipe,"Ridge Gourd Skin, Sesame Seeds, Red Chilli Powder, Sugar, Cumin Seeds, Sunflower Oil, Salt",7,10,20,30,2,Indian,Side Dish,Diabetic Friendly
Kashmiri Style Rajma Recipe,"Rajma, Homemade Tomato Puree, Onion, Curd, Bay Leaf, Sunflower Oil, Asafoetida, Cumin Seeds, Dry Ginger Powder, Ginger, Coriander Powder, Kashmiri Red Chilli Powder, Green Chilli, Garam Masala Powder, Salt, Few  Coriander, Black Cardamom, Cardamom, Cloves, Whole Black Peppercorns, Cinnamon Stick",21,520,30,550,4,Kashmiri,Lunch,Vegetarian
Mushroom Manchurian Recipe | Mushroom Chilli Recipe | Indian Chinese,"Button Mushrooms, Sesame, Stalk Spring Onion, Garlic, Ginger, Green Chilli, Red Chilli Sauce, Tomato Ketchup, Dark Soy Sauce",9,10,10,20,4,Indo Chinese,Dinner,Vegetarian
Sweet Potato Pineapple Skewers In Spicy Sweetish Peanut Dip Recipe,"Sweet Potato, Pineapple, Extra Virgin Olive Oil, Red Chilli Powder, Lemon Juice, Garlic Powder, Soy Sauce, Salt, Peanut Butter, Water, Lemon, Soy Sauce, Honey, Garlic Powder, Red Chilli Powder",15,30,30,60,2,Asian,Appetizer,Vegetarian
Methi Missi Roti Recipe,"Gram Flour, Whole Wheat Flour, Methi Leaves, Green Chilli, Onion, Ginger, Turmeric Powder, Whole Black Peppercorns, Black Salt, Salt, Sunflower Oil Ghee For Smearing",11,10,25,35,4,Gujarati Recipesï»¿,Side Dish,Vegetarian
Nagaland Style Kali Dal ,"Black Urad Dal, Green Chilli, Baking Soda, Salt, Bay Leaves, Oil, Dry Red Chilies, Panch Foran Masala, Ginger",9,30,25,55,2,Nagaland,Lunch,Vegetarian
Parmesan And Fresh Herbs Savoury Scones Recipe,"All Purpose Flour, Baking Powder, Sugar, Salt, Baking Soda, Butter, Parmesan Cheese, Mixed Herbs, Fresh Cream, Milk, Whole Egg",11,15,20,35,8,Continental,World Breakfast,Eggetarian
Buckwheat & Oat Waffle Recipe With Bananas & Vanilla Ice Cream,"Buckwheat Flour, Whole Wheat Flour, Instant Oats, Baking Powder, Sugar, Vanilla Extract, Salt, Cloves, Curd, Whole Egg, Sunflower Oil, Ice Cream, Ripe Bananas, Chocolate Sauce Maple Syrupdrizzle On Top, Mixed Nuts",15,30,30,60,4,Continental,Dessert,Vegetarian
Sprouted Moong Dhokla Recipe,"Green Moong Sprouts, Gram Flour, Carrot, Green Chilli, Ginger, Sunflower Oil, Salt, Cumin Powder, Buttermilk, Baking Soda, Coriander, Mustard Seeds, Sesame Seeds, Curry Leaves",14,60,45,105,4,Gujarati Recipesï»¿,North Indian Breakfast,High Protein Vegetarian
Refreshing Sweet Lime Soda Recipe,"Sugar, Lemon Juice, Water, Aerated Water, Cumin, Black Salt, Black Pepper Powder, Mint Leaves, Ice Cubes",9,15,0,15,2,Indian,Snack,Vegetarian
Spicy And Delicious Chicken Teriyaki Noodle Recipe,"Egg Noodles, Chicken, Carrots, Green Bell Peppers, Green Zucchini, Onion, Ginger, Garlic, Sprig Ginger Teriyaki Sauce, Soy Sauce, Red Chilli Sauce, Salt And Pepper, Sunflower Oil",13,15,30,45,4,Indo Chinese,Main Course,Non Vegeterian
Beetroot Tambuli (Beetroot Raita With Coconut) Recipe,"Beetroot, Curd, Fresh Coconut, Whole Black Peppercorns, Cumin Seeds, Green Chilli, Ginger, Salt, Coriander, Mustard Seeds, Dry Red Chilli, Curry Leaves, Asafoetida",13,20,20,40,4,Indian,Side Dish,Vegetarian
Malpua With Rose And Saffron Syrup Recipe,"Milk, Sooji, All Purpose Flour, Khoya, Baking Powder, Sugar, Fennel Seeds, Cardamom, Raisins, Pistachios Almondsgarnish, Sunflower Oil Deep Fry, Sugar, Water, Cardamom, Saffron Strands, Rose Essence, Rabri",17,10,120,130,3,North Indian Recipes,Dessert,Vegetarian
Carrot Cake Overnight Oats Recipe,"Almond Milk, Hung Curd, Vanilla Extract, Carrots, Cinnamon Powder, Salt, Nutmeg Powder, Chia Seeds, Honey As Needed, Dessicated Coconut, Rolled Oats, Mixed Nuts, Granola",13,300,10,310,4,Continental,World Breakfast,Vegetarian
How to Make Quinoa Flour Recipe,Quinoa,1,5,15,20,100,Indian,Lunch,Vegetarian
Spiced Carrot Walnut Cake Recipe With Chocolate,"All Purpose Flour, Baking Powder, Salt, Cardamom Powder, Cinnamon Powder, Sugar, Carrots, Sunflower Oil, Whole Eggs, Walnuts, Dark Chocolate",11,15,45,60,6,Continental,Dessert,Eggetarian
High Protein Broccoli and Dill Stuffed Paratha Recipe,"Whole Wheat Flour, Salt, Water, Gram Flour, Broccoli, Dill Leaves, Red Bell Pepper, Onion, Ginger, Garlic, Red Chilli Powder, Turmeric Powder, Salt, Sunflower Oil",14,20,35,55,4,North Indian Recipes,Lunch,Vegetarian
Dhuska Recipe (Rice Fried Bread),"Basmati Rice, Chana Dal, Green Peas, Green Chilli, Salt, Coriander, Turmeric Powder, Mustard Oil",8,20,30,50,3,Jharkhand,Snack,Vegetarian
Healthy Kale Pesto Pasta Recipe,"Kale, Basil Leaves, Avocado, Walnuts, Lemon Juice, Black Pepper Powder, Extra Virgin Olive Oil, Pasta  Fusilli, Green Chilli Paste, Garlic, Parmesan Cheese, Mozzarella Cheese, Salt",13,30,4,34,5,Italian Recipes,Lunch,Vegetarian
Chickpea Soup Recipe,"Kabuli Chana, Onion, Ginger Garlic Paste, Basil Powder Oregano, Red Chilli Flakes, Black Pepper Powder, Turmeric Powder, Sunflower Oil, Lemon Juice, Salt",10,15,20,35,4,North Indian Recipes,Dinner,High Protein Vegetarian
Kollu Rasam Recipe - Healthy Horse Gram Rasam,"Tamarind Water, Tomato, Horse Gram Dal, Turmeric Powder, Cumin Powder, Coriander Powder, Ssp Asafoetida, Black Pepper Powder, Salt, Red Chilli Powder, Coriander, Ghee, Garlic, Mustard Seeds, Curry Leaves",15,10,60,70,3,South Indian Recipes,Lunch,Diabetic Friendly
Kathiyawadi Stuffed Onion Recipe,"Pearl Onion, Roasted Peanuts, Garlic, Coriander Powder, Red Chilli Powder, Cumin Powder, Turmeric Powder, Coriander, Sunflower Oil, Salt",10,10,20,30,4,Gujarati Recipesï»¿,Side Dish,Vegetarian
Strawberry And Sooji Halwa Recipe,"Sooji, Strawberry Compote, Ghee, Cardamom Powder, Sugar, Hot Water, Mixed Nuts",7,5,15,20,2,Indian,Dessert,Vegetarian
Maharashtrian Kadhi Recipe,"Hung Curd, Gram Flour, Sugar, Mustard Seeds, Cumin Seeds, Ginger, Green Chilli, Curry Leaves, Coriander, Asafoetida",10,10,25,35,4,Maharashtrian Recipes,Lunch,Vegetarian
Drumstick Dal Soup Recipe,"Drumsticks, Green Moong Dal, Water As Per Use, Onion, Tomato, Garlic, Turmeric Powder, Cumin Powder, Pepper Powder, Salt",10,10,30,40,4,South Indian Recipes,Dinner,Vegetarian
Lauki Yakhni Recipe - Bottle Gourd In Yogurt Gravy,"Bottle Gourd, Cinnamon Stick, Cardamom, Cloves, Ajwain, Dry Ginger Powder, Fennel Powder, Asafoetida, Curd, Mustard Oil, Salt",11,15,35,50,4,Awadhi,Lunch,Vegetarian
Twice Baked Potatoes Recipe,"Potato, Extra Virgin Olive Oil, Salt And Pepper, Vegetable Stock, Butter, Onion, Garlic, Ginger, Green Peas, Green Chilli, Cumin Powder, Asafoetida, Coriander Powder, Turmeric Powder, Kashmiri Red Chilli Powder, Amchur, All Purpose Flour, Sour Cream, Mozzarella Cheese, Coriander",20,15,35,50,4,Continental,Appetizer,Vegetarian
Tomato and Zucchini Frittata Recipe,"Whole Eggs, Milk, Dried Oregano, Red Chilli Flakes, Dried Thyme Leaves, Tomato, Green Zucchini, Paneer, Salt",9,5,15,20,4,Continental,World Breakfast,Eggetarian
Spiced Turnips with Spinach Recipe,"Turnips, Spinach Leaves, Tomato, Onion, Salt, Red Chilli Powder, Turmeric Powder, Coriander Powder, Ginger, Garlic, Cumin Seeds, Green Chilli, Sunflower Oil Cook, Coriander",14,15,60,75,4,Indian,Lunch,Vegetarian
Labra Assamese Chunky Mix Vegetables Recipe,"Kaddu, Potato, Small Green Brinjal, Mooli Mullangi, Onion, Garlic, Ginger, Dry Red Chilli, Sugar, Turmeric Powder, Cumin Powder, Garam Masala Powder, Mustard Oil, Salt, Water, Bay Leaf, Dry Red Chilli, Panch Phoran Masala",18,15,45,60,3,Assamese,Lunch,Vegetarian
Perum Payaru Theeyal Recipe (Kerala Style Black Eyed Bean Curry),"Red Black Eyed Beans, Fresh Coconut, Coriander, Dry Red Chilli, Tamarind Paste, Coriander, Sunflower Oil, Salt",8,15,10,25,4,Kerala Recipes,Lunch,Vegetarian
Raw Mango Sambar Recipe - South Indian Mangai Sambar Recipe,"Arhar Dal, Mango, Onion, Garlic, Ginger, Mustard Seeds, Cumin Seeds, Dry Red Chilli, Turmeric Powder, Sambar Powder, Salt, Sunflower Oil, Mustard Seeds, White Urad Dal, Dry Red Chilli, Asafoetida, Curry Leaves, Sunflower Oil",18,10,30,40,4,Tamil Nadu,Lunch,High Protein Vegetarian
Pumpkin Curry With Chicken Recipe,"Chicken Breasts, Kaddu, Ginger, Onion, Garlic, Green Chilli, Cumin Powder, Red Chilli Powder, Turmeric Powder, Coriander Powder, Garam Masala Powder, Homemade Tomato Puree, Salt, Coriander, Sunflower Oil",15,10,60,70,4,Indian,Lunch,Non Vegeterian
Pacha & Mocha Parappu Sundal Recipe - Green Sprouts & Flat Broad Bean Stir Fry,"Green Moong Sprouts, White Broad Beans, Onion, Garlic, Ginger, Fresh Coconut, Turmeric Powder, Mustard Seeds, White Urad Dal, Asafoetida, Green Chilli, Dry Red Chilli, Curry Leaves, Salt, Sunflower Oil",15,10,30,40,4,Tamil Nadu,Snack,High Protein Vegetarian
Pasta Aglio Olio Recipe,"Spaghetti Pasta, Garlic, Red Chilli Flakes Red Chilli, Extra Virgin Olive Oil, Parsley Leaves, Parmesan Cheese, Salt",7,10,15,25,4,Italian Recipes,Dinner,Vegetarian
Dry Palak Dal Sabzi Recipe,"Spinach Leaves, Arhar Dal, Onion, Garlic, Fresh Red Chilli, Salt, Red Chilli Powder, Sunflower Oil, Cumin Seeds",9,10,30,40,2,Andhra,Dinner,High Protein Vegetarian
Rajasthani Hari Mirch Ka Maas Recipe,"Mutton, Green Chilli, Lemon Juice, Salt, Turmeric Powder, Ghee, Ginger, Garlic, Onion, Curd, Coriander, Green Chilli, Red Chilli Powder",13,30,25,55,4,North Indian Recipes,Main Course,Non Vegeterian
Triple Bean Vegetarian Cutlet or Patty Recipe,"Mixed Beans, Mixed Vegetables, Potato, Whole Wheat Bread Crumbs, Onion, Green Chilli, Garlic, Ginger, Garam Masala Powder, Red Chilli Powder, Coriander, Mint Leaves, Salt And Pepper, Sunflower Oil  For Shallow Frying",14,20,60,80,6,Continental,Appetizer,Vegetarian
Nawabi Kofta Curry Recipe,"Potato, Black Pepper Powder, Paneer, Cashew Nuts, Raisins, Green Chilli, Coriander, Cumin Powder, Garam Masala Powder, Salt, Homemade Tomato Puree, Ghee, Onion, Garlic, Ginger, Fennel Seeds, Coriander, Cloves, Cinnamon Stick, Cardamom, Turmeric Powder, Kashmiri Red Chilli Powder, Fresh Cream, Salt, Coriander",25,30,45,75,4,North Indian Recipes,Dinner,Vegetarian
Whole Wheat Waffles with Caramelised Bananas (Egg and Eggless Recipe),"Flaxmeal Egg Replacer, Milk, Sunflower Oil, Sugar, Baking Powder, Salt, Vanilla Extract, Whole Wheat Flour, Butter, Ripe Bananas, Brown Sugar, Cinnamon Powder",12,10,45,55,2,Continental,World Breakfast,Vegetarian
Green Chilli Pickle Recipe (Gujarati Raiwala Marcha),"Green Chilli, Yellow Mustard Seeds, Salt, Turmeric Powder, Asafoetida, Sunflower Oil, Lemon",7,10,0,10,4,Indian,Side Dish,Vegetarian
Uttar Pradesh Style Satpaita Dal Recipe,"Chana Dal, White Urad Dal, Spinach Leaves, Onion, Tomato, Turmeric Powder, Ginger Garlic Paste, Cumin Powder, Coriander Powder, Whole Black Peppercorns, Red Chilli Powder, Garam Masala Powder, Green Chilli, Bay Leaves, Sunflower Oil, Salt, Ghee, Cumin Seeds, Garlic, Asafoetida, Green Chilli",21,15,20,35,2,Uttar Pradesh,Side Dish,High Protein Vegetarian
Gujarati Tawa Handvo Recipe With Sweet Corn,"Rice, Chana Dal, White Urad Dal, Green Chilli, Ginger, Salt, Sesame Seeds, Curry Leaves, Ssp Asafoetida, Red Chilli Powder, Sunflower Oil, Sweet Corn",12,20,30,50,4,Gujarati Recipesï»¿,North Indian Breakfast,High Protein Vegetarian
Spring Onion & Roasted Garlic Brown Rice Recipe,"Brown Rice  Washed And Soaked, Extra Virgin Olive Oil, Garlic, Spring Onion, Salt, Spring Onion Greens",6,30,35,65,4,Continental,Main Course,Vegetarian
Basbousa Recipe With Egg,"Sooji, Dessicated Coconut, Vivatta Maida, Sugar, Whole Eggs, Vanilla Extract, Curd, Butter, Sugar, Water, Lemon, Rose Water",12,15,75,90,8,Middle Eastern,Dessert,Eggetarian
Methi And Palak Paratha Recipe,"Whole Wheat Flour, Methi Leaves, Spinach Leaves, Onion, Garlic, Cumin Seeds, Turmeric Powder, Red Chilli Powder, Coriander Powder, Cumin Powder, Chaat Masala Powder, Sunflower Oil, Salt, Water Bind The Dough",14,10,40,50,4,Indian,North Indian Breakfast,High Protein Vegetarian
Bell Pepper & Parsley Rice Recipe,"Extra Virgin Olive Oil, Garlic, Onion, Salt, Rosemary, Rice, Extra Virgin Olive Oil, Red Chilli Flakes, Salt, Green Bell Pepper, Mixed Herbs, Red Bell Pepper, Yellow Bell Pepper, Parsley Leaves",14,15,30,45,4,Continental,Main Course,Vegetarian
Jolada Roti Recipe - Jowar Bhakri,"Jowar Flour, Rice Flour, Water, Salt, Sunflower Oil",5,20,30,50,4,North Karnataka,Lunch,High Protein Vegetarian
Kambu Murukku Recipe,"Bajra Flour, Whole Wheat Flour, Kalonji, Green Chilli, Garlic, Butter, Salt, Curd, Water, Sunflower Oil",10,10,20,30,4,South Indian Recipes,Snack,Vegetarian
Amritsari Sookhi Dal Recipe,"Black Urad Dal, Onion, Tomato, Green Chilli, Ginger, Coriander, Salt, Red Chilli Powder, Coriander Powder, Turmeric Powder, Sunflower Oil, Ajwain, Cumin Seeds, Asafoetida, Coriander",15,30,20,50,4,Punjabi,Dinner,Vegetarian
Mohan Bhog Recipe - Bengali Style Sooji Ka Halwa,"Sooji, Sugar, Milk, Ghee, Raisins, Bay Leaf, Cardamom Powder, Saffron Strands, Cashew Nuts",9,10,30,40,4,Indian,Dessert,Vegetarian
Eggless Whole Wheat Orange Cake Recipe,"Whole Wheat Flour, Corn Flour, Baking Soda, Baking Powder, Salt, Icing Sugar, Sunflower Oil, Fresh Orange Juice, Orange Zest",9,10,30,40,6,Continental,Dessert,Vegetarian
Rajasthani Methi Mangodi Sabzi Recipe,"Mangodi, Methi Leaves, Onion, Garlic, Cumin Seeds, Turmeric Powder, Red Chilli Powder, Garam Masala Powder, Curd, Dry Red Chilli, Sunflower Oil, Salt",12,10,15,25,4,Rajasthani,Lunch,Vegetarian
"Eggless Strawberry, Rose And Pistachio Cake Recipe","Whole Wheat Flour, All Purpose Flour, Caster Sugar, Buttermilk, Baking Powder, Butter, Vanilla Extract, Strawberries, Pistachios, Rose Petals, Salt, Water",12,20,40,60,8,Continental,Dessert,Vegetarian
Mini Rava Idli With Tomato Chutney Recipe,"Sooji, Hung Curd, Lukewarm Water, Coriander, Sunflower Oil Grease The Mould, Tomato, Garlic, Ginger, Salt, Black Pepper Powder, Sunflower Oil",11,10,30,40,4,South Indian Recipes,South Indian Breakfast,Vegetarian
Thai Yellow Curry Risotto Recipe,"Arborio Rice, Thai Yellow Curry Paste, Garlic, Vegetable Stock, Salt, Parmesan Cheese Garnish",6,10,25,35,4,Fusion,Main Course,Vegetarian
Roasted Cauliflower Salad With Quinoa & Garlic Yogurt Recipe,"Cauliflower, Paprika Powder, Dried Oregano, Black Pepper Powder, Salt, Extra Virgin Olive Oil, Quinoa, Red Chilli Flakes, Mixed Herbs, Salt, Extra Virgin Olive Oil, Hung Curd, Garlic, Lemon Juice, Fresh Pomegranate Fruit Kernels",15,5,35,40,4,Continental,Appetizer,Vegetarian
Goan Style Frango Vera Recipe - Chicken Vera,"Drumstick, Turmeric Powder, Salt, Sunflower Oil, Dry Red Chilli, Garlic, Cloves, Cinnamon Stick, Whole Black Peppercorns, Onion, Tamarind Paste",11,60,45,105,2,Goan Recipes,Appetizer,High Protein Non Vegetarian
Nagaland Style Pumpkin Oambal Recipe,"Kaddu, Tamarind, Water, Sunflower Oil, Dry Red Chilli, Mustard Seeds, Green Chilli, Raisins, Jaggery, Salt",10,15,10,25,3,Nagaland,Side Dish,Vegetarian
Black Bean Walnut Burger Recipe,"Burger Buns, Butter Toast The Burger Buns, Onion, Black Soy Beans, Potato, Onion, Green Bell Pepper, Red Bell Pepper, Corn Flour, Red Chilli Powder, Cumin Powder, Black Pepper Powder, Whole Wheat Bread Crumbs, Walnuts, Soy Sauce, Sriracha Sauce, Honey, Tomato Ketchup",18,120,30,150,2,Continental,Main Course,High Protein Vegetarian
Pancakes Drizzled With Chocolate Sauce Served With Fruits & Jaggery Recipe (Breakfast In Bed),"Milk, Whole Egg, All Purpose Flour, Baking Powder, Sugar, Butter, Vanilla Extract, Salt, Ripe Bananas, Jaggery, Mango, Fresh Cherries",12,10,40,50,4,Continental,World Breakfast,Vegetarian
Kanchipuram Idlis Recipe,"Idli Rice, Black Urad Dal, Methi Seeds, Salt, Ghee, Cumin Seeds, Whole Black Peppercorns, Curry Leaves, Ginger, Asafoetida",10,30,45,75,4,South Indian Recipes,South Indian Breakfast,High Protein Vegetarian
Aam Ki Launji Pickle Recipe - Sweet & Spicy Mango Pickle,"Mango, Jaggery, Red Chilli Powder, Salt, Sunflower Oil, Ssp Asafoetida, Methi Seeds, Cumin Seeds, Fennel Seeds, Turmeric Powder, Black Salt, Garam Masala Powder",12,10,25,35,10,North Indian Recipes,Side Dish,Vegetarian
Creamy Potato and Vegetable Salad Recipe,"Potato, Salt, Carrots, Green Beans, Raisins, Red Onion, S Coriander, Dijon Mustard, Fresh Cream, Whole Black Peppercorns, Extra Virgin Olive Oil",11,20,10,30,4,Continental,Dinner,Vegetarian
Peanut Bhel Recipe,"Raw Peanuts, Red Chilli Powder, Turmeric Powder, Chaat Masala Powder, Cumin Powder, Sunflower Oil, Salt, Onion, Tomato, Cucumber, Coriander, Lemon Juice, Sev, Salt",14,15,10,25,4,Indian,Snack,High Protein Vegetarian
Thengai Saadam (Spiced Coconut Rice) Recipe,"Rice, Sunflower Oil, Fresh Coconut, Mustard Seeds, White Urad Dal, Dry Red Chilli, Asafoetida, Curry Leaves, Coriander, Cashew Nuts, Salt, Ghee",12,10,30,40,2,South Indian Recipes,Lunch,Vegetarian
Soya Manchurian Gravy Recipe,"Soy Chunks, Garlic, Ginger, Onion, Green Bell Pepper, Green Chilli, Spring Onion Greens, Sunflower Oil, Corn Flour, Soy Sauce, Red Chilli Sauce, Homemade Tomato Puree, Chilli Vinegar, Chilled Water",14,10,30,40,4,Asian,Side Dish,Vegetarian
Upside Down Choco Orange Cake Recipe,"Vivatta Maida, Whole Wheat Flour, Baking Powder, Baking Soda, Orange Zest, Butter, Sugar, Fresh Orange Juice, Whole Eggs, Chocolate Chips, Butter, Brown Sugar, Oranges",13,20,38,58,6,Continental,Dessert,Eggetarian
Smoked Tandoori Chicken Recipe - Classic North Indian Chicken Recipe,"Chicken Thighs, Mustard Oil, Ghee, Charcoal, Hung Curd, Ginger, Garlic, Lemon Juice, Garam Masala Powder, Coriander Powder, Kashmiri Red Chilli Powder, Chaat Masala Powder, Black Salt, Salt, Mustard Oil",15,240,30,270,2,North Indian Recipes,Appetizer,High Protein Non Vegetarian
Thotakura Vepudu Recipe - Andhra Style Amaranth Greens Stir Fry,"Green Amaranth Leaves, Garlic, Green Chilli, Turmeric Powder, Sesame Seeds, Dry Red Chilli, Mustard Seeds, Cumin Seeds, White Urad Dal, Curry Leaves",10,5,10,15,4,Andhra,Lunch,Vegetarian
Stir Fried Carrot And Green Beans Recipe,"Green Beans, Carrot, Ginger, Cloves, Cumin Seeds, Red Chilli Powder, Black Pepper Powder, Coriander Powder, Salt",9,10,25,35,4,Indian,Lunch,Vegetarian
Mahali Kizhangu Thayir Urugaai Recipe (Mahali Root Curd Pickle),"Sarsaparilla, Red Chilli Powder, Turmeric Powder, Salt, Curd, Lemon, Mustard Seeds",7,30,15,45,1,Indian,Appetizer,Vegetarian
Kuvar Pak Recipe,"Milk, Aloe Vera Extract, Fresh Cream, Ghee, Sugar, Pistachios",6,5,60,65,3,Gujarati Recipesï»¿,Dessert,Vegetarian
Pineapple Jal Jeera Recipe - Sweet & Sour Pineapple Drink,"Mint Powder, Cumin Seeds, Black Pepper Powder, Citric Acid Crystals, Asafoetida, Dry Ginger Powder, Black Salt, Amchur, Cardamom, Salt, Sugar, Fennel Seeds, Pineapple Juice, Chilled Water, Jal Jeera Powder As Needed, Lemon Juice",16,15,5,20,2,Indian,Snack,Vegetarian
Southern Buttermilk Biscuits Recipe,"All Purpose Flour, Baking Powder, Baking Soda, Salt, Butter, Buttermilk, Fresh Cream",7,20,25,45,4,Continental,Snack,Vegetarian
One Pot Punjabi Rajma Masala Recipe In Preethi Electric Pressure Cooker,"Rajma, Ginger, Garlic, Onion, Homemade Tomato Puree, Turmeric Powder, Cumin Powder, Garam Masala Powder, Cardamom, Cinnamon Stick, Butter, Coriander, Sunflower Oil, Salt",14,15,90,105,4,North Indian Recipes,Main Course,Vegetarian
Creamy Spinach And Potato Breakfast Casserole Recipe,"Onion, Soy Chunks, Red Chilli Powder, Garam Masala Powder, Spinach Leaves, Whole Eggs, Garlic, Potato, Half And Half, Mozzarella Cheese, Extra Virgin Olive Oil, Salt And Pepper",12,20,45,65,4,Continental,World Breakfast,Eggetarian
Saffron Paneer Peda Recipe,"Paneer, Sugar, Cardamom Powder, Saffron Strands, Water, Ghee, Rose Water",7,5,15,20,4,Indian,Dessert,Vegetarian
Italian Arancini Rice Balls Recipe With Delicious Pasta Dipping Sauce,"Risotto  Cooked Risotto, Parmesan Cheese, Gorgonzola Cheese, Basil Leaves, Whole Eggs, Whole Wheat Bread Crumbs, Homemade Pizza And Pasta Sauce Marinara Sauce For Serving, Arborio Rice, Vegetable Stock Chicken Broth, Butter, Onion, Dry White Wine, Parmesan Cheese, Salt, Black Pepper Powder",15,10,90,100,3,Italian Recipes,Dinner,Vegetarian
Quinoa Phirnee Recipe (Quinoa Milk Pudding),"Quinoa, Sugar, Cardamom Powder, Milk, Condensed Milk Khoya, Ghee, Saffron Strands, Mixed Nuts",8,10,25,35,2,Indian,Dessert,Vegetarian
Ullikadala Pulusu Recipe | Spring Onion Curry,"Spring Onion, Tamarind Water, Gram Flour, Sunflower Oil, Mustard Seeds, Cumin Seeds, Dry Red Chilli, Asafoetida, Turmeric Powder, Salt Atste, Coriander, Cumin Seeds, Mustard Seeds, Methi Seeds, Water",15,5,10,15,2,Andhra,Side Dish,Vegetarian
Kashmiri Style Kokur Yakhni Recipe-Chicken Cooked In Yogurt,"Chicken, Mustard Oil, Ghee, Curd, Cinnamon Stick, Black Cardamom, Cloves, Asafoetida, Bay Leaf, Cumin Seeds, Fennel Powder, Salt, Mint Leaves",13,30,45,75,4,Kashmiri,Lunch,Non Vegeterian
